,date,city,newDeaths,deaths,newCases,totalCases
77,2022-01-01,Alfenas/MG,0,215,0,11449
5674,2022-01-02,Alfenas/MG,0,215,0,11449
11271,2022-01-03,Alfenas/MG,0,215,0,11449
16868,2022-01-04,Alfenas/MG,2,217,50,11499
22465,2022-01-05,Alfenas/MG,0,217,73,11572
28062,2022-01-06,Alfenas/MG,0,217,0,11572
33659,2022-01-07,Alfenas/MG,0,217,201,11773
39256,2022-01-08,Alfenas/MG,0,217,113,11886
44853,2022-01-09,Alfenas/MG,0,217,0,11886
50450,2022-01-10,Alfenas/MG,0,217,0,11886
56047,2022-01-11,Alfenas/MG,0,217,152,12038
61644,2022-01-12,Alfenas/MG,0,217,164,12202
67241,2022-01-13,Alfenas/MG,0,217,160,12362
72838,2022-01-14,Alfenas/MG,1,218,62,12424
78435,2022-01-15,Alfenas/MG,0,218,130,12554
84032,2022-01-16,Alfenas/MG,0,218,0,12554
89629,2022-01-17,Alfenas/MG,0,218,0,12554
95226,2022-01-18,Alfenas/MG,0,218,113,12667
100823,2022-01-19,Alfenas/MG,0,218,138,12805
106420,2022-01-20,Alfenas/MG,0,218,185,12990
112017,2022-01-21,Alfenas/MG,0,218,177,13167
117614,2022-01-22,Alfenas/MG,0,218,125,13292
123211,2022-01-23,Alfenas/MG,0,218,0,13292
128808,2022-01-24,Alfenas/MG,0,218,0,13292
134405,2022-01-25,Alfenas/MG,0,218,120,13412
140002,2022-01-26,Alfenas/MG,0,218,194,13606
145599,2022-01-27,Alfenas/MG,0,218,253,13859
151196,2022-01-28,Alfenas/MG,0,218,221,14080
156793,2022-01-29,Alfenas/MG,0,218,209,14289
162390,2022-01-30,Alfenas/MG,1,219,0,14289
167987,2022-01-31,Alfenas/MG,0,219,0,14289
173584,2022-02-01,Alfenas/MG,4,223,168,14457
179181,2022-02-02,Alfenas/MG,6,229,135,14592
184778,2022-02-03,Alfenas/MG,3,232,115,14707
190375,2022-02-04,Alfenas/MG,1,233,149,14856
195972,2022-02-05,Alfenas/MG,0,233,112,14968
201569,2022-02-06,Alfenas/MG,0,233,0,14968
207166,2022-02-07,Alfenas/MG,0,233,0,14968
212763,2022-02-08,Alfenas/MG,0,233,92,15060
218360,2022-02-09,Alfenas/MG,0,233,95,15155
223957,2022-02-10,Alfenas/MG,0,233,92,15247
229554,2022-02-11,Alfenas/MG,0,233,93,15340
235151,2022-02-12,Alfenas/MG,0,233,90,15430
240748,2022-02-13,Alfenas/MG,0,233,0,15430
246345,2022-02-14,Alfenas/MG,0,233,0,15430
251942,2022-02-15,Alfenas/MG,0,233,100,15530
257539,2022-02-16,Alfenas/MG,0,233,109,15639
263136,2022-02-17,Alfenas/MG,1,234,92,15731
268733,2022-02-18,Alfenas/MG,2,236,101,15832
274330,2022-02-19,Alfenas/MG,0,236,102,15934
279927,2022-02-20,Alfenas/MG,0,236,0,15934
285524,2022-02-21,Alfenas/MG,0,236,0,15934
291121,2022-02-22,Alfenas/MG,0,236,87,16021
296718,2022-02-23,Alfenas/MG,0,236,142,16163
302315,2022-02-24,Alfenas/MG,1,237,174,16337
307912,2022-02-25,Alfenas/MG,0,237,176,16513
313509,2022-02-26,Alfenas/MG,0,237,163,16676
319106,2022-02-27,Alfenas/MG,0,237,0,16676
324703,2022-02-28,Alfenas/MG,0,237,0,16676
330300,2022-03-01,Alfenas/MG,0,237,0,16676
335897,2022-03-02,Alfenas/MG,0,237,0,16676
341494,2022-03-03,Alfenas/MG,0,237,0,16676
347091,2022-03-04,Alfenas/MG,0,237,194,16870
352688,2022-03-05,Alfenas/MG,0,237,146,17016
358285,2022-03-06,Alfenas/MG,1,238,0,17016
363882,2022-03-07,Alfenas/MG,0,238,0,17016
369479,2022-03-08,Alfenas/MG,0,238,266,17282
375076,2022-03-09,Alfenas/MG,1,239,193,17475
380673,2022-03-10,Alfenas/MG,1,240,126,17601
386270,2022-03-11,Alfenas/MG,2,242,192,17793
391867,2022-03-12,Alfenas/MG,0,242,167,17960
397464,2022-03-13,Alfenas/MG,0,242,0,17960
403061,2022-03-14,Alfenas/MG,0,242,0,17960
408658,2022-03-15,Alfenas/MG,0,242,193,18153
414255,2022-03-16,Alfenas/MG,0,242,186,18339
419852,2022-03-17,Alfenas/MG,1,243,204,18543
425449,2022-03-18,Alfenas/MG,1,244,199,18742
431046,2022-03-19,Alfenas/MG,2,246,185,18927
436643,2022-03-20,Alfenas/MG,-1,245,0,18927
442240,2022-03-21,Alfenas/MG,0,245,0,18927
447837,2022-03-22,Alfenas/MG,1,246,135,19062
453434,2022-03-23,Alfenas/MG,-1,245,291,19353
459031,2022-03-24,Alfenas/MG,0,245,100,19453
464628,2022-03-25,Alfenas/MG,0,245,171,19624
470225,2022-03-26,Alfenas/MG,1,246,211,19835
475822,2022-03-27,Alfenas/MG,0,246,0,19835
481419,2022-03-28,Alfenas/MG,0,246,0,19835
487016,2022-03-29,Alfenas/MG,0,246,168,20003
492613,2022-03-30,Alfenas/MG,0,246,253,20256
498210,2022-03-31,Alfenas/MG,0,246,211,20467
503807,2022-04-01,Alfenas/MG,0,246,164,20631
509404,2022-04-02,Alfenas/MG,0,246,0,20631
515001,2022-04-03,Alfenas/MG,0,246,0,20631
520598,2022-04-04,Alfenas/MG,0,246,30,20661
526195,2022-04-05,Alfenas/MG,0,246,23,20684
531792,2022-04-06,Alfenas/MG,0,246,1,20685
537389,2022-04-07,Alfenas/MG,0,246,0,20685
542986,2022-04-08,Alfenas/MG,0,246,1,20686
548583,2022-04-09,Alfenas/MG,0,246,3,20689
554180,2022-04-10,Alfenas/MG,0,246,0,20689
559777,2022-04-11,Alfenas/MG,0,246,0,20689
565374,2022-04-12,Alfenas/MG,0,246,90,20779
570971,2022-04-13,Alfenas/MG,0,246,1,20780
576568,2022-04-14,Alfenas/MG,0,246,3,20783
582165,2022-04-15,Alfenas/MG,0,246,1,20784
587762,2022-04-16,Alfenas/MG,0,246,0,20784
593359,2022-04-17,Alfenas/MG,0,246,0,20784
598956,2022-04-18,Alfenas/MG,0,246,0,20784
604553,2022-04-19,Alfenas/MG,0,246,0,20784
610150,2022-04-20,Alfenas/MG,1,247,0,20784
615747,2022-04-21,Alfenas/MG,0,247,12,20796
621344,2022-04-22,Alfenas/MG,0,247,0,20796
626941,2022-04-23,Alfenas/MG,0,247,0,20796
632538,2022-04-24,Alfenas/MG,0,247,0,20796
638135,2022-04-25,Alfenas/MG,0,247,0,20796
643732,2022-04-26,Alfenas/MG,0,247,2,20798
649329,2022-04-27,Alfenas/MG,0,247,1,20799
654926,2022-04-28,Alfenas/MG,0,247,4,20803
660523,2022-04-29,Alfenas/MG,0,247,1,20804
666120,2022-04-30,Alfenas/MG,0,247,2,20806
671717,2022-05-01,Alfenas/MG,0,247,0,20806
677314,2022-05-02,Alfenas/MG,0,247,0,20806
682911,2022-05-03,Alfenas/MG,0,247,1,20807
688508,2022-05-04,Alfenas/MG,0,247,25,20832
694105,2022-05-05,Alfenas/MG,0,247,17,20849
699702,2022-05-06,Alfenas/MG,0,247,15,20864
705299,2022-05-07,Alfenas/MG,0,247,0,20864
710896,2022-05-08,Alfenas/MG,0,247,0,20864
716493,2022-05-09,Alfenas/MG,0,247,5,20869
722090,2022-05-10,Alfenas/MG,0,247,5,20874
727687,2022-05-11,Alfenas/MG,0,247,11,20885
733284,2022-05-12,Alfenas/MG,0,247,26,20911
738881,2022-05-13,Alfenas/MG,0,247,30,20941
744478,2022-05-14,Alfenas/MG,0,247,0,20941
750075,2022-05-15,Alfenas/MG,0,247,0,20941
755672,2022-05-16,Alfenas/MG,0,247,6,20947
761269,2022-05-17,Alfenas/MG,0,247,29,20976
766866,2022-05-18,Alfenas/MG,0,247,44,21020
772463,2022-05-19,Alfenas/MG,0,247,13,21033
778060,2022-05-20,Alfenas/MG,0,247,25,21058
783657,2022-05-21,Alfenas/MG,0,247,0,21058
789254,2022-05-22,Alfenas/MG,0,247,0,21058
794851,2022-05-23,Alfenas/MG,0,247,18,21076
800448,2022-05-24,Alfenas/MG,0,247,3,21079
806045,2022-05-25,Alfenas/MG,0,247,41,21120
811642,2022-05-26,Alfenas/MG,0,247,31,21151
817239,2022-05-27,Alfenas/MG,0,247,48,21199
822836,2022-05-28,Alfenas/MG,0,247,0,21199
828433,2022-05-29,Alfenas/MG,0,247,0,21199
834030,2022-05-30,Alfenas/MG,0,247,23,21222
839627,2022-05-31,Alfenas/MG,0,247,8,21230
845224,2022-06-01,Alfenas/MG,0,247,44,21274
850821,2022-06-02,Alfenas/MG,0,247,25,21299
856418,2022-06-03,Alfenas/MG,0,247,42,21341
862015,2022-06-04,Alfenas/MG,0,247,0,21341
867612,2022-06-05,Alfenas/MG,0,247,0,21341
873209,2022-06-06,Alfenas/MG,0,247,48,21389
878806,2022-06-07,Alfenas/MG,0,247,9,21398
884403,2022-06-08,Alfenas/MG,1,248,25,21423
890000,2022-06-09,Alfenas/MG,0,248,71,21494
895597,2022-06-10,Alfenas/MG,0,248,76,21570
901194,2022-06-11,Alfenas/MG,0,248,0,21570
906791,2022-06-12,Alfenas/MG,0,248,0,21570
912388,2022-06-13,Alfenas/MG,0,248,33,21603
917985,2022-06-14,Alfenas/MG,0,248,39,21642
923582,2022-06-15,Alfenas/MG,0,248,77,21719
929179,2022-06-16,Alfenas/MG,0,248,0,21719
934776,2022-06-17,Alfenas/MG,0,248,0,21719
940373,2022-06-18,Alfenas/MG,0,248,0,21719
945970,2022-06-19,Alfenas/MG,0,248,0,21719
951567,2022-06-20,Alfenas/MG,0,248,125,21844
957164,2022-06-21,Alfenas/MG,0,248,0,21844
962761,2022-06-22,Alfenas/MG,0,248,0,21844
968358,2022-06-23,Alfenas/MG,0,248,0,21844
973955,2022-06-24,Alfenas/MG,0,248,206,22050
979552,2022-06-25,Alfenas/MG,0,248,0,22050
985149,2022-06-26,Alfenas/MG,0,248,0,22050
990746,2022-06-27,Alfenas/MG,0,248,97,22147
996343,2022-06-28,Alfenas/MG,0,248,130,22277
1001940,2022-06-29,Alfenas/MG,0,248,0,22277
1007537,2022-06-30,Alfenas/MG,2,250,0,22277
1013134,2022-07-01,Alfenas/MG,0,250,0,22277
1018731,2022-07-02,Alfenas/MG,0,250,0,22277
1024328,2022-07-03,Alfenas/MG,0,250,0,22277
1029925,2022-07-04,Alfenas/MG,0,250,206,22483
1035522,2022-07-05,Alfenas/MG,0,250,16,22499
1041119,2022-07-06,Alfenas/MG,0,250,0,22499
1046716,2022-07-07,Alfenas/MG,0,250,0,22499
1052313,2022-07-08,Alfenas/MG,0,250,0,22499
1057910,2022-07-09,Alfenas/MG,0,250,0,22499
1063507,2022-07-10,Alfenas/MG,0,250,0,22499
1069104,2022-07-11,Alfenas/MG,0,250,147,22646
1074701,2022-07-12,Alfenas/MG,0,250,0,22646
1080298,2022-07-13,Alfenas/MG,0,250,63,22709
1085895,2022-07-14,Alfenas/MG,0,250,0,22709
1091492,2022-07-15,Alfenas/MG,0,250,0,22709
1097089,2022-07-16,Alfenas/MG,0,250,0,22709
1102686,2022-07-17,Alfenas/MG,0,250,0,22709
1108283,2022-07-18,Alfenas/MG,0,250,85,22794
1113880,2022-07-19,Alfenas/MG,0,250,28,22822
1119477,2022-07-20,Alfenas/MG,0,250,57,22879
1125074,2022-07-21,Alfenas/MG,0,250,40,22919
1130671,2022-07-22,Alfenas/MG,1,251,5,22924
1136268,2022-07-23,Alfenas/MG,0,251,0,22924
1141865,2022-07-24,Alfenas/MG,0,251,0,22924
1147462,2022-07-25,Alfenas/MG,0,251,7,22931
1153059,2022-07-26,Alfenas/MG,0,251,13,22944
1158656,2022-07-27,Alfenas/MG,0,251,28,22972
1164253,2022-07-28,Alfenas/MG,0,251,39,23011
1169850,2022-07-29,Alfenas/MG,0,251,12,23023
1175447,2022-07-30,Alfenas/MG,0,251,0,23023
1181044,2022-07-31,Alfenas/MG,0,251,0,23023
1186641,2022-08-01,Alfenas/MG,0,251,8,23031
1192238,2022-08-02,Alfenas/MG,1,252,13,23044
1197835,2022-08-03,Alfenas/MG,0,252,20,23064
1203432,2022-08-04,Alfenas/MG,0,252,15,23079
1209029,2022-08-05,Alfenas/MG,0,252,1,23080
1214626,2022-08-06,Alfenas/MG,0,252,0,23080
1220223,2022-08-07,Alfenas/MG,0,252,0,23080
1225820,2022-08-08,Alfenas/MG,0,252,6,23086
1231417,2022-08-09,Alfenas/MG,0,252,3,23089
1237014,2022-08-10,Alfenas/MG,0,252,15,23104
1242611,2022-08-11,Alfenas/MG,0,252,0,23104
1248208,2022-08-12,Alfenas/MG,0,252,10,23114
1253805,2022-08-13,Alfenas/MG,0,252,0,23114
1259402,2022-08-14,Alfenas/MG,0,252,0,23114
1264999,2022-08-15,Alfenas/MG,0,252,0,23114
1270596,2022-08-16,Alfenas/MG,0,252,6,23120
1276193,2022-08-17,Alfenas/MG,0,252,0,23120
1281790,2022-08-18,Alfenas/MG,0,252,24,23144
1287387,2022-08-19,Alfenas/MG,0,252,0,23144
1292984,2022-08-20,Alfenas/MG,0,252,0,23144
1298581,2022-08-21,Alfenas/MG,0,252,0,23144
1304178,2022-08-22,Alfenas/MG,0,252,14,23158
1309775,2022-08-23,Alfenas/MG,0,252,8,23166
1315372,2022-08-24,Alfenas/MG,0,252,0,23166
1320969,2022-08-25,Alfenas/MG,0,252,20,23186
96,2022-01-01,Alpinópolis/MG,0,48,1,1918
5693,2022-01-02,Alpinópolis/MG,0,48,0,1918
11290,2022-01-03,Alpinópolis/MG,-1,47,0,1918
16887,2022-01-04,Alpinópolis/MG,0,47,5,1923
22484,2022-01-05,Alpinópolis/MG,0,47,11,1934
28081,2022-01-06,Alpinópolis/MG,0,47,19,1953
33678,2022-01-07,Alpinópolis/MG,0,47,15,1968
39275,2022-01-08,Alpinópolis/MG,0,47,47,2015
44872,2022-01-09,Alpinópolis/MG,0,47,0,2015
50469,2022-01-10,Alpinópolis/MG,0,47,0,2015
56066,2022-01-11,Alpinópolis/MG,0,47,20,2035
61663,2022-01-12,Alpinópolis/MG,0,47,30,2065
67260,2022-01-13,Alpinópolis/MG,0,47,26,2091
72857,2022-01-14,Alpinópolis/MG,0,47,19,2110
78454,2022-01-15,Alpinópolis/MG,0,47,31,2141
84051,2022-01-16,Alpinópolis/MG,0,47,0,2141
89648,2022-01-17,Alpinópolis/MG,0,47,0,2141
95245,2022-01-18,Alpinópolis/MG,0,47,36,2177
100842,2022-01-19,Alpinópolis/MG,0,47,47,2224
106439,2022-01-20,Alpinópolis/MG,0,47,60,2284
112036,2022-01-21,Alpinópolis/MG,0,47,68,2352
117633,2022-01-22,Alpinópolis/MG,0,47,1,2353
123230,2022-01-23,Alpinópolis/MG,0,47,0,2353
128827,2022-01-24,Alpinópolis/MG,0,47,0,2353
134424,2022-01-25,Alpinópolis/MG,0,47,117,2470
140021,2022-01-26,Alpinópolis/MG,0,47,124,2594
145618,2022-01-27,Alpinópolis/MG,0,47,62,2656
151215,2022-01-28,Alpinópolis/MG,0,47,101,2757
156812,2022-01-29,Alpinópolis/MG,0,47,70,2827
162409,2022-01-30,Alpinópolis/MG,0,47,0,2827
168006,2022-01-31,Alpinópolis/MG,0,47,0,2827
173603,2022-02-01,Alpinópolis/MG,0,47,96,2923
179200,2022-02-02,Alpinópolis/MG,0,47,100,3023
184797,2022-02-03,Alpinópolis/MG,1,48,58,3081
190394,2022-02-04,Alpinópolis/MG,0,48,71,3152
195991,2022-02-05,Alpinópolis/MG,0,48,52,3204
201588,2022-02-06,Alpinópolis/MG,0,48,0,3204
207185,2022-02-07,Alpinópolis/MG,0,48,0,3204
212782,2022-02-08,Alpinópolis/MG,0,48,64,3268
218379,2022-02-09,Alpinópolis/MG,0,48,72,3340
223976,2022-02-10,Alpinópolis/MG,0,48,50,3390
229573,2022-02-11,Alpinópolis/MG,0,48,42,3432
235170,2022-02-12,Alpinópolis/MG,0,48,22,3454
240767,2022-02-13,Alpinópolis/MG,0,48,0,3454
246364,2022-02-14,Alpinópolis/MG,0,48,0,3454
251961,2022-02-15,Alpinópolis/MG,0,48,43,3497
257558,2022-02-16,Alpinópolis/MG,1,49,57,3554
263155,2022-02-17,Alpinópolis/MG,0,49,11,3565
268752,2022-02-18,Alpinópolis/MG,0,49,0,3565
274349,2022-02-19,Alpinópolis/MG,1,50,67,3632
279946,2022-02-20,Alpinópolis/MG,0,50,0,3632
285543,2022-02-21,Alpinópolis/MG,0,50,0,3632
291140,2022-02-22,Alpinópolis/MG,0,50,32,3664
296737,2022-02-23,Alpinópolis/MG,0,50,41,3705
302334,2022-02-24,Alpinópolis/MG,0,50,0,3705
307931,2022-02-25,Alpinópolis/MG,0,50,45,3750
313528,2022-02-26,Alpinópolis/MG,0,50,11,3761
319125,2022-02-27,Alpinópolis/MG,0,50,0,3761
324722,2022-02-28,Alpinópolis/MG,0,50,0,3761
330319,2022-03-01,Alpinópolis/MG,0,50,0,3761
335916,2022-03-02,Alpinópolis/MG,0,50,0,3761
341513,2022-03-03,Alpinópolis/MG,0,50,0,3761
347110,2022-03-04,Alpinópolis/MG,0,50,0,3761
352707,2022-03-05,Alpinópolis/MG,0,50,42,3803
358304,2022-03-06,Alpinópolis/MG,1,51,0,3803
363901,2022-03-07,Alpinópolis/MG,0,51,0,3803
369498,2022-03-08,Alpinópolis/MG,0,51,16,3819
375095,2022-03-09,Alpinópolis/MG,0,51,14,3833
380692,2022-03-10,Alpinópolis/MG,0,51,9,3842
386289,2022-03-11,Alpinópolis/MG,0,51,6,3848
391886,2022-03-12,Alpinópolis/MG,0,51,4,3852
397483,2022-03-13,Alpinópolis/MG,0,51,0,3852
403080,2022-03-14,Alpinópolis/MG,0,51,0,3852
408677,2022-03-15,Alpinópolis/MG,0,51,5,3857
414274,2022-03-16,Alpinópolis/MG,0,51,1,3858
419871,2022-03-17,Alpinópolis/MG,0,51,2,3860
425468,2022-03-18,Alpinópolis/MG,0,51,4,3864
431065,2022-03-19,Alpinópolis/MG,0,51,0,3864
436662,2022-03-20,Alpinópolis/MG,0,51,0,3864
442259,2022-03-21,Alpinópolis/MG,0,51,0,3864
447856,2022-03-22,Alpinópolis/MG,0,51,2,3866
453453,2022-03-23,Alpinópolis/MG,0,51,4,3870
459050,2022-03-24,Alpinópolis/MG,0,51,1,3871
464647,2022-03-25,Alpinópolis/MG,0,51,0,3871
470244,2022-03-26,Alpinópolis/MG,0,51,0,3871
475841,2022-03-27,Alpinópolis/MG,0,51,0,3871
481438,2022-03-28,Alpinópolis/MG,0,51,0,3871
487035,2022-03-29,Alpinópolis/MG,0,51,0,3871
492632,2022-03-30,Alpinópolis/MG,0,51,0,3871
498229,2022-03-31,Alpinópolis/MG,0,51,0,3871
503826,2022-04-01,Alpinópolis/MG,0,51,1,3872
509423,2022-04-02,Alpinópolis/MG,0,51,0,3872
515020,2022-04-03,Alpinópolis/MG,0,51,0,3872
520617,2022-04-04,Alpinópolis/MG,0,51,1,3873
526214,2022-04-05,Alpinópolis/MG,0,51,1,3874
531811,2022-04-06,Alpinópolis/MG,0,51,0,3874
537408,2022-04-07,Alpinópolis/MG,0,51,4,3878
543005,2022-04-08,Alpinópolis/MG,0,51,2,3880
548602,2022-04-09,Alpinópolis/MG,0,51,0,3880
554199,2022-04-10,Alpinópolis/MG,0,51,0,3880
559796,2022-04-11,Alpinópolis/MG,0,51,0,3880
565393,2022-04-12,Alpinópolis/MG,0,51,0,3880
570990,2022-04-13,Alpinópolis/MG,0,51,0,3880
576587,2022-04-14,Alpinópolis/MG,0,51,0,3880
582184,2022-04-15,Alpinópolis/MG,0,51,0,3880
587781,2022-04-16,Alpinópolis/MG,0,51,0,3880
593378,2022-04-17,Alpinópolis/MG,0,51,0,3880
598975,2022-04-18,Alpinópolis/MG,0,51,0,3880
604572,2022-04-19,Alpinópolis/MG,0,51,2,3882
610169,2022-04-20,Alpinópolis/MG,0,51,4,3886
615766,2022-04-21,Alpinópolis/MG,0,51,2,3888
621363,2022-04-22,Alpinópolis/MG,0,51,0,3888
626960,2022-04-23,Alpinópolis/MG,0,51,0,3888
632557,2022-04-24,Alpinópolis/MG,0,51,0,3888
638154,2022-04-25,Alpinópolis/MG,0,51,0,3888
643751,2022-04-26,Alpinópolis/MG,0,51,1,3889
649348,2022-04-27,Alpinópolis/MG,0,51,0,3889
654945,2022-04-28,Alpinópolis/MG,0,51,2,3891
660542,2022-04-29,Alpinópolis/MG,0,51,0,3891
666139,2022-04-30,Alpinópolis/MG,0,51,0,3891
671736,2022-05-01,Alpinópolis/MG,0,51,0,3891
677333,2022-05-02,Alpinópolis/MG,0,51,0,3891
682930,2022-05-03,Alpinópolis/MG,0,51,0,3891
688527,2022-05-04,Alpinópolis/MG,0,51,0,3891
694124,2022-05-05,Alpinópolis/MG,0,51,0,3891
699721,2022-05-06,Alpinópolis/MG,0,51,0,3891
705318,2022-05-07,Alpinópolis/MG,0,51,0,3891
710915,2022-05-08,Alpinópolis/MG,0,51,0,3891
716512,2022-05-09,Alpinópolis/MG,0,51,0,3891
722109,2022-05-10,Alpinópolis/MG,0,51,1,3892
727706,2022-05-11,Alpinópolis/MG,0,51,1,3893
733303,2022-05-12,Alpinópolis/MG,0,51,1,3894
738900,2022-05-13,Alpinópolis/MG,0,51,0,3894
744497,2022-05-14,Alpinópolis/MG,0,51,0,3894
750094,2022-05-15,Alpinópolis/MG,0,51,0,3894
755691,2022-05-16,Alpinópolis/MG,0,51,1,3895
761288,2022-05-17,Alpinópolis/MG,0,51,0,3895
766885,2022-05-18,Alpinópolis/MG,0,51,0,3895
772482,2022-05-19,Alpinópolis/MG,0,51,7,3902
778079,2022-05-20,Alpinópolis/MG,0,51,1,3903
783676,2022-05-21,Alpinópolis/MG,0,51,0,3903
789273,2022-05-22,Alpinópolis/MG,0,51,0,3903
794870,2022-05-23,Alpinópolis/MG,0,51,0,3903
800467,2022-05-24,Alpinópolis/MG,0,51,1,3904
806064,2022-05-25,Alpinópolis/MG,0,51,1,3905
811661,2022-05-26,Alpinópolis/MG,0,51,0,3905
817258,2022-05-27,Alpinópolis/MG,0,51,0,3905
822855,2022-05-28,Alpinópolis/MG,0,51,0,3905
828452,2022-05-29,Alpinópolis/MG,0,51,0,3905
834049,2022-05-30,Alpinópolis/MG,0,51,2,3907
839646,2022-05-31,Alpinópolis/MG,0,51,5,3912
845243,2022-06-01,Alpinópolis/MG,0,51,0,3912
850840,2022-06-02,Alpinópolis/MG,0,51,0,3912
856437,2022-06-03,Alpinópolis/MG,0,51,36,3948
862034,2022-06-04,Alpinópolis/MG,0,51,0,3948
867631,2022-06-05,Alpinópolis/MG,0,51,0,3948
873228,2022-06-06,Alpinópolis/MG,0,51,23,3971
878825,2022-06-07,Alpinópolis/MG,0,51,23,3994
884422,2022-06-08,Alpinópolis/MG,0,51,12,4006
890019,2022-06-09,Alpinópolis/MG,0,51,10,4016
895616,2022-06-10,Alpinópolis/MG,0,51,0,4016
901213,2022-06-11,Alpinópolis/MG,0,51,0,4016
906810,2022-06-12,Alpinópolis/MG,0,51,0,4016
912407,2022-06-13,Alpinópolis/MG,0,51,23,4039
918004,2022-06-14,Alpinópolis/MG,0,51,16,4055
923601,2022-06-15,Alpinópolis/MG,0,51,0,4055
929198,2022-06-16,Alpinópolis/MG,0,51,0,4055
934795,2022-06-17,Alpinópolis/MG,0,51,0,4055
940392,2022-06-18,Alpinópolis/MG,0,51,0,4055
945989,2022-06-19,Alpinópolis/MG,0,51,0,4055
951586,2022-06-20,Alpinópolis/MG,0,51,23,4078
957183,2022-06-21,Alpinópolis/MG,0,51,0,4078
962780,2022-06-22,Alpinópolis/MG,0,51,54,4132
968377,2022-06-23,Alpinópolis/MG,0,51,25,4157
973974,2022-06-24,Alpinópolis/MG,0,51,0,4157
979571,2022-06-25,Alpinópolis/MG,0,51,0,4157
985168,2022-06-26,Alpinópolis/MG,0,51,0,4157
990765,2022-06-27,Alpinópolis/MG,0,51,53,4210
996362,2022-06-28,Alpinópolis/MG,0,51,18,4228
1001959,2022-06-29,Alpinópolis/MG,0,51,34,4262
1007556,2022-06-30,Alpinópolis/MG,0,51,0,4262
1013153,2022-07-01,Alpinópolis/MG,0,51,8,4270
1018750,2022-07-02,Alpinópolis/MG,0,51,0,4270
1024347,2022-07-03,Alpinópolis/MG,0,51,0,4270
1029944,2022-07-04,Alpinópolis/MG,0,51,46,4316
1035541,2022-07-05,Alpinópolis/MG,0,51,26,4342
1041138,2022-07-06,Alpinópolis/MG,0,51,37,4379
1046735,2022-07-07,Alpinópolis/MG,0,51,16,4395
1052332,2022-07-08,Alpinópolis/MG,0,51,27,4422
1057929,2022-07-09,Alpinópolis/MG,0,51,0,4422
1063526,2022-07-10,Alpinópolis/MG,0,51,0,4422
1069123,2022-07-11,Alpinópolis/MG,0,51,15,4437
1074720,2022-07-12,Alpinópolis/MG,0,51,12,4449
1080317,2022-07-13,Alpinópolis/MG,0,51,26,4475
1085914,2022-07-14,Alpinópolis/MG,0,51,18,4493
1091511,2022-07-15,Alpinópolis/MG,0,51,7,4500
1097108,2022-07-16,Alpinópolis/MG,0,51,0,4500
1102705,2022-07-17,Alpinópolis/MG,0,51,0,4500
1108302,2022-07-18,Alpinópolis/MG,0,51,12,4512
1113899,2022-07-19,Alpinópolis/MG,0,51,11,4523
1119496,2022-07-20,Alpinópolis/MG,0,51,11,4534
1125093,2022-07-21,Alpinópolis/MG,0,51,9,4543
1130690,2022-07-22,Alpinópolis/MG,0,51,11,4554
1136287,2022-07-23,Alpinópolis/MG,0,51,0,4554
1141884,2022-07-24,Alpinópolis/MG,0,51,0,4554
1147481,2022-07-25,Alpinópolis/MG,0,51,0,4554
1153078,2022-07-26,Alpinópolis/MG,0,51,5,4559
1158675,2022-07-27,Alpinópolis/MG,0,51,8,4567
1164272,2022-07-28,Alpinópolis/MG,0,51,0,4567
1169869,2022-07-29,Alpinópolis/MG,0,51,0,4567
1175466,2022-07-30,Alpinópolis/MG,0,51,0,4567
1181063,2022-07-31,Alpinópolis/MG,0,51,0,4567
1186660,2022-08-01,Alpinópolis/MG,0,51,0,4567
1192257,2022-08-02,Alpinópolis/MG,0,51,38,4605
1197854,2022-08-03,Alpinópolis/MG,0,51,16,4621
1203451,2022-08-04,Alpinópolis/MG,0,51,4,4625
1209048,2022-08-05,Alpinópolis/MG,0,51,0,4625
1214645,2022-08-06,Alpinópolis/MG,0,51,0,4625
1220242,2022-08-07,Alpinópolis/MG,0,51,0,4625
1225839,2022-08-08,Alpinópolis/MG,0,51,8,4633
1231436,2022-08-09,Alpinópolis/MG,0,51,2,4635
1237033,2022-08-10,Alpinópolis/MG,0,51,10,4645
1242630,2022-08-11,Alpinópolis/MG,0,51,0,4645
1248227,2022-08-12,Alpinópolis/MG,0,51,4,4649
1253824,2022-08-13,Alpinópolis/MG,0,51,0,4649
1259421,2022-08-14,Alpinópolis/MG,0,51,0,4649
1265018,2022-08-15,Alpinópolis/MG,0,51,0,4649
1270615,2022-08-16,Alpinópolis/MG,0,51,6,4655
1276212,2022-08-17,Alpinópolis/MG,1,52,5,4660
1281809,2022-08-18,Alpinópolis/MG,0,52,0,4660
1287406,2022-08-19,Alpinópolis/MG,0,52,0,4660
1293003,2022-08-20,Alpinópolis/MG,0,52,0,4660
1298600,2022-08-21,Alpinópolis/MG,0,52,0,4660
1304197,2022-08-22,Alpinópolis/MG,0,52,0,4660
1309794,2022-08-23,Alpinópolis/MG,0,52,10,4670
1315391,2022-08-24,Alpinópolis/MG,0,52,4,4674
1320988,2022-08-25,Alpinópolis/MG,0,52,1,4675
104,2022-01-01,Alterosa/MG,0,38,0,855
5701,2022-01-02,Alterosa/MG,0,38,0,855
11298,2022-01-03,Alterosa/MG,0,38,0,855
16895,2022-01-04,Alterosa/MG,0,38,8,863
22492,2022-01-05,Alterosa/MG,0,38,0,863
28089,2022-01-06,Alterosa/MG,0,38,0,863
33686,2022-01-07,Alterosa/MG,0,38,24,887
39283,2022-01-08,Alterosa/MG,0,38,42,929
44880,2022-01-09,Alterosa/MG,0,38,0,929
50477,2022-01-10,Alterosa/MG,0,38,0,929
56074,2022-01-11,Alterosa/MG,0,38,46,975
61671,2022-01-12,Alterosa/MG,0,38,0,975
67268,2022-01-13,Alterosa/MG,0,38,10,985
72865,2022-01-14,Alterosa/MG,0,38,13,998
78462,2022-01-15,Alterosa/MG,0,38,18,1016
84059,2022-01-16,Alterosa/MG,0,38,0,1016
89656,2022-01-17,Alterosa/MG,0,38,0,1016
95253,2022-01-18,Alterosa/MG,0,38,31,1047
100850,2022-01-19,Alterosa/MG,0,38,17,1064
106447,2022-01-20,Alterosa/MG,0,38,25,1089
112044,2022-01-21,Alterosa/MG,0,38,0,1089
117641,2022-01-22,Alterosa/MG,0,38,84,1173
123238,2022-01-23,Alterosa/MG,0,38,0,1173
128835,2022-01-24,Alterosa/MG,0,38,0,1173
134432,2022-01-25,Alterosa/MG,0,38,0,1173
140029,2022-01-26,Alterosa/MG,0,38,0,1173
145626,2022-01-27,Alterosa/MG,0,38,0,1173
151223,2022-01-28,Alterosa/MG,0,38,0,1173
156820,2022-01-29,Alterosa/MG,0,38,0,1173
162417,2022-01-30,Alterosa/MG,0,38,0,1173
168014,2022-01-31,Alterosa/MG,0,38,0,1173
173611,2022-02-01,Alterosa/MG,0,38,158,1331
179208,2022-02-02,Alterosa/MG,0,38,11,1342
184805,2022-02-03,Alterosa/MG,1,39,0,1342
190402,2022-02-04,Alterosa/MG,0,39,0,1342
195999,2022-02-05,Alterosa/MG,1,40,17,1359
201596,2022-02-06,Alterosa/MG,0,40,0,1359
207193,2022-02-07,Alterosa/MG,0,40,0,1359
212790,2022-02-08,Alterosa/MG,0,40,0,1359
218387,2022-02-09,Alterosa/MG,1,41,34,1393
223984,2022-02-10,Alterosa/MG,0,41,0,1393
229581,2022-02-11,Alterosa/MG,0,41,0,1393
235178,2022-02-12,Alterosa/MG,0,41,40,1433
240775,2022-02-13,Alterosa/MG,0,41,0,1433
246372,2022-02-14,Alterosa/MG,0,41,0,1433
251969,2022-02-15,Alterosa/MG,0,41,18,1451
257566,2022-02-16,Alterosa/MG,0,41,7,1458
263163,2022-02-17,Alterosa/MG,0,41,0,1458
268760,2022-02-18,Alterosa/MG,0,41,27,1485
274357,2022-02-19,Alterosa/MG,0,41,0,1485
279954,2022-02-20,Alterosa/MG,0,41,0,1485
285551,2022-02-21,Alterosa/MG,0,41,0,1485
291148,2022-02-22,Alterosa/MG,0,41,0,1485
296745,2022-02-23,Alterosa/MG,0,41,0,1485
302342,2022-02-24,Alterosa/MG,0,41,43,1528
307939,2022-02-25,Alterosa/MG,0,41,5,1533
313536,2022-02-26,Alterosa/MG,0,41,2,1535
319133,2022-02-27,Alterosa/MG,0,41,0,1535
324730,2022-02-28,Alterosa/MG,0,41,0,1535
330327,2022-03-01,Alterosa/MG,0,41,0,1535
335924,2022-03-02,Alterosa/MG,0,41,0,1535
341521,2022-03-03,Alterosa/MG,0,41,0,1535
347118,2022-03-04,Alterosa/MG,0,41,0,1535
352715,2022-03-05,Alterosa/MG,0,41,32,1567
358312,2022-03-06,Alterosa/MG,0,41,0,1567
363909,2022-03-07,Alterosa/MG,0,41,0,1567
369506,2022-03-08,Alterosa/MG,0,41,8,1575
375103,2022-03-09,Alterosa/MG,0,41,0,1575
380700,2022-03-10,Alterosa/MG,0,41,2,1577
386297,2022-03-11,Alterosa/MG,0,41,0,1577
391894,2022-03-12,Alterosa/MG,0,41,5,1582
397491,2022-03-13,Alterosa/MG,0,41,0,1582
403088,2022-03-14,Alterosa/MG,0,41,0,1582
408685,2022-03-15,Alterosa/MG,0,41,3,1585
414282,2022-03-16,Alterosa/MG,0,41,0,1585
419879,2022-03-17,Alterosa/MG,0,41,0,1585
425476,2022-03-18,Alterosa/MG,0,41,0,1585
431073,2022-03-19,Alterosa/MG,0,41,0,1585
436670,2022-03-20,Alterosa/MG,0,41,0,1585
442267,2022-03-21,Alterosa/MG,0,41,0,1585
447864,2022-03-22,Alterosa/MG,0,41,8,1593
453461,2022-03-23,Alterosa/MG,0,41,0,1593
459058,2022-03-24,Alterosa/MG,0,41,0,1593
464655,2022-03-25,Alterosa/MG,0,41,0,1593
470252,2022-03-26,Alterosa/MG,0,41,1,1594
475849,2022-03-27,Alterosa/MG,0,41,0,1594
481446,2022-03-28,Alterosa/MG,0,41,0,1594
487043,2022-03-29,Alterosa/MG,0,41,2,1596
492640,2022-03-30,Alterosa/MG,0,41,0,1596
498237,2022-03-31,Alterosa/MG,0,41,0,1596
503834,2022-04-01,Alterosa/MG,0,41,0,1596
509431,2022-04-02,Alterosa/MG,0,41,0,1596
515028,2022-04-03,Alterosa/MG,0,41,0,1596
520625,2022-04-04,Alterosa/MG,0,41,0,1596
526222,2022-04-05,Alterosa/MG,0,41,1,1597
531819,2022-04-06,Alterosa/MG,0,41,4,1601
537416,2022-04-07,Alterosa/MG,0,41,0,1601
543013,2022-04-08,Alterosa/MG,0,41,0,1601
548610,2022-04-09,Alterosa/MG,0,41,0,1601
554207,2022-04-10,Alterosa/MG,0,41,0,1601
559804,2022-04-11,Alterosa/MG,0,41,0,1601
565401,2022-04-12,Alterosa/MG,0,41,0,1601
570998,2022-04-13,Alterosa/MG,0,41,0,1601
576595,2022-04-14,Alterosa/MG,0,41,0,1601
582192,2022-04-15,Alterosa/MG,0,41,0,1601
587789,2022-04-16,Alterosa/MG,0,41,0,1601
593386,2022-04-17,Alterosa/MG,0,41,0,1601
598983,2022-04-18,Alterosa/MG,0,41,0,1601
604580,2022-04-19,Alterosa/MG,0,41,0,1601
610177,2022-04-20,Alterosa/MG,0,41,0,1601
615774,2022-04-21,Alterosa/MG,0,41,0,1601
621371,2022-04-22,Alterosa/MG,0,41,0,1601
626968,2022-04-23,Alterosa/MG,0,41,0,1601
632565,2022-04-24,Alterosa/MG,0,41,0,1601
638162,2022-04-25,Alterosa/MG,0,41,0,1601
643759,2022-04-26,Alterosa/MG,0,41,0,1601
649356,2022-04-27,Alterosa/MG,0,41,0,1601
654953,2022-04-28,Alterosa/MG,0,41,0,1601
660550,2022-04-29,Alterosa/MG,0,41,0,1601
666147,2022-04-30,Alterosa/MG,0,41,0,1601
671744,2022-05-01,Alterosa/MG,0,41,0,1601
677341,2022-05-02,Alterosa/MG,0,41,0,1601
682938,2022-05-03,Alterosa/MG,0,41,1,1602
688535,2022-05-04,Alterosa/MG,0,41,0,1602
694132,2022-05-05,Alterosa/MG,0,41,0,1602
699729,2022-05-06,Alterosa/MG,0,41,0,1602
705326,2022-05-07,Alterosa/MG,0,41,0,1602
710923,2022-05-08,Alterosa/MG,0,41,0,1602
716520,2022-05-09,Alterosa/MG,0,41,0,1602
722117,2022-05-10,Alterosa/MG,0,41,1,1603
727714,2022-05-11,Alterosa/MG,0,41,0,1603
733311,2022-05-12,Alterosa/MG,0,41,0,1603
738908,2022-05-13,Alterosa/MG,0,41,0,1603
744505,2022-05-14,Alterosa/MG,0,41,0,1603
750102,2022-05-15,Alterosa/MG,0,41,0,1603
755699,2022-05-16,Alterosa/MG,0,41,0,1603
761296,2022-05-17,Alterosa/MG,0,41,2,1605
766893,2022-05-18,Alterosa/MG,0,41,0,1605
772490,2022-05-19,Alterosa/MG,0,41,0,1605
778087,2022-05-20,Alterosa/MG,0,41,0,1605
783684,2022-05-21,Alterosa/MG,0,41,0,1605
789281,2022-05-22,Alterosa/MG,0,41,0,1605
794878,2022-05-23,Alterosa/MG,0,41,35,1640
800475,2022-05-24,Alterosa/MG,0,41,0,1640
806072,2022-05-25,Alterosa/MG,0,41,0,1640
811669,2022-05-26,Alterosa/MG,0,41,65,1705
817266,2022-05-27,Alterosa/MG,0,41,0,1705
822863,2022-05-28,Alterosa/MG,0,41,0,1705
828460,2022-05-29,Alterosa/MG,0,41,0,1705
834057,2022-05-30,Alterosa/MG,0,41,0,1705
839654,2022-05-31,Alterosa/MG,0,41,0,1705
845251,2022-06-01,Alterosa/MG,0,41,0,1705
850848,2022-06-02,Alterosa/MG,0,41,0,1705
856445,2022-06-03,Alterosa/MG,0,41,179,1884
862042,2022-06-04,Alterosa/MG,0,41,0,1884
867639,2022-06-05,Alterosa/MG,0,41,0,1884
873236,2022-06-06,Alterosa/MG,0,41,16,1900
878833,2022-06-07,Alterosa/MG,0,41,10,1910
884430,2022-06-08,Alterosa/MG,0,41,28,1938
890027,2022-06-09,Alterosa/MG,0,41,0,1938
895624,2022-06-10,Alterosa/MG,0,41,49,1987
901221,2022-06-11,Alterosa/MG,0,41,0,1987
906818,2022-06-12,Alterosa/MG,0,41,0,1987
912415,2022-06-13,Alterosa/MG,0,41,0,1987
918012,2022-06-14,Alterosa/MG,0,41,23,2010
923609,2022-06-15,Alterosa/MG,0,41,0,2010
929206,2022-06-16,Alterosa/MG,0,41,0,2010
934803,2022-06-17,Alterosa/MG,0,41,0,2010
940400,2022-06-18,Alterosa/MG,0,41,0,2010
945997,2022-06-19,Alterosa/MG,0,41,0,2010
951594,2022-06-20,Alterosa/MG,0,41,0,2010
957191,2022-06-21,Alterosa/MG,0,41,0,2010
962788,2022-06-22,Alterosa/MG,0,41,39,2049
968385,2022-06-23,Alterosa/MG,0,41,0,2049
973982,2022-06-24,Alterosa/MG,0,41,0,2049
979579,2022-06-25,Alterosa/MG,0,41,0,2049
985176,2022-06-26,Alterosa/MG,0,41,0,2049
990773,2022-06-27,Alterosa/MG,0,41,0,2049
996370,2022-06-28,Alterosa/MG,0,41,0,2049
1001967,2022-06-29,Alterosa/MG,0,41,0,2049
1007564,2022-06-30,Alterosa/MG,0,41,0,2049
1013161,2022-07-01,Alterosa/MG,0,41,48,2097
1018758,2022-07-02,Alterosa/MG,0,41,0,2097
1024355,2022-07-03,Alterosa/MG,0,41,0,2097
1029952,2022-07-04,Alterosa/MG,0,41,0,2097
1035549,2022-07-05,Alterosa/MG,0,41,15,2112
1041146,2022-07-06,Alterosa/MG,0,41,0,2112
1046743,2022-07-07,Alterosa/MG,0,41,0,2112
1052340,2022-07-08,Alterosa/MG,0,41,0,2112
1057937,2022-07-09,Alterosa/MG,0,41,0,2112
1063534,2022-07-10,Alterosa/MG,0,41,0,2112
1069131,2022-07-11,Alterosa/MG,0,41,0,2112
1074728,2022-07-12,Alterosa/MG,0,41,0,2112
1080325,2022-07-13,Alterosa/MG,0,41,0,2112
1085922,2022-07-14,Alterosa/MG,0,41,0,2112
1091519,2022-07-15,Alterosa/MG,0,41,0,2112
1097116,2022-07-16,Alterosa/MG,0,41,0,2112
1102713,2022-07-17,Alterosa/MG,0,41,0,2112
1108310,2022-07-18,Alterosa/MG,0,41,0,2112
1113907,2022-07-19,Alterosa/MG,0,41,0,2112
1119504,2022-07-20,Alterosa/MG,0,41,0,2112
1125101,2022-07-21,Alterosa/MG,0,41,0,2112
1130698,2022-07-22,Alterosa/MG,0,41,0,2112
1136295,2022-07-23,Alterosa/MG,0,41,0,2112
1141892,2022-07-24,Alterosa/MG,0,41,0,2112
1147489,2022-07-25,Alterosa/MG,0,41,0,2112
1153086,2022-07-26,Alterosa/MG,0,41,0,2112
1158683,2022-07-27,Alterosa/MG,0,41,0,2112
1164280,2022-07-28,Alterosa/MG,0,41,0,2112
1169877,2022-07-29,Alterosa/MG,0,41,0,2112
1175474,2022-07-30,Alterosa/MG,0,41,0,2112
1181071,2022-07-31,Alterosa/MG,0,41,0,2112
1186668,2022-08-01,Alterosa/MG,0,41,0,2112
1192265,2022-08-02,Alterosa/MG,0,41,0,2112
1197862,2022-08-03,Alterosa/MG,1,42,0,2112
1203459,2022-08-04,Alterosa/MG,1,43,0,2112
1209056,2022-08-05,Alterosa/MG,0,43,0,2112
1214653,2022-08-06,Alterosa/MG,0,43,0,2112
1220250,2022-08-07,Alterosa/MG,0,43,0,2112
1225847,2022-08-08,Alterosa/MG,0,43,0,2112
1231444,2022-08-09,Alterosa/MG,0,43,0,2112
1237041,2022-08-10,Alterosa/MG,0,43,0,2112
1242638,2022-08-11,Alterosa/MG,0,43,0,2112
1248235,2022-08-12,Alterosa/MG,-1,42,0,2112
1253832,2022-08-13,Alterosa/MG,0,42,0,2112
1259429,2022-08-14,Alterosa/MG,0,42,0,2112
1265026,2022-08-15,Alterosa/MG,0,42,0,2112
1270623,2022-08-16,Alterosa/MG,0,42,0,2112
1276220,2022-08-17,Alterosa/MG,0,42,0,2112
1281817,2022-08-18,Alterosa/MG,0,42,0,2112
1287414,2022-08-19,Alterosa/MG,0,42,0,2112
1293011,2022-08-20,Alterosa/MG,0,42,0,2112
1298608,2022-08-21,Alterosa/MG,0,42,0,2112
1304205,2022-08-22,Alterosa/MG,0,42,0,2112
1309802,2022-08-23,Alterosa/MG,0,42,0,2112
1315399,2022-08-24,Alterosa/MG,0,42,0,2112
1320996,2022-08-25,Alterosa/MG,0,42,0,2112
193,2022-01-01,Andradas/MG,0,125,0,4174
5790,2022-01-02,Andradas/MG,0,125,0,4174
11387,2022-01-03,Andradas/MG,0,125,0,4174
16984,2022-01-04,Andradas/MG,0,125,4,4178
22581,2022-01-05,Andradas/MG,0,125,10,4188
28178,2022-01-06,Andradas/MG,0,125,28,4216
33775,2022-01-07,Andradas/MG,0,125,27,4243
39372,2022-01-08,Andradas/MG,0,125,43,4286
44969,2022-01-09,Andradas/MG,0,125,0,4286
50566,2022-01-10,Andradas/MG,0,125,0,4286
56163,2022-01-11,Andradas/MG,0,125,87,4373
61760,2022-01-12,Andradas/MG,0,125,67,4440
67357,2022-01-13,Andradas/MG,0,125,0,4440
72954,2022-01-14,Andradas/MG,0,125,0,4440
78551,2022-01-15,Andradas/MG,0,125,155,4595
84148,2022-01-16,Andradas/MG,0,125,0,4595
89745,2022-01-17,Andradas/MG,0,125,0,4595
95342,2022-01-18,Andradas/MG,0,125,0,4595
100939,2022-01-19,Andradas/MG,0,125,234,4829
106536,2022-01-20,Andradas/MG,0,125,150,4979
112133,2022-01-21,Andradas/MG,0,125,0,4979
117730,2022-01-22,Andradas/MG,0,125,0,4979
123327,2022-01-23,Andradas/MG,0,125,0,4979
128924,2022-01-24,Andradas/MG,0,125,0,4979
134521,2022-01-25,Andradas/MG,0,125,182,5161
140118,2022-01-26,Andradas/MG,1,126,166,5327
145715,2022-01-27,Andradas/MG,0,126,92,5419
151312,2022-01-28,Andradas/MG,0,126,95,5514
156909,2022-01-29,Andradas/MG,0,126,97,5611
162506,2022-01-30,Andradas/MG,1,127,0,5611
168103,2022-01-31,Andradas/MG,0,127,0,5611
173700,2022-02-01,Andradas/MG,0,127,70,5681
179297,2022-02-02,Andradas/MG,0,127,0,5681
184894,2022-02-03,Andradas/MG,0,127,141,5822
190491,2022-02-04,Andradas/MG,2,129,38,5860
196088,2022-02-05,Andradas/MG,0,129,42,5902
201685,2022-02-06,Andradas/MG,0,129,0,5902
207282,2022-02-07,Andradas/MG,0,129,0,5902
212879,2022-02-08,Andradas/MG,0,129,70,5972
218476,2022-02-09,Andradas/MG,0,129,91,6063
224073,2022-02-10,Andradas/MG,0,129,63,6126
229670,2022-02-11,Andradas/MG,0,129,52,6178
235267,2022-02-12,Andradas/MG,0,129,33,6211
240864,2022-02-13,Andradas/MG,0,129,0,6211
246461,2022-02-14,Andradas/MG,0,129,0,6211
252058,2022-02-15,Andradas/MG,0,129,62,6273
257655,2022-02-16,Andradas/MG,0,129,0,6273
263252,2022-02-17,Andradas/MG,1,130,59,6332
268849,2022-02-18,Andradas/MG,0,130,20,6352
274446,2022-02-19,Andradas/MG,0,130,20,6372
280043,2022-02-20,Andradas/MG,0,130,0,6372
285640,2022-02-21,Andradas/MG,0,130,0,6372
291237,2022-02-22,Andradas/MG,0,130,0,6372
296834,2022-02-23,Andradas/MG,1,131,0,6372
302431,2022-02-24,Andradas/MG,0,131,0,6372
308028,2022-02-25,Andradas/MG,0,131,68,6440
313625,2022-02-26,Andradas/MG,0,131,0,6440
319222,2022-02-27,Andradas/MG,0,131,0,6440
324819,2022-02-28,Andradas/MG,0,131,0,6440
330416,2022-03-01,Andradas/MG,0,131,0,6440
336013,2022-03-02,Andradas/MG,0,131,0,6440
341610,2022-03-03,Andradas/MG,0,131,0,6440
347207,2022-03-04,Andradas/MG,2,133,72,6512
352804,2022-03-05,Andradas/MG,0,133,6,6518
358401,2022-03-06,Andradas/MG,1,134,0,6518
363998,2022-03-07,Andradas/MG,0,134,0,6518
369595,2022-03-08,Andradas/MG,0,134,5,6523
375192,2022-03-09,Andradas/MG,1,135,0,6523
380789,2022-03-10,Andradas/MG,0,135,0,6523
386386,2022-03-11,Andradas/MG,0,135,0,6523
391983,2022-03-12,Andradas/MG,0,135,0,6523
397580,2022-03-13,Andradas/MG,0,135,0,6523
403177,2022-03-14,Andradas/MG,0,135,0,6523
408774,2022-03-15,Andradas/MG,0,135,0,6523
414371,2022-03-16,Andradas/MG,0,135,50,6573
419968,2022-03-17,Andradas/MG,0,135,7,6580
425565,2022-03-18,Andradas/MG,0,135,0,6580
431162,2022-03-19,Andradas/MG,0,135,3,6583
436759,2022-03-20,Andradas/MG,0,135,2,6585
442356,2022-03-21,Andradas/MG,0,135,0,6585
447953,2022-03-22,Andradas/MG,0,135,6,6591
453550,2022-03-23,Andradas/MG,2,137,0,6591
459147,2022-03-24,Andradas/MG,0,137,4,6595
464744,2022-03-25,Andradas/MG,0,137,4,6599
470341,2022-03-26,Andradas/MG,0,137,4,6603
475938,2022-03-27,Andradas/MG,0,137,0,6603
481535,2022-03-28,Andradas/MG,0,137,0,6603
487132,2022-03-29,Andradas/MG,0,137,0,6603
492729,2022-03-30,Andradas/MG,0,137,2,6605
498326,2022-03-31,Andradas/MG,0,137,0,6605
503923,2022-04-01,Andradas/MG,0,137,0,6605
509520,2022-04-02,Andradas/MG,0,137,0,6605
515117,2022-04-03,Andradas/MG,0,137,0,6605
520714,2022-04-04,Andradas/MG,0,137,0,6605
526311,2022-04-05,Andradas/MG,0,137,13,6618
531908,2022-04-06,Andradas/MG,0,137,0,6618
537505,2022-04-07,Andradas/MG,0,137,0,6618
543102,2022-04-08,Andradas/MG,0,137,4,6622
548699,2022-04-09,Andradas/MG,0,137,2,6624
554296,2022-04-10,Andradas/MG,0,137,0,6624
559893,2022-04-11,Andradas/MG,0,137,0,6624
565490,2022-04-12,Andradas/MG,0,137,5,6629
571087,2022-04-13,Andradas/MG,0,137,0,6629
576684,2022-04-14,Andradas/MG,0,137,4,6633
582281,2022-04-15,Andradas/MG,0,137,0,6633
587878,2022-04-16,Andradas/MG,0,137,0,6633
593475,2022-04-17,Andradas/MG,0,137,0,6633
599072,2022-04-18,Andradas/MG,0,137,0,6633
604669,2022-04-19,Andradas/MG,0,137,0,6633
610266,2022-04-20,Andradas/MG,0,137,9,6642
615863,2022-04-21,Andradas/MG,0,137,2,6644
621460,2022-04-22,Andradas/MG,0,137,0,6644
627057,2022-04-23,Andradas/MG,0,137,0,6644
632654,2022-04-24,Andradas/MG,0,137,0,6644
638251,2022-04-25,Andradas/MG,0,137,0,6644
643848,2022-04-26,Andradas/MG,0,137,4,6648
649445,2022-04-27,Andradas/MG,0,137,1,6649
655042,2022-04-28,Andradas/MG,0,137,4,6653
660639,2022-04-29,Andradas/MG,0,137,0,6653
666236,2022-04-30,Andradas/MG,0,137,3,6656
671833,2022-05-01,Andradas/MG,0,137,0,6656
677430,2022-05-02,Andradas/MG,0,137,0,6656
683027,2022-05-03,Andradas/MG,0,137,4,6660
688624,2022-05-04,Andradas/MG,0,137,1,6661
694221,2022-05-05,Andradas/MG,0,137,0,6661
699818,2022-05-06,Andradas/MG,0,137,0,6661
705415,2022-05-07,Andradas/MG,0,137,0,6661
711012,2022-05-08,Andradas/MG,0,137,0,6661
716609,2022-05-09,Andradas/MG,0,137,0,6661
722206,2022-05-10,Andradas/MG,0,137,4,6665
727803,2022-05-11,Andradas/MG,0,137,4,6669
733400,2022-05-12,Andradas/MG,0,137,2,6671
738997,2022-05-13,Andradas/MG,0,137,0,6671
744594,2022-05-14,Andradas/MG,0,137,0,6671
750191,2022-05-15,Andradas/MG,0,137,0,6671
755788,2022-05-16,Andradas/MG,0,137,0,6671
761385,2022-05-17,Andradas/MG,0,137,7,6678
766982,2022-05-18,Andradas/MG,0,137,0,6678
772579,2022-05-19,Andradas/MG,0,137,0,6678
778176,2022-05-20,Andradas/MG,0,137,0,6678
783773,2022-05-21,Andradas/MG,0,137,0,6678
789370,2022-05-22,Andradas/MG,0,137,0,6678
794967,2022-05-23,Andradas/MG,0,137,9,6687
800564,2022-05-24,Andradas/MG,0,137,0,6687
806161,2022-05-25,Andradas/MG,0,137,0,6687
811758,2022-05-26,Andradas/MG,0,137,32,6719
817355,2022-05-27,Andradas/MG,0,137,10,6729
822952,2022-05-28,Andradas/MG,0,137,0,6729
828549,2022-05-29,Andradas/MG,0,137,0,6729
834146,2022-05-30,Andradas/MG,0,137,20,6749
839743,2022-05-31,Andradas/MG,0,137,0,6749
845340,2022-06-01,Andradas/MG,0,137,54,6803
850937,2022-06-02,Andradas/MG,0,137,15,6818
856534,2022-06-03,Andradas/MG,0,137,29,6847
862131,2022-06-04,Andradas/MG,0,137,0,6847
867728,2022-06-05,Andradas/MG,0,137,0,6847
873325,2022-06-06,Andradas/MG,0,137,17,6864
878922,2022-06-07,Andradas/MG,0,137,25,6889
884519,2022-06-08,Andradas/MG,0,137,0,6889
890116,2022-06-09,Andradas/MG,0,137,45,6934
895713,2022-06-10,Andradas/MG,0,137,31,6965
901310,2022-06-11,Andradas/MG,0,137,0,6965
906907,2022-06-12,Andradas/MG,0,137,0,6965
912504,2022-06-13,Andradas/MG,0,137,25,6990
918101,2022-06-14,Andradas/MG,0,137,33,7023
923698,2022-06-15,Andradas/MG,0,137,0,7023
929295,2022-06-16,Andradas/MG,0,137,0,7023
934892,2022-06-17,Andradas/MG,0,137,0,7023
940489,2022-06-18,Andradas/MG,0,137,0,7023
946086,2022-06-19,Andradas/MG,0,137,0,7023
951683,2022-06-20,Andradas/MG,0,137,28,7051
957280,2022-06-21,Andradas/MG,0,137,32,7083
962877,2022-06-22,Andradas/MG,0,137,7,7090
968474,2022-06-23,Andradas/MG,0,137,12,7102
974071,2022-06-24,Andradas/MG,0,137,8,7110
979668,2022-06-25,Andradas/MG,0,137,0,7110
985265,2022-06-26,Andradas/MG,0,137,0,7110
990862,2022-06-27,Andradas/MG,0,137,0,7110
996459,2022-06-28,Andradas/MG,0,137,38,7148
1002056,2022-06-29,Andradas/MG,0,137,0,7148
1007653,2022-06-30,Andradas/MG,0,137,33,7181
1013250,2022-07-01,Andradas/MG,0,137,10,7191
1018847,2022-07-02,Andradas/MG,0,137,0,7191
1024444,2022-07-03,Andradas/MG,0,137,0,7191
1030041,2022-07-04,Andradas/MG,0,137,10,7201
1035638,2022-07-05,Andradas/MG,0,137,22,7223
1041235,2022-07-06,Andradas/MG,0,137,11,7234
1046832,2022-07-07,Andradas/MG,0,137,13,7247
1052429,2022-07-08,Andradas/MG,0,137,4,7251
1058026,2022-07-09,Andradas/MG,0,137,0,7251
1063623,2022-07-10,Andradas/MG,0,137,0,7251
1069220,2022-07-11,Andradas/MG,0,137,7,7258
1074817,2022-07-12,Andradas/MG,1,138,0,7258
1080414,2022-07-13,Andradas/MG,0,138,17,7275
1086011,2022-07-14,Andradas/MG,0,138,11,7286
1091608,2022-07-15,Andradas/MG,1,139,0,7286
1097205,2022-07-16,Andradas/MG,0,139,0,7286
1102802,2022-07-17,Andradas/MG,0,139,0,7286
1108399,2022-07-18,Andradas/MG,0,139,32,7318
1113996,2022-07-19,Andradas/MG,0,139,24,7342
1119593,2022-07-20,Andradas/MG,2,141,17,7359
1125190,2022-07-21,Andradas/MG,0,141,11,7370
1130787,2022-07-22,Andradas/MG,0,141,10,7380
1136384,2022-07-23,Andradas/MG,0,141,0,7380
1141981,2022-07-24,Andradas/MG,0,141,0,7380
1147578,2022-07-25,Andradas/MG,0,141,18,7398
1153175,2022-07-26,Andradas/MG,0,141,0,7398
1158772,2022-07-27,Andradas/MG,0,141,30,7428
1164369,2022-07-28,Andradas/MG,0,141,12,7440
1169966,2022-07-29,Andradas/MG,0,141,13,7453
1175563,2022-07-30,Andradas/MG,0,141,0,7453
1181160,2022-07-31,Andradas/MG,0,141,0,7453
1186757,2022-08-01,Andradas/MG,0,141,13,7466
1192354,2022-08-02,Andradas/MG,0,141,15,7481
1197951,2022-08-03,Andradas/MG,0,141,9,7490
1203548,2022-08-04,Andradas/MG,0,141,9,7499
1209145,2022-08-05,Andradas/MG,0,141,7,7506
1214742,2022-08-06,Andradas/MG,0,141,0,7506
1220339,2022-08-07,Andradas/MG,0,141,0,7506
1225936,2022-08-08,Andradas/MG,0,141,6,7512
1231533,2022-08-09,Andradas/MG,0,141,15,7527
1237130,2022-08-10,Andradas/MG,0,141,9,7536
1242727,2022-08-11,Andradas/MG,0,141,0,7536
1248324,2022-08-12,Andradas/MG,0,141,0,7536
1253921,2022-08-13,Andradas/MG,0,141,0,7536
1259518,2022-08-14,Andradas/MG,0,141,0,7536
1265115,2022-08-15,Andradas/MG,0,141,0,7536
1270712,2022-08-16,Andradas/MG,0,141,7,7543
1276309,2022-08-17,Andradas/MG,0,141,1,7544
1281906,2022-08-18,Andradas/MG,0,141,0,7544
1287503,2022-08-19,Andradas/MG,0,141,0,7544
1293100,2022-08-20,Andradas/MG,0,141,0,7544
1298697,2022-08-21,Andradas/MG,0,141,0,7544
1304294,2022-08-22,Andradas/MG,0,141,4,7548
1309891,2022-08-23,Andradas/MG,0,141,3,7551
1315488,2022-08-24,Andradas/MG,0,141,0,7551
1321085,2022-08-25,Andradas/MG,0,141,0,7551
328,2022-01-01,Areado/MG,0,33,0,1265
5925,2022-01-02,Areado/MG,0,33,0,1265
11522,2022-01-03,Areado/MG,0,33,0,1265
17119,2022-01-04,Areado/MG,0,33,7,1272
22716,2022-01-05,Areado/MG,0,33,7,1279
28313,2022-01-06,Areado/MG,0,33,18,1297
33910,2022-01-07,Areado/MG,0,33,24,1321
39507,2022-01-08,Areado/MG,0,33,25,1346
45104,2022-01-09,Areado/MG,0,33,0,1346
50701,2022-01-10,Areado/MG,0,33,0,1346
56298,2022-01-11,Areado/MG,0,33,45,1391
61895,2022-01-12,Areado/MG,0,33,29,1420
67492,2022-01-13,Areado/MG,0,33,0,1420
73089,2022-01-14,Areado/MG,0,33,72,1492
78686,2022-01-15,Areado/MG,0,33,29,1521
84283,2022-01-16,Areado/MG,0,33,0,1521
89880,2022-01-17,Areado/MG,0,33,0,1521
95477,2022-01-18,Areado/MG,0,33,35,1556
101074,2022-01-19,Areado/MG,0,33,33,1589
106671,2022-01-20,Areado/MG,0,33,0,1589
112268,2022-01-21,Areado/MG,0,33,0,1589
117865,2022-01-22,Areado/MG,0,33,0,1589
123462,2022-01-23,Areado/MG,0,33,0,1589
129059,2022-01-24,Areado/MG,0,33,0,1589
134656,2022-01-25,Areado/MG,0,33,0,1589
140253,2022-01-26,Areado/MG,0,33,0,1589
145850,2022-01-27,Areado/MG,0,33,0,1589
151447,2022-01-28,Areado/MG,0,33,178,1767
157044,2022-01-29,Areado/MG,0,33,0,1767
162641,2022-01-30,Areado/MG,0,33,102,1869
168238,2022-01-31,Areado/MG,0,33,0,1869
173835,2022-02-01,Areado/MG,0,33,53,1922
179432,2022-02-02,Areado/MG,0,33,32,1954
185029,2022-02-03,Areado/MG,0,33,24,1978
190626,2022-02-04,Areado/MG,0,33,14,1992
196223,2022-02-05,Areado/MG,0,33,23,2015
201820,2022-02-06,Areado/MG,0,33,0,2015
207417,2022-02-07,Areado/MG,0,33,0,2015
213014,2022-02-08,Areado/MG,0,33,66,2081
218611,2022-02-09,Areado/MG,0,33,26,2107
224208,2022-02-10,Areado/MG,0,33,32,2139
229805,2022-02-11,Areado/MG,0,33,23,2162
235402,2022-02-12,Areado/MG,0,33,17,2179
240999,2022-02-13,Areado/MG,0,33,0,2179
246596,2022-02-14,Areado/MG,0,33,0,2179
252193,2022-02-15,Areado/MG,0,33,0,2179
257790,2022-02-16,Areado/MG,0,33,0,2179
263387,2022-02-17,Areado/MG,0,33,0,2179
268984,2022-02-18,Areado/MG,0,33,125,2304
274581,2022-02-19,Areado/MG,1,34,21,2325
280178,2022-02-20,Areado/MG,0,34,0,2325
285775,2022-02-21,Areado/MG,0,34,0,2325
291372,2022-02-22,Areado/MG,0,34,23,2348
296969,2022-02-23,Areado/MG,0,34,28,2376
302566,2022-02-24,Areado/MG,0,34,22,2398
308163,2022-02-25,Areado/MG,0,34,26,2424
313760,2022-02-26,Areado/MG,1,35,30,2454
319357,2022-02-27,Areado/MG,0,35,0,2454
324954,2022-02-28,Areado/MG,0,35,0,2454
330551,2022-03-01,Areado/MG,0,35,0,2454
336148,2022-03-02,Areado/MG,0,35,0,2454
341745,2022-03-03,Areado/MG,0,35,37,2491
347342,2022-03-04,Areado/MG,0,35,10,2501
352939,2022-03-05,Areado/MG,0,35,9,2510
358536,2022-03-06,Areado/MG,0,35,0,2510
364133,2022-03-07,Areado/MG,0,35,0,2510
369730,2022-03-08,Areado/MG,0,35,17,2527
375327,2022-03-09,Areado/MG,0,35,9,2536
380924,2022-03-10,Areado/MG,0,35,10,2546
386521,2022-03-11,Areado/MG,0,35,8,2554
392118,2022-03-12,Areado/MG,0,35,6,2560
397715,2022-03-13,Areado/MG,0,35,0,2560
403312,2022-03-14,Areado/MG,0,35,0,2560
408909,2022-03-15,Areado/MG,0,35,11,2571
414506,2022-03-16,Areado/MG,0,35,8,2579
420103,2022-03-17,Areado/MG,0,35,6,2585
425700,2022-03-18,Areado/MG,0,35,1,2586
431297,2022-03-19,Areado/MG,0,35,4,2590
436894,2022-03-20,Areado/MG,0,35,0,2590
442491,2022-03-21,Areado/MG,0,35,0,2590
448088,2022-03-22,Areado/MG,0,35,12,2602
453685,2022-03-23,Areado/MG,0,35,8,2610
459282,2022-03-24,Areado/MG,0,35,3,2613
464879,2022-03-25,Areado/MG,0,35,2,2615
470476,2022-03-26,Areado/MG,0,35,0,2615
476073,2022-03-27,Areado/MG,0,35,0,2615
481670,2022-03-28,Areado/MG,0,35,0,2615
487267,2022-03-29,Areado/MG,0,35,2,2617
492864,2022-03-30,Areado/MG,0,35,4,2621
498461,2022-03-31,Areado/MG,0,35,2,2623
504058,2022-04-01,Areado/MG,0,35,0,2623
509655,2022-04-02,Areado/MG,0,35,0,2623
515252,2022-04-03,Areado/MG,0,35,0,2623
520849,2022-04-04,Areado/MG,0,35,3,2626
526446,2022-04-05,Areado/MG,0,35,0,2626
532043,2022-04-06,Areado/MG,0,35,2,2628
537640,2022-04-07,Areado/MG,0,35,0,2628
543237,2022-04-08,Areado/MG,0,35,1,2629
548834,2022-04-09,Areado/MG,0,35,1,2630
554431,2022-04-10,Areado/MG,0,35,0,2630
560028,2022-04-11,Areado/MG,0,35,0,2630
565625,2022-04-12,Areado/MG,0,35,0,2630
571222,2022-04-13,Areado/MG,0,35,0,2630
576819,2022-04-14,Areado/MG,0,35,2,2632
582416,2022-04-15,Areado/MG,0,35,0,2632
588013,2022-04-16,Areado/MG,0,35,0,2632
593610,2022-04-17,Areado/MG,0,35,0,2632
599207,2022-04-18,Areado/MG,0,35,0,2632
604804,2022-04-19,Areado/MG,0,35,2,2634
610401,2022-04-20,Areado/MG,0,35,0,2634
615998,2022-04-21,Areado/MG,0,35,0,2634
621595,2022-04-22,Areado/MG,0,35,0,2634
627192,2022-04-23,Areado/MG,0,35,0,2634
632789,2022-04-24,Areado/MG,0,35,0,2634
638386,2022-04-25,Areado/MG,0,35,0,2634
643983,2022-04-26,Areado/MG,0,35,0,2634
649580,2022-04-27,Areado/MG,0,35,1,2635
655177,2022-04-28,Areado/MG,0,35,0,2635
660774,2022-04-29,Areado/MG,0,35,0,2635
666371,2022-04-30,Areado/MG,0,35,0,2635
671968,2022-05-01,Areado/MG,0,35,0,2635
677565,2022-05-02,Areado/MG,0,35,0,2635
683162,2022-05-03,Areado/MG,0,35,0,2635
688759,2022-05-04,Areado/MG,0,35,5,2640
694356,2022-05-05,Areado/MG,0,35,0,2640
699953,2022-05-06,Areado/MG,0,35,0,2640
705550,2022-05-07,Areado/MG,0,35,0,2640
711147,2022-05-08,Areado/MG,0,35,0,2640
716744,2022-05-09,Areado/MG,0,35,0,2640
722341,2022-05-10,Areado/MG,0,35,0,2640
727938,2022-05-11,Areado/MG,0,35,36,2676
733535,2022-05-12,Areado/MG,0,35,0,2676
739132,2022-05-13,Areado/MG,0,35,0,2676
744729,2022-05-14,Areado/MG,0,35,0,2676
750326,2022-05-15,Areado/MG,0,35,0,2676
755923,2022-05-16,Areado/MG,0,35,0,2676
761520,2022-05-17,Areado/MG,0,35,0,2676
767117,2022-05-18,Areado/MG,0,35,80,2756
772714,2022-05-19,Areado/MG,0,35,0,2756
778311,2022-05-20,Areado/MG,0,35,0,2756
783908,2022-05-21,Areado/MG,0,35,0,2756
789505,2022-05-22,Areado/MG,0,35,0,2756
795102,2022-05-23,Areado/MG,0,35,0,2756
800699,2022-05-24,Areado/MG,0,35,0,2756
806296,2022-05-25,Areado/MG,0,35,57,2813
811893,2022-05-26,Areado/MG,0,35,0,2813
817490,2022-05-27,Areado/MG,0,35,0,2813
823087,2022-05-28,Areado/MG,0,35,0,2813
828684,2022-05-29,Areado/MG,0,35,0,2813
834281,2022-05-30,Areado/MG,0,35,0,2813
839878,2022-05-31,Areado/MG,0,35,0,2813
845475,2022-06-01,Areado/MG,0,35,62,2875
851072,2022-06-02,Areado/MG,0,35,0,2875
856669,2022-06-03,Areado/MG,0,35,0,2875
862266,2022-06-04,Areado/MG,0,35,0,2875
867863,2022-06-05,Areado/MG,0,35,0,2875
873460,2022-06-06,Areado/MG,0,35,0,2875
879057,2022-06-07,Areado/MG,0,35,0,2875
884654,2022-06-08,Areado/MG,0,35,0,2875
890251,2022-06-09,Areado/MG,0,35,68,2943
895848,2022-06-10,Areado/MG,0,35,0,2943
901445,2022-06-11,Areado/MG,0,35,0,2943
907042,2022-06-12,Areado/MG,0,35,0,2943
912639,2022-06-13,Areado/MG,0,35,0,2943
918236,2022-06-14,Areado/MG,0,35,0,2943
923833,2022-06-15,Areado/MG,0,35,0,2943
929430,2022-06-16,Areado/MG,0,35,0,2943
935027,2022-06-17,Areado/MG,0,35,0,2943
940624,2022-06-18,Areado/MG,0,35,0,2943
946221,2022-06-19,Areado/MG,0,35,0,2943
951818,2022-06-20,Areado/MG,0,35,83,3026
957415,2022-06-21,Areado/MG,0,35,0,3026
963012,2022-06-22,Areado/MG,0,35,76,3102
968609,2022-06-23,Areado/MG,0,35,0,3102
974206,2022-06-24,Areado/MG,0,35,0,3102
979803,2022-06-25,Areado/MG,0,35,0,3102
985400,2022-06-26,Areado/MG,0,35,0,3102
990997,2022-06-27,Areado/MG,0,35,0,3102
996594,2022-06-28,Areado/MG,0,35,0,3102
1002191,2022-06-29,Areado/MG,0,35,51,3153
1007788,2022-06-30,Areado/MG,0,35,0,3153
1013385,2022-07-01,Areado/MG,0,35,0,3153
1018982,2022-07-02,Areado/MG,0,35,0,3153
1024579,2022-07-03,Areado/MG,0,35,0,3153
1030176,2022-07-04,Areado/MG,0,35,0,3153
1035773,2022-07-05,Areado/MG,0,35,0,3153
1041370,2022-07-06,Areado/MG,0,35,46,3199
1046967,2022-07-07,Areado/MG,0,35,0,3199
1052564,2022-07-08,Areado/MG,0,35,0,3199
1058161,2022-07-09,Areado/MG,0,35,0,3199
1063758,2022-07-10,Areado/MG,0,35,0,3199
1069355,2022-07-11,Areado/MG,0,35,0,3199
1074952,2022-07-12,Areado/MG,0,35,0,3199
1080549,2022-07-13,Areado/MG,0,35,41,3240
1086146,2022-07-14,Areado/MG,0,35,0,3240
1091743,2022-07-15,Areado/MG,0,35,0,3240
1097340,2022-07-16,Areado/MG,0,35,0,3240
1102937,2022-07-17,Areado/MG,0,35,0,3240
1108534,2022-07-18,Areado/MG,0,35,0,3240
1114131,2022-07-19,Areado/MG,0,35,0,3240
1119728,2022-07-20,Areado/MG,0,35,37,3277
1125325,2022-07-21,Areado/MG,0,35,0,3277
1130922,2022-07-22,Areado/MG,0,35,0,3277
1136519,2022-07-23,Areado/MG,0,35,0,3277
1142116,2022-07-24,Areado/MG,0,35,0,3277
1147713,2022-07-25,Areado/MG,0,35,0,3277
1153310,2022-07-26,Areado/MG,0,35,0,3277
1158907,2022-07-27,Areado/MG,0,35,14,3291
1164504,2022-07-28,Areado/MG,0,35,0,3291
1170101,2022-07-29,Areado/MG,0,35,0,3291
1175698,2022-07-30,Areado/MG,0,35,0,3291
1181295,2022-07-31,Areado/MG,0,35,0,3291
1186892,2022-08-01,Areado/MG,0,35,0,3291
1192489,2022-08-02,Areado/MG,0,35,0,3291
1198086,2022-08-03,Areado/MG,0,35,0,3291
1203683,2022-08-04,Areado/MG,0,35,15,3306
1209280,2022-08-05,Areado/MG,0,35,0,3306
1214877,2022-08-06,Areado/MG,0,35,0,3306
1220474,2022-08-07,Areado/MG,0,35,0,3306
1226071,2022-08-08,Areado/MG,0,35,0,3306
1231668,2022-08-09,Areado/MG,0,35,0,3306
1237265,2022-08-10,Areado/MG,0,35,6,3312
1242862,2022-08-11,Areado/MG,0,35,0,3312
1248459,2022-08-12,Areado/MG,0,35,0,3312
1254056,2022-08-13,Areado/MG,0,35,0,3312
1259653,2022-08-14,Areado/MG,0,35,0,3312
1265250,2022-08-15,Areado/MG,0,35,0,3312
1270847,2022-08-16,Areado/MG,0,35,0,3312
1276444,2022-08-17,Areado/MG,0,35,6,3318
1282041,2022-08-18,Areado/MG,0,35,0,3318
1287638,2022-08-19,Areado/MG,0,35,0,3318
1293235,2022-08-20,Areado/MG,0,35,0,3318
1298832,2022-08-21,Areado/MG,0,35,0,3318
1304429,2022-08-22,Areado/MG,0,35,0,3318
1310026,2022-08-23,Areado/MG,0,35,0,3318
1315623,2022-08-24,Areado/MG,0,35,4,3322
1321220,2022-08-25,Areado/MG,0,35,0,3322
416,2022-01-01,Baependi/MG,0,33,0,1767
6013,2022-01-02,Baependi/MG,0,33,0,1767
11610,2022-01-03,Baependi/MG,0,33,0,1767
17207,2022-01-04,Baependi/MG,0,33,15,1782
22804,2022-01-05,Baependi/MG,0,33,3,1785
28401,2022-01-06,Baependi/MG,0,33,44,1829
33998,2022-01-07,Baependi/MG,0,33,43,1872
39595,2022-01-08,Baependi/MG,0,33,0,1872
45192,2022-01-09,Baependi/MG,0,33,32,1904
50789,2022-01-10,Baependi/MG,0,33,0,1904
56386,2022-01-11,Baependi/MG,0,33,35,1939
61983,2022-01-12,Baependi/MG,0,33,0,1939
67580,2022-01-13,Baependi/MG,0,33,99,2038
73177,2022-01-14,Baependi/MG,0,33,52,2090
78774,2022-01-15,Baependi/MG,0,33,43,2133
84371,2022-01-16,Baependi/MG,0,33,0,2133
89968,2022-01-17,Baependi/MG,0,33,20,2153
95565,2022-01-18,Baependi/MG,0,33,24,2177
101162,2022-01-19,Baependi/MG,0,33,73,2250
106759,2022-01-20,Baependi/MG,0,33,47,2297
112356,2022-01-21,Baependi/MG,0,33,30,2327
117953,2022-01-22,Baependi/MG,0,33,40,2367
123550,2022-01-23,Baependi/MG,0,33,32,2399
129147,2022-01-24,Baependi/MG,0,33,0,2399
134744,2022-01-25,Baependi/MG,0,33,14,2413
140341,2022-01-26,Baependi/MG,0,33,67,2480
145938,2022-01-27,Baependi/MG,0,33,22,2502
151535,2022-01-28,Baependi/MG,0,33,47,2549
157132,2022-01-29,Baependi/MG,0,33,44,2593
162729,2022-01-30,Baependi/MG,0,33,20,2613
168326,2022-01-31,Baependi/MG,0,33,0,2613
173923,2022-02-01,Baependi/MG,0,33,0,2613
179520,2022-02-02,Baependi/MG,2,35,31,2644
185117,2022-02-03,Baependi/MG,1,36,21,2665
190714,2022-02-04,Baependi/MG,0,36,12,2677
196311,2022-02-05,Baependi/MG,0,36,20,2697
201908,2022-02-06,Baependi/MG,0,36,33,2730
207505,2022-02-07,Baependi/MG,0,36,0,2730
213102,2022-02-08,Baependi/MG,0,36,0,2730
218699,2022-02-09,Baependi/MG,0,36,18,2748
224296,2022-02-10,Baependi/MG,0,36,11,2759
229893,2022-02-11,Baependi/MG,0,36,10,2769
235490,2022-02-12,Baependi/MG,0,36,5,2774
241087,2022-02-13,Baependi/MG,0,36,5,2779
246684,2022-02-14,Baependi/MG,0,36,0,2779
252281,2022-02-15,Baependi/MG,0,36,2,2781
257878,2022-02-16,Baependi/MG,0,36,10,2791
263475,2022-02-17,Baependi/MG,0,36,3,2794
269072,2022-02-18,Baependi/MG,0,36,6,2800
274669,2022-02-19,Baependi/MG,-1,35,8,2808
280266,2022-02-20,Baependi/MG,0,35,3,2811
285863,2022-02-21,Baependi/MG,0,35,0,2811
291460,2022-02-22,Baependi/MG,0,35,4,2815
297057,2022-02-23,Baependi/MG,1,36,12,2827
302654,2022-02-24,Baependi/MG,0,36,7,2834
308251,2022-02-25,Baependi/MG,0,36,2,2836
313848,2022-02-26,Baependi/MG,0,36,7,2843
319445,2022-02-27,Baependi/MG,0,36,3,2846
325042,2022-02-28,Baependi/MG,0,36,0,2846
330639,2022-03-01,Baependi/MG,0,36,4,2850
336236,2022-03-02,Baependi/MG,0,36,0,2850
341833,2022-03-03,Baependi/MG,0,36,0,2850
347430,2022-03-04,Baependi/MG,0,36,3,2853
353027,2022-03-05,Baependi/MG,0,36,4,2857
358624,2022-03-06,Baependi/MG,0,36,5,2862
364221,2022-03-07,Baependi/MG,0,36,3,2865
369818,2022-03-08,Baependi/MG,0,36,2,2867
375415,2022-03-09,Baependi/MG,0,36,1,2868
381012,2022-03-10,Baependi/MG,0,36,2,2870
386609,2022-03-11,Baependi/MG,0,36,6,2876
392206,2022-03-12,Baependi/MG,0,36,2,2878
397803,2022-03-13,Baependi/MG,0,36,1,2879
403400,2022-03-14,Baependi/MG,0,36,0,2879
408997,2022-03-15,Baependi/MG,0,36,0,2879
414594,2022-03-16,Baependi/MG,0,36,3,2882
420191,2022-03-17,Baependi/MG,0,36,2,2884
425788,2022-03-18,Baependi/MG,0,36,1,2885
431385,2022-03-19,Baependi/MG,0,36,2,2887
436982,2022-03-20,Baependi/MG,0,36,0,2887
442579,2022-03-21,Baependi/MG,0,36,0,2887
448176,2022-03-22,Baependi/MG,0,36,1,2888
453773,2022-03-23,Baependi/MG,0,36,0,2888
459370,2022-03-24,Baependi/MG,0,36,5,2893
464967,2022-03-25,Baependi/MG,0,36,1,2894
470564,2022-03-26,Baependi/MG,0,36,0,2894
476161,2022-03-27,Baependi/MG,0,36,0,2894
481758,2022-03-28,Baependi/MG,0,36,0,2894
487355,2022-03-29,Baependi/MG,0,36,0,2894
492952,2022-03-30,Baependi/MG,0,36,2,2896
498549,2022-03-31,Baependi/MG,1,37,1,2897
504146,2022-04-01,Baependi/MG,0,37,0,2897
509743,2022-04-02,Baependi/MG,0,37,0,2897
515340,2022-04-03,Baependi/MG,0,37,0,2897
520937,2022-04-04,Baependi/MG,0,37,1,2898
526534,2022-04-05,Baependi/MG,0,37,0,2898
532131,2022-04-06,Baependi/MG,0,37,0,2898
537728,2022-04-07,Baependi/MG,0,37,2,2900
543325,2022-04-08,Baependi/MG,0,37,0,2900
548922,2022-04-09,Baependi/MG,0,37,0,2900
554519,2022-04-10,Baependi/MG,0,37,0,2900
560116,2022-04-11,Baependi/MG,0,37,0,2900
565713,2022-04-12,Baependi/MG,0,37,0,2900
571310,2022-04-13,Baependi/MG,0,37,0,2900
576907,2022-04-14,Baependi/MG,0,37,0,2900
582504,2022-04-15,Baependi/MG,0,37,0,2900
588101,2022-04-16,Baependi/MG,0,37,0,2900
593698,2022-04-17,Baependi/MG,0,37,0,2900
599295,2022-04-18,Baependi/MG,0,37,0,2900
604892,2022-04-19,Baependi/MG,0,37,0,2900
610489,2022-04-20,Baependi/MG,0,37,0,2900
616086,2022-04-21,Baependi/MG,0,37,1,2901
621683,2022-04-22,Baependi/MG,0,37,0,2901
627280,2022-04-23,Baependi/MG,0,37,0,2901
632877,2022-04-24,Baependi/MG,0,37,0,2901
638474,2022-04-25,Baependi/MG,0,37,0,2901
644071,2022-04-26,Baependi/MG,0,37,0,2901
649668,2022-04-27,Baependi/MG,0,37,1,2902
655265,2022-04-28,Baependi/MG,0,37,1,2903
660862,2022-04-29,Baependi/MG,0,37,1,2904
666459,2022-04-30,Baependi/MG,0,37,1,2905
672056,2022-05-01,Baependi/MG,0,37,1,2906
677653,2022-05-02,Baependi/MG,0,37,0,2906
683250,2022-05-03,Baependi/MG,0,37,0,2906
688847,2022-05-04,Baependi/MG,0,37,0,2906
694444,2022-05-05,Baependi/MG,0,37,1,2907
700041,2022-05-06,Baependi/MG,0,37,0,2907
705638,2022-05-07,Baependi/MG,0,37,0,2907
711235,2022-05-08,Baependi/MG,0,37,0,2907
716832,2022-05-09,Baependi/MG,0,37,1,2908
722429,2022-05-10,Baependi/MG,0,37,0,2908
728026,2022-05-11,Baependi/MG,0,37,1,2909
733623,2022-05-12,Baependi/MG,0,37,2,2911
739220,2022-05-13,Baependi/MG,0,37,0,2911
744817,2022-05-14,Baependi/MG,0,37,0,2911
750414,2022-05-15,Baependi/MG,0,37,0,2911
756011,2022-05-16,Baependi/MG,0,37,-1,2910
761608,2022-05-17,Baependi/MG,0,37,0,2910
767205,2022-05-18,Baependi/MG,0,37,0,2910
772802,2022-05-19,Baependi/MG,0,37,0,2910
778399,2022-05-20,Baependi/MG,0,37,1,2911
783996,2022-05-21,Baependi/MG,0,37,0,2911
789593,2022-05-22,Baependi/MG,0,37,0,2911
795190,2022-05-23,Baependi/MG,0,37,1,2912
800787,2022-05-24,Baependi/MG,0,37,0,2912
806384,2022-05-25,Baependi/MG,1,38,0,2912
811981,2022-05-26,Baependi/MG,0,38,2,2914
817578,2022-05-27,Baependi/MG,0,38,1,2915
823175,2022-05-28,Baependi/MG,0,38,0,2915
828772,2022-05-29,Baependi/MG,0,38,0,2915
834369,2022-05-30,Baependi/MG,0,38,2,2917
839966,2022-05-31,Baependi/MG,0,38,2,2919
845563,2022-06-01,Baependi/MG,0,38,0,2919
851160,2022-06-02,Baependi/MG,0,38,4,2923
856757,2022-06-03,Baependi/MG,0,38,6,2929
862354,2022-06-04,Baependi/MG,0,38,0,2929
867951,2022-06-05,Baependi/MG,0,38,0,2929
873548,2022-06-06,Baependi/MG,0,38,9,2938
879145,2022-06-07,Baependi/MG,0,38,7,2945
884742,2022-06-08,Baependi/MG,0,38,17,2962
890339,2022-06-09,Baependi/MG,0,38,5,2967
895936,2022-06-10,Baependi/MG,0,38,5,2972
901533,2022-06-11,Baependi/MG,0,38,0,2972
907130,2022-06-12,Baependi/MG,0,38,0,2972
912727,2022-06-13,Baependi/MG,0,38,15,2987
918324,2022-06-14,Baependi/MG,0,38,7,2994
923921,2022-06-15,Baependi/MG,0,38,4,2998
929518,2022-06-16,Baependi/MG,0,38,0,2998
935115,2022-06-17,Baependi/MG,0,38,0,2998
940712,2022-06-18,Baependi/MG,0,38,0,2998
946309,2022-06-19,Baependi/MG,0,38,0,2998
951906,2022-06-20,Baependi/MG,0,38,22,3020
957503,2022-06-21,Baependi/MG,0,38,11,3031
963100,2022-06-22,Baependi/MG,0,38,7,3038
968697,2022-06-23,Baependi/MG,0,38,18,3056
974294,2022-06-24,Baependi/MG,0,38,13,3069
979891,2022-06-25,Baependi/MG,0,38,0,3069
985488,2022-06-26,Baependi/MG,0,38,0,3069
991085,2022-06-27,Baependi/MG,0,38,35,3104
996682,2022-06-28,Baependi/MG,0,38,18,3122
1002279,2022-06-29,Baependi/MG,0,38,15,3137
1007876,2022-06-30,Baependi/MG,0,38,13,3150
1013473,2022-07-01,Baependi/MG,0,38,15,3165
1019070,2022-07-02,Baependi/MG,0,38,0,3165
1024667,2022-07-03,Baependi/MG,0,38,0,3165
1030264,2022-07-04,Baependi/MG,0,38,37,3202
1035861,2022-07-05,Baependi/MG,0,38,0,3202
1041458,2022-07-06,Baependi/MG,0,38,20,3222
1047055,2022-07-07,Baependi/MG,0,38,9,3231
1052652,2022-07-08,Baependi/MG,0,38,0,3231
1058249,2022-07-09,Baependi/MG,0,38,0,3231
1063846,2022-07-10,Baependi/MG,0,38,0,3231
1069443,2022-07-11,Baependi/MG,0,38,23,3254
1075040,2022-07-12,Baependi/MG,0,38,9,3263
1080637,2022-07-13,Baependi/MG,0,38,0,3263
1086234,2022-07-14,Baependi/MG,0,38,37,3300
1091831,2022-07-15,Baependi/MG,0,38,20,3320
1097428,2022-07-16,Baependi/MG,0,38,0,3320
1103025,2022-07-17,Baependi/MG,0,38,0,3320
1108622,2022-07-18,Baependi/MG,0,38,8,3328
1114219,2022-07-19,Baependi/MG,0,38,5,3333
1119816,2022-07-20,Baependi/MG,0,38,7,3340
1125413,2022-07-21,Baependi/MG,0,38,3,3343
1131010,2022-07-22,Baependi/MG,0,38,0,3343
1136607,2022-07-23,Baependi/MG,0,38,0,3343
1142204,2022-07-24,Baependi/MG,0,38,0,3343
1147801,2022-07-25,Baependi/MG,0,38,11,3354
1153398,2022-07-26,Baependi/MG,0,38,4,3358
1158995,2022-07-27,Baependi/MG,0,38,7,3365
1164592,2022-07-28,Baependi/MG,0,38,9,3374
1170189,2022-07-29,Baependi/MG,0,38,8,3382
1175786,2022-07-30,Baependi/MG,0,38,0,3382
1181383,2022-07-31,Baependi/MG,0,38,0,3382
1186980,2022-08-01,Baependi/MG,0,38,9,3391
1192577,2022-08-02,Baependi/MG,0,38,12,3403
1198174,2022-08-03,Baependi/MG,0,38,0,3403
1203771,2022-08-04,Baependi/MG,0,38,0,3403
1209368,2022-08-05,Baependi/MG,0,38,21,3424
1214965,2022-08-06,Baependi/MG,0,38,0,3424
1220562,2022-08-07,Baependi/MG,0,38,0,3424
1226159,2022-08-08,Baependi/MG,0,38,13,3437
1231756,2022-08-09,Baependi/MG,0,38,3,3440
1237353,2022-08-10,Baependi/MG,0,38,16,3456
1242950,2022-08-11,Baependi/MG,0,38,0,3456
1248547,2022-08-12,Baependi/MG,0,38,6,3462
1254144,2022-08-13,Baependi/MG,0,38,0,3462
1259741,2022-08-14,Baependi/MG,0,38,0,3462
1265338,2022-08-15,Baependi/MG,0,38,0,3462
1270935,2022-08-16,Baependi/MG,0,38,6,3468
1276532,2022-08-17,Baependi/MG,0,38,5,3473
1282129,2022-08-18,Baependi/MG,0,38,4,3477
1287726,2022-08-19,Baependi/MG,0,38,3,3480
1293323,2022-08-20,Baependi/MG,0,38,0,3480
1298920,2022-08-21,Baependi/MG,0,38,0,3480
1304517,2022-08-22,Baependi/MG,0,38,11,3491
1310114,2022-08-23,Baependi/MG,0,38,0,3491
1315711,2022-08-24,Baependi/MG,0,38,7,3498
1321308,2022-08-25,Baependi/MG,0,38,6,3504
599,2022-01-01,Boa Esperança/MG,0,145,0,5076
6196,2022-01-02,Boa Esperança/MG,0,145,0,5076
11793,2022-01-03,Boa Esperança/MG,0,145,2,5078
17390,2022-01-04,Boa Esperança/MG,0,145,0,5078
22987,2022-01-05,Boa Esperança/MG,0,145,6,5084
28584,2022-01-06,Boa Esperança/MG,0,145,10,5094
34181,2022-01-07,Boa Esperança/MG,0,145,13,5107
39778,2022-01-08,Boa Esperança/MG,0,145,41,5148
45375,2022-01-09,Boa Esperança/MG,0,145,22,5170
50972,2022-01-10,Boa Esperança/MG,0,145,0,5170
56569,2022-01-11,Boa Esperança/MG,0,145,0,5170
62166,2022-01-12,Boa Esperança/MG,0,145,68,5238
67763,2022-01-13,Boa Esperança/MG,0,145,51,5289
73360,2022-01-14,Boa Esperança/MG,0,145,33,5322
78957,2022-01-15,Boa Esperança/MG,0,145,63,5385
84554,2022-01-16,Boa Esperança/MG,0,145,0,5385
90151,2022-01-17,Boa Esperança/MG,0,145,46,5431
95748,2022-01-18,Boa Esperança/MG,0,145,0,5431
101345,2022-01-19,Boa Esperança/MG,0,145,111,5542
106942,2022-01-20,Boa Esperança/MG,0,145,79,5621
112539,2022-01-21,Boa Esperança/MG,0,145,61,5682
118136,2022-01-22,Boa Esperança/MG,0,145,107,5789
123733,2022-01-23,Boa Esperança/MG,0,145,91,5880
129330,2022-01-24,Boa Esperança/MG,0,145,0,5880
134927,2022-01-25,Boa Esperança/MG,0,145,0,5880
140524,2022-01-26,Boa Esperança/MG,0,145,192,6072
146121,2022-01-27,Boa Esperança/MG,0,145,71,6143
151718,2022-01-28,Boa Esperança/MG,1,146,109,6252
157315,2022-01-29,Boa Esperança/MG,0,146,109,6361
162912,2022-01-30,Boa Esperança/MG,0,146,57,6418
168509,2022-01-31,Boa Esperança/MG,0,146,0,6418
174106,2022-02-01,Boa Esperança/MG,0,146,0,6418
179703,2022-02-02,Boa Esperança/MG,0,146,129,6547
185300,2022-02-03,Boa Esperança/MG,0,146,100,6647
190897,2022-02-04,Boa Esperança/MG,0,146,86,6733
196494,2022-02-05,Boa Esperança/MG,0,146,50,6783
202091,2022-02-06,Boa Esperança/MG,0,146,112,6895
207688,2022-02-07,Boa Esperança/MG,0,146,0,6895
213285,2022-02-08,Boa Esperança/MG,0,146,0,6895
218882,2022-02-09,Boa Esperança/MG,0,146,121,7016
224479,2022-02-10,Boa Esperança/MG,0,146,99,7115
230076,2022-02-11,Boa Esperança/MG,1,147,0,7115
235673,2022-02-12,Boa Esperança/MG,0,147,103,7218
241270,2022-02-13,Boa Esperança/MG,0,147,57,7275
246867,2022-02-14,Boa Esperança/MG,0,147,0,7275
252464,2022-02-15,Boa Esperança/MG,0,147,0,7275
258061,2022-02-16,Boa Esperança/MG,0,147,78,7353
263658,2022-02-17,Boa Esperança/MG,0,147,63,7416
269255,2022-02-18,Boa Esperança/MG,1,148,49,7465
274852,2022-02-19,Boa Esperança/MG,0,148,45,7510
280449,2022-02-20,Boa Esperança/MG,0,148,64,7574
286046,2022-02-21,Boa Esperança/MG,0,148,0,7574
291643,2022-02-22,Boa Esperança/MG,0,148,0,7574
297240,2022-02-23,Boa Esperança/MG,0,148,46,7620
302837,2022-02-24,Boa Esperança/MG,0,148,28,7648
308434,2022-02-25,Boa Esperança/MG,0,148,24,7672
314031,2022-02-26,Boa Esperança/MG,0,148,16,7688
319628,2022-02-27,Boa Esperança/MG,0,148,25,7713
325225,2022-02-28,Boa Esperança/MG,0,148,0,7713
330822,2022-03-01,Boa Esperança/MG,0,148,0,7713
336419,2022-03-02,Boa Esperança/MG,0,148,0,7713
342016,2022-03-03,Boa Esperança/MG,0,148,0,7713
347613,2022-03-04,Boa Esperança/MG,0,148,0,7713
353210,2022-03-05,Boa Esperança/MG,0,148,56,7769
358807,2022-03-06,Boa Esperança/MG,0,148,0,7769
364404,2022-03-07,Boa Esperança/MG,0,148,24,7793
370001,2022-03-08,Boa Esperança/MG,0,148,0,7793
375598,2022-03-09,Boa Esperança/MG,1,149,25,7818
381195,2022-03-10,Boa Esperança/MG,0,149,9,7827
386792,2022-03-11,Boa Esperança/MG,0,149,5,7832
392389,2022-03-12,Boa Esperança/MG,0,149,0,7832
397986,2022-03-13,Boa Esperança/MG,0,149,9,7841
403583,2022-03-14,Boa Esperança/MG,0,149,0,7841
409180,2022-03-15,Boa Esperança/MG,1,150,0,7841
414777,2022-03-16,Boa Esperança/MG,1,151,15,7856
420374,2022-03-17,Boa Esperança/MG,0,151,5,7861
425971,2022-03-18,Boa Esperança/MG,0,151,5,7866
431568,2022-03-19,Boa Esperança/MG,0,151,4,7870
437165,2022-03-20,Boa Esperança/MG,0,151,6,7876
442762,2022-03-21,Boa Esperança/MG,0,151,0,7876
448359,2022-03-22,Boa Esperança/MG,0,151,0,7876
453956,2022-03-23,Boa Esperança/MG,0,151,11,7887
459553,2022-03-24,Boa Esperança/MG,0,151,2,7889
465150,2022-03-25,Boa Esperança/MG,0,151,2,7891
470747,2022-03-26,Boa Esperança/MG,0,151,0,7891
476344,2022-03-27,Boa Esperança/MG,0,151,0,7891
481941,2022-03-28,Boa Esperança/MG,0,151,0,7891
487538,2022-03-29,Boa Esperança/MG,0,151,1,7892
493135,2022-03-30,Boa Esperança/MG,0,151,2,7894
498732,2022-03-31,Boa Esperança/MG,0,151,2,7896
504329,2022-04-01,Boa Esperança/MG,0,151,2,7898
509926,2022-04-02,Boa Esperança/MG,0,151,0,7898
515523,2022-04-03,Boa Esperança/MG,0,151,0,7898
521120,2022-04-04,Boa Esperança/MG,0,151,4,7902
526717,2022-04-05,Boa Esperança/MG,0,151,3,7905
532314,2022-04-06,Boa Esperança/MG,0,151,3,7908
537911,2022-04-07,Boa Esperança/MG,0,151,2,7910
543508,2022-04-08,Boa Esperança/MG,1,152,4,7914
549105,2022-04-09,Boa Esperança/MG,0,152,2,7916
554702,2022-04-10,Boa Esperança/MG,0,152,0,7916
560299,2022-04-11,Boa Esperança/MG,0,152,0,7916
565896,2022-04-12,Boa Esperança/MG,0,152,0,7916
571493,2022-04-13,Boa Esperança/MG,0,152,1,7917
577090,2022-04-14,Boa Esperança/MG,0,152,1,7918
582687,2022-04-15,Boa Esperança/MG,0,152,0,7918
588284,2022-04-16,Boa Esperança/MG,0,152,0,7918
593881,2022-04-17,Boa Esperança/MG,0,152,0,7918
599478,2022-04-18,Boa Esperança/MG,0,152,0,7918
605075,2022-04-19,Boa Esperança/MG,0,152,0,7918
610672,2022-04-20,Boa Esperança/MG,0,152,1,7919
616269,2022-04-21,Boa Esperança/MG,0,152,0,7919
621866,2022-04-22,Boa Esperança/MG,0,152,0,7919
627463,2022-04-23,Boa Esperança/MG,0,152,0,7919
633060,2022-04-24,Boa Esperança/MG,0,152,0,7919
638657,2022-04-25,Boa Esperança/MG,0,152,0,7919
644254,2022-04-26,Boa Esperança/MG,0,152,0,7919
649851,2022-04-27,Boa Esperança/MG,0,152,0,7919
655448,2022-04-28,Boa Esperança/MG,0,152,0,7919
661045,2022-04-29,Boa Esperança/MG,0,152,1,7920
666642,2022-04-30,Boa Esperança/MG,0,152,1,7921
672239,2022-05-01,Boa Esperança/MG,0,152,0,7921
677836,2022-05-02,Boa Esperança/MG,0,152,0,7921
683433,2022-05-03,Boa Esperança/MG,0,152,2,7923
689030,2022-05-04,Boa Esperança/MG,0,152,0,7923
694627,2022-05-05,Boa Esperança/MG,0,152,1,7924
700224,2022-05-06,Boa Esperança/MG,0,152,1,7925
705821,2022-05-07,Boa Esperança/MG,0,152,0,7925
711418,2022-05-08,Boa Esperança/MG,0,152,0,7925
717015,2022-05-09,Boa Esperança/MG,0,152,1,7926
722612,2022-05-10,Boa Esperança/MG,0,152,1,7927
728209,2022-05-11,Boa Esperança/MG,0,152,0,7927
733806,2022-05-12,Boa Esperança/MG,0,152,2,7929
739403,2022-05-13,Boa Esperança/MG,0,152,1,7930
745000,2022-05-14,Boa Esperança/MG,0,152,0,7930
750597,2022-05-15,Boa Esperança/MG,0,152,0,7930
756194,2022-05-16,Boa Esperança/MG,0,152,1,7931
761791,2022-05-17,Boa Esperança/MG,0,152,1,7932
767388,2022-05-18,Boa Esperança/MG,0,152,3,7935
772985,2022-05-19,Boa Esperança/MG,0,152,7,7942
778582,2022-05-20,Boa Esperança/MG,0,152,1,7943
784179,2022-05-21,Boa Esperança/MG,0,152,0,7943
789776,2022-05-22,Boa Esperança/MG,0,152,0,7943
795373,2022-05-23,Boa Esperança/MG,0,152,3,7946
800970,2022-05-24,Boa Esperança/MG,0,152,2,7948
806567,2022-05-25,Boa Esperança/MG,0,152,0,7948
812164,2022-05-26,Boa Esperança/MG,0,152,5,7953
817761,2022-05-27,Boa Esperança/MG,0,152,8,7961
823358,2022-05-28,Boa Esperança/MG,0,152,0,7961
828955,2022-05-29,Boa Esperança/MG,0,152,0,7961
834552,2022-05-30,Boa Esperança/MG,0,152,15,7976
840149,2022-05-31,Boa Esperança/MG,0,152,0,7976
845746,2022-06-01,Boa Esperança/MG,0,152,15,7991
851343,2022-06-02,Boa Esperança/MG,0,152,2,7993
856940,2022-06-03,Boa Esperança/MG,0,152,11,8004
862537,2022-06-04,Boa Esperança/MG,0,152,0,8004
868134,2022-06-05,Boa Esperança/MG,0,152,0,8004
873731,2022-06-06,Boa Esperança/MG,0,152,48,8052
879328,2022-06-07,Boa Esperança/MG,0,152,0,8052
884925,2022-06-08,Boa Esperança/MG,0,152,33,8085
890522,2022-06-09,Boa Esperança/MG,0,152,17,8102
896119,2022-06-10,Boa Esperança/MG,0,152,26,8128
901716,2022-06-11,Boa Esperança/MG,0,152,0,8128
907313,2022-06-12,Boa Esperança/MG,0,152,0,8128
912910,2022-06-13,Boa Esperança/MG,0,152,59,8187
918507,2022-06-14,Boa Esperança/MG,0,152,0,8187
924104,2022-06-15,Boa Esperança/MG,0,152,27,8214
929701,2022-06-16,Boa Esperança/MG,0,152,0,8214
935298,2022-06-17,Boa Esperança/MG,0,152,0,8214
940895,2022-06-18,Boa Esperança/MG,0,152,0,8214
946492,2022-06-19,Boa Esperança/MG,0,152,0,8214
952089,2022-06-20,Boa Esperança/MG,0,152,31,8245
957686,2022-06-21,Boa Esperança/MG,0,152,20,8265
963283,2022-06-22,Boa Esperança/MG,0,152,21,8286
968880,2022-06-23,Boa Esperança/MG,0,152,35,8321
974477,2022-06-24,Boa Esperança/MG,0,152,27,8348
980074,2022-06-25,Boa Esperança/MG,0,152,0,8348
985671,2022-06-26,Boa Esperança/MG,0,152,0,8348
991268,2022-06-27,Boa Esperança/MG,0,152,36,8384
996865,2022-06-28,Boa Esperança/MG,0,152,0,8384
1002462,2022-06-29,Boa Esperança/MG,0,152,23,8407
1008059,2022-06-30,Boa Esperança/MG,0,152,8,8415
1013656,2022-07-01,Boa Esperança/MG,0,152,0,8415
1019253,2022-07-02,Boa Esperança/MG,0,152,0,8415
1024850,2022-07-03,Boa Esperança/MG,0,152,0,8415
1030447,2022-07-04,Boa Esperança/MG,0,152,31,8446
1036044,2022-07-05,Boa Esperança/MG,0,152,24,8470
1041641,2022-07-06,Boa Esperança/MG,0,152,12,8482
1047238,2022-07-07,Boa Esperança/MG,0,152,14,8496
1052835,2022-07-08,Boa Esperança/MG,0,152,9,8505
1058432,2022-07-09,Boa Esperança/MG,0,152,0,8505
1064029,2022-07-10,Boa Esperança/MG,0,152,0,8505
1069626,2022-07-11,Boa Esperança/MG,0,152,16,8521
1075223,2022-07-12,Boa Esperança/MG,0,152,0,8521
1080820,2022-07-13,Boa Esperança/MG,0,152,15,8536
1086417,2022-07-14,Boa Esperança/MG,0,152,11,8547
1092014,2022-07-15,Boa Esperança/MG,0,152,5,8552
1097611,2022-07-16,Boa Esperança/MG,0,152,0,8552
1103208,2022-07-17,Boa Esperança/MG,0,152,0,8552
1108805,2022-07-18,Boa Esperança/MG,0,152,8,8560
1114402,2022-07-19,Boa Esperança/MG,0,152,10,8570
1119999,2022-07-20,Boa Esperança/MG,0,152,13,8583
1125596,2022-07-21,Boa Esperança/MG,0,152,0,8583
1131193,2022-07-22,Boa Esperança/MG,0,152,15,8598
1136790,2022-07-23,Boa Esperança/MG,0,152,0,8598
1142387,2022-07-24,Boa Esperança/MG,0,152,0,8598
1147984,2022-07-25,Boa Esperança/MG,0,152,7,8605
1153581,2022-07-26,Boa Esperança/MG,0,152,0,8605
1159178,2022-07-27,Boa Esperança/MG,0,152,0,8605
1164775,2022-07-28,Boa Esperança/MG,0,152,0,8605
1170372,2022-07-29,Boa Esperança/MG,0,152,0,8605
1175969,2022-07-30,Boa Esperança/MG,0,152,0,8605
1181566,2022-07-31,Boa Esperança/MG,0,152,0,8605
1187163,2022-08-01,Boa Esperança/MG,0,152,0,8605
1192760,2022-08-02,Boa Esperança/MG,0,152,0,8605
1198357,2022-08-03,Boa Esperança/MG,0,152,0,8605
1203954,2022-08-04,Boa Esperança/MG,0,152,0,8605
1209551,2022-08-05,Boa Esperança/MG,0,152,0,8605
1215148,2022-08-06,Boa Esperança/MG,0,152,0,8605
1220745,2022-08-07,Boa Esperança/MG,0,152,0,8605
1226342,2022-08-08,Boa Esperança/MG,0,152,41,8646
1231939,2022-08-09,Boa Esperança/MG,0,152,3,8649
1237536,2022-08-10,Boa Esperança/MG,0,152,4,8653
1243133,2022-08-11,Boa Esperança/MG,0,152,5,8658
1248730,2022-08-12,Boa Esperança/MG,0,152,0,8658
1254327,2022-08-13,Boa Esperança/MG,0,152,0,8658
1259924,2022-08-14,Boa Esperança/MG,0,152,0,8658
1265521,2022-08-15,Boa Esperança/MG,0,152,0,8658
1271118,2022-08-16,Boa Esperança/MG,0,152,6,8664
1276715,2022-08-17,Boa Esperança/MG,0,152,6,8670
1282312,2022-08-18,Boa Esperança/MG,0,152,2,8672
1287909,2022-08-19,Boa Esperança/MG,0,152,1,8673
1293506,2022-08-20,Boa Esperança/MG,0,152,0,8673
1299103,2022-08-21,Boa Esperança/MG,0,152,0,8673
1304700,2022-08-22,Boa Esperança/MG,0,152,2,8675
1310297,2022-08-23,Boa Esperança/MG,1,153,0,8675
1315894,2022-08-24,Boa Esperança/MG,0,153,2,8677
1321491,2022-08-25,Boa Esperança/MG,0,153,2,8679
698,2022-01-01,Botelhos/MG,0,34,0,1896
6295,2022-01-02,Botelhos/MG,0,34,0,1896
11892,2022-01-03,Botelhos/MG,0,34,0,1896
17489,2022-01-04,Botelhos/MG,0,34,0,1896
23086,2022-01-05,Botelhos/MG,0,34,0,1896
28683,2022-01-06,Botelhos/MG,0,34,0,1896
34280,2022-01-07,Botelhos/MG,0,34,0,1896
39877,2022-01-08,Botelhos/MG,0,34,66,1962
45474,2022-01-09,Botelhos/MG,0,34,0,1962
51071,2022-01-10,Botelhos/MG,0,34,0,1962
56668,2022-01-11,Botelhos/MG,0,34,0,1962
62265,2022-01-12,Botelhos/MG,0,34,0,1962
67862,2022-01-13,Botelhos/MG,0,34,0,1962
73459,2022-01-14,Botelhos/MG,0,34,0,1962
79056,2022-01-15,Botelhos/MG,0,34,0,1962
84653,2022-01-16,Botelhos/MG,0,34,0,1962
90250,2022-01-17,Botelhos/MG,0,34,0,1962
95847,2022-01-18,Botelhos/MG,0,34,223,2185
101444,2022-01-19,Botelhos/MG,0,34,0,2185
107041,2022-01-20,Botelhos/MG,0,34,0,2185
112638,2022-01-21,Botelhos/MG,0,34,0,2185
118235,2022-01-22,Botelhos/MG,0,34,0,2185
123832,2022-01-23,Botelhos/MG,0,34,0,2185
129429,2022-01-24,Botelhos/MG,0,34,0,2185
135026,2022-01-25,Botelhos/MG,0,34,0,2185
140623,2022-01-26,Botelhos/MG,0,34,0,2185
146220,2022-01-27,Botelhos/MG,0,34,322,2507
151817,2022-01-28,Botelhos/MG,0,34,73,2580
157414,2022-01-29,Botelhos/MG,0,34,0,2580
163011,2022-01-30,Botelhos/MG,0,34,0,2580
168608,2022-01-31,Botelhos/MG,0,34,0,2580
174205,2022-02-01,Botelhos/MG,0,34,82,2662
179802,2022-02-02,Botelhos/MG,0,34,47,2709
185399,2022-02-03,Botelhos/MG,0,34,0,2709
190996,2022-02-04,Botelhos/MG,0,34,45,2754
196593,2022-02-05,Botelhos/MG,0,34,0,2754
202190,2022-02-06,Botelhos/MG,0,34,47,2801
207787,2022-02-07,Botelhos/MG,0,34,0,2801
213384,2022-02-08,Botelhos/MG,0,34,0,2801
218981,2022-02-09,Botelhos/MG,0,34,0,2801
224578,2022-02-10,Botelhos/MG,0,34,0,2801
230175,2022-02-11,Botelhos/MG,1,35,0,2801
235772,2022-02-12,Botelhos/MG,0,35,0,2801
241369,2022-02-13,Botelhos/MG,0,35,0,2801
246966,2022-02-14,Botelhos/MG,0,35,0,2801
252563,2022-02-15,Botelhos/MG,0,35,166,2967
258160,2022-02-16,Botelhos/MG,0,35,20,2987
263757,2022-02-17,Botelhos/MG,0,35,0,2987
269354,2022-02-18,Botelhos/MG,0,35,0,2987
274951,2022-02-19,Botelhos/MG,0,35,0,2987
280548,2022-02-20,Botelhos/MG,0,35,0,2987
286145,2022-02-21,Botelhos/MG,0,35,0,2987
291742,2022-02-22,Botelhos/MG,0,35,0,2987
297339,2022-02-23,Botelhos/MG,0,35,0,2987
302936,2022-02-24,Botelhos/MG,0,35,0,2987
308533,2022-02-25,Botelhos/MG,0,35,0,2987
314130,2022-02-26,Botelhos/MG,0,35,0,2987
319727,2022-02-27,Botelhos/MG,0,35,0,2987
325324,2022-02-28,Botelhos/MG,0,35,0,2987
330921,2022-03-01,Botelhos/MG,0,35,0,2987
336518,2022-03-02,Botelhos/MG,0,35,0,2987
342115,2022-03-03,Botelhos/MG,0,35,0,2987
347712,2022-03-04,Botelhos/MG,0,35,0,2987
353309,2022-03-05,Botelhos/MG,0,35,223,3210
358906,2022-03-06,Botelhos/MG,0,35,0,3210
364503,2022-03-07,Botelhos/MG,0,35,0,3210
370100,2022-03-08,Botelhos/MG,0,35,4,3214
375697,2022-03-09,Botelhos/MG,0,35,9,3223
381294,2022-03-10,Botelhos/MG,1,36,0,3223
386891,2022-03-11,Botelhos/MG,0,36,6,3229
392488,2022-03-12,Botelhos/MG,0,36,7,3236
398085,2022-03-13,Botelhos/MG,0,36,0,3236
403682,2022-03-14,Botelhos/MG,0,36,0,3236
409279,2022-03-15,Botelhos/MG,0,36,0,3236
414876,2022-03-16,Botelhos/MG,0,36,0,3236
420473,2022-03-17,Botelhos/MG,0,36,0,3236
426070,2022-03-18,Botelhos/MG,0,36,15,3251
431667,2022-03-19,Botelhos/MG,0,36,0,3251
437264,2022-03-20,Botelhos/MG,0,36,0,3251
442861,2022-03-21,Botelhos/MG,0,36,0,3251
448458,2022-03-22,Botelhos/MG,0,36,0,3251
454055,2022-03-23,Botelhos/MG,0,36,5,3256
459652,2022-03-24,Botelhos/MG,0,36,1,3257
465249,2022-03-25,Botelhos/MG,0,36,0,3257
470846,2022-03-26,Botelhos/MG,0,36,0,3257
476443,2022-03-27,Botelhos/MG,-1,35,0,3257
482040,2022-03-28,Botelhos/MG,0,35,0,3257
487637,2022-03-29,Botelhos/MG,0,35,0,3257
493234,2022-03-30,Botelhos/MG,0,35,0,3257
498831,2022-03-31,Botelhos/MG,0,35,0,3257
504428,2022-04-01,Botelhos/MG,0,35,0,3257
510025,2022-04-02,Botelhos/MG,0,35,0,3257
515622,2022-04-03,Botelhos/MG,0,35,0,3257
521219,2022-04-04,Botelhos/MG,0,35,0,3257
526816,2022-04-05,Botelhos/MG,0,35,0,3257
532413,2022-04-06,Botelhos/MG,0,35,0,3257
538010,2022-04-07,Botelhos/MG,0,35,0,3257
543607,2022-04-08,Botelhos/MG,0,35,0,3257
549204,2022-04-09,Botelhos/MG,0,35,0,3257
554801,2022-04-10,Botelhos/MG,0,35,0,3257
560398,2022-04-11,Botelhos/MG,0,35,0,3257
565995,2022-04-12,Botelhos/MG,0,35,0,3257
571592,2022-04-13,Botelhos/MG,0,35,0,3257
577189,2022-04-14,Botelhos/MG,0,35,0,3257
582786,2022-04-15,Botelhos/MG,0,35,0,3257
588383,2022-04-16,Botelhos/MG,0,35,0,3257
593980,2022-04-17,Botelhos/MG,0,35,0,3257
599577,2022-04-18,Botelhos/MG,0,35,0,3257
605174,2022-04-19,Botelhos/MG,0,35,0,3257
610771,2022-04-20,Botelhos/MG,0,35,0,3257
616368,2022-04-21,Botelhos/MG,0,35,0,3257
621965,2022-04-22,Botelhos/MG,0,35,0,3257
627562,2022-04-23,Botelhos/MG,0,35,0,3257
633159,2022-04-24,Botelhos/MG,0,35,0,3257
638756,2022-04-25,Botelhos/MG,0,35,0,3257
644353,2022-04-26,Botelhos/MG,0,35,0,3257
649950,2022-04-27,Botelhos/MG,0,35,0,3257
655547,2022-04-28,Botelhos/MG,0,35,0,3257
661144,2022-04-29,Botelhos/MG,0,35,0,3257
666741,2022-04-30,Botelhos/MG,0,35,0,3257
672338,2022-05-01,Botelhos/MG,0,35,0,3257
677935,2022-05-02,Botelhos/MG,0,35,0,3257
683532,2022-05-03,Botelhos/MG,0,35,0,3257
689129,2022-05-04,Botelhos/MG,0,35,0,3257
694726,2022-05-05,Botelhos/MG,0,35,0,3257
700323,2022-05-06,Botelhos/MG,0,35,0,3257
705920,2022-05-07,Botelhos/MG,0,35,0,3257
711517,2022-05-08,Botelhos/MG,0,35,0,3257
717114,2022-05-09,Botelhos/MG,0,35,0,3257
722711,2022-05-10,Botelhos/MG,0,35,0,3257
728308,2022-05-11,Botelhos/MG,0,35,0,3257
733905,2022-05-12,Botelhos/MG,0,35,0,3257
739502,2022-05-13,Botelhos/MG,0,35,40,3297
745099,2022-05-14,Botelhos/MG,0,35,0,3297
750696,2022-05-15,Botelhos/MG,0,35,0,3297
756293,2022-05-16,Botelhos/MG,0,35,3,3300
761890,2022-05-17,Botelhos/MG,0,35,7,3307
767487,2022-05-18,Botelhos/MG,0,35,0,3307
773084,2022-05-19,Botelhos/MG,0,35,10,3317
778681,2022-05-20,Botelhos/MG,0,35,0,3317
784278,2022-05-21,Botelhos/MG,0,35,0,3317
789875,2022-05-22,Botelhos/MG,0,35,0,3317
795472,2022-05-23,Botelhos/MG,0,35,14,3331
801069,2022-05-24,Botelhos/MG,0,35,3,3334
806666,2022-05-25,Botelhos/MG,0,35,13,3347
812263,2022-05-26,Botelhos/MG,0,35,3,3350
817860,2022-05-27,Botelhos/MG,0,35,11,3361
823457,2022-05-28,Botelhos/MG,0,35,0,3361
829054,2022-05-29,Botelhos/MG,0,35,0,3361
834651,2022-05-30,Botelhos/MG,0,35,12,3373
840248,2022-05-31,Botelhos/MG,0,35,10,3383
845845,2022-06-01,Botelhos/MG,0,35,31,3414
851442,2022-06-02,Botelhos/MG,0,35,23,3437
857039,2022-06-03,Botelhos/MG,0,35,22,3459
862636,2022-06-04,Botelhos/MG,0,35,0,3459
868233,2022-06-05,Botelhos/MG,0,35,0,3459
873830,2022-06-06,Botelhos/MG,0,35,39,3498
879427,2022-06-07,Botelhos/MG,0,35,40,3538
885024,2022-06-08,Botelhos/MG,0,35,39,3577
890621,2022-06-09,Botelhos/MG,0,35,0,3577
896218,2022-06-10,Botelhos/MG,0,35,20,3597
901815,2022-06-11,Botelhos/MG,0,35,0,3597
907412,2022-06-12,Botelhos/MG,0,35,0,3597
913009,2022-06-13,Botelhos/MG,0,35,13,3610
918606,2022-06-14,Botelhos/MG,0,35,11,3621
924203,2022-06-15,Botelhos/MG,0,35,40,3661
929800,2022-06-16,Botelhos/MG,0,35,0,3661
935397,2022-06-17,Botelhos/MG,0,35,0,3661
940994,2022-06-18,Botelhos/MG,0,35,0,3661
946591,2022-06-19,Botelhos/MG,0,35,0,3661
952188,2022-06-20,Botelhos/MG,0,35,24,3685
957785,2022-06-21,Botelhos/MG,0,35,0,3685
963382,2022-06-22,Botelhos/MG,0,35,0,3685
968979,2022-06-23,Botelhos/MG,0,35,0,3685
974576,2022-06-24,Botelhos/MG,0,35,0,3685
980173,2022-06-25,Botelhos/MG,0,35,0,3685
985770,2022-06-26,Botelhos/MG,0,35,0,3685
991367,2022-06-27,Botelhos/MG,0,35,0,3685
996964,2022-06-28,Botelhos/MG,0,35,0,3685
1002561,2022-06-29,Botelhos/MG,0,35,0,3685
1008158,2022-06-30,Botelhos/MG,0,35,0,3685
1013755,2022-07-01,Botelhos/MG,0,35,0,3685
1019352,2022-07-02,Botelhos/MG,0,35,0,3685
1024949,2022-07-03,Botelhos/MG,0,35,0,3685
1030546,2022-07-04,Botelhos/MG,0,35,0,3685
1036143,2022-07-05,Botelhos/MG,0,35,0,3685
1041740,2022-07-06,Botelhos/MG,0,35,0,3685
1047337,2022-07-07,Botelhos/MG,0,35,0,3685
1052934,2022-07-08,Botelhos/MG,0,35,0,3685
1058531,2022-07-09,Botelhos/MG,0,35,0,3685
1064128,2022-07-10,Botelhos/MG,0,35,0,3685
1069725,2022-07-11,Botelhos/MG,0,35,0,3685
1075322,2022-07-12,Botelhos/MG,0,35,0,3685
1080919,2022-07-13,Botelhos/MG,0,35,0,3685
1086516,2022-07-14,Botelhos/MG,0,35,0,3685
1092113,2022-07-15,Botelhos/MG,0,35,0,3685
1097710,2022-07-16,Botelhos/MG,0,35,0,3685
1103307,2022-07-17,Botelhos/MG,0,35,0,3685
1108904,2022-07-18,Botelhos/MG,0,35,0,3685
1114501,2022-07-19,Botelhos/MG,0,35,0,3685
1120098,2022-07-20,Botelhos/MG,0,35,0,3685
1125695,2022-07-21,Botelhos/MG,0,35,0,3685
1131292,2022-07-22,Botelhos/MG,1,36,0,3685
1136889,2022-07-23,Botelhos/MG,0,36,0,3685
1142486,2022-07-24,Botelhos/MG,0,36,0,3685
1148083,2022-07-25,Botelhos/MG,0,36,0,3685
1153680,2022-07-26,Botelhos/MG,0,36,0,3685
1159277,2022-07-27,Botelhos/MG,0,36,0,3685
1164874,2022-07-28,Botelhos/MG,1,37,0,3685
1170471,2022-07-29,Botelhos/MG,0,37,0,3685
1176068,2022-07-30,Botelhos/MG,0,37,0,3685
1181665,2022-07-31,Botelhos/MG,0,37,0,3685
1187262,2022-08-01,Botelhos/MG,0,37,0,3685
1192859,2022-08-02,Botelhos/MG,0,37,0,3685
1198456,2022-08-03,Botelhos/MG,0,37,0,3685
1204053,2022-08-04,Botelhos/MG,0,37,0,3685
1209650,2022-08-05,Botelhos/MG,0,37,0,3685
1215247,2022-08-06,Botelhos/MG,0,37,0,3685
1220844,2022-08-07,Botelhos/MG,0,37,0,3685
1226441,2022-08-08,Botelhos/MG,0,37,0,3685
1232038,2022-08-09,Botelhos/MG,0,37,0,3685
1237635,2022-08-10,Botelhos/MG,0,37,0,3685
1243232,2022-08-11,Botelhos/MG,0,37,0,3685
1248829,2022-08-12,Botelhos/MG,0,37,0,3685
1254426,2022-08-13,Botelhos/MG,0,37,0,3685
1260023,2022-08-14,Botelhos/MG,0,37,0,3685
1265620,2022-08-15,Botelhos/MG,0,37,0,3685
1271217,2022-08-16,Botelhos/MG,0,37,0,3685
1276814,2022-08-17,Botelhos/MG,0,37,0,3685
1282411,2022-08-18,Botelhos/MG,0,37,0,3685
1288008,2022-08-19,Botelhos/MG,0,37,0,3685
1293605,2022-08-20,Botelhos/MG,0,37,0,3685
1299202,2022-08-21,Botelhos/MG,0,37,0,3685
1304799,2022-08-22,Botelhos/MG,0,37,0,3685
1310396,2022-08-23,Botelhos/MG,0,37,0,3685
1315993,2022-08-24,Botelhos/MG,0,37,0,3685
1321590,2022-08-25,Botelhos/MG,0,37,0,3685
890,2022-01-01,Caldas/MG,0,39,0,1050
6487,2022-01-02,Caldas/MG,0,39,0,1050
12084,2022-01-03,Caldas/MG,0,39,0,1050
17681,2022-01-04,Caldas/MG,0,39,4,1054
23278,2022-01-05,Caldas/MG,0,39,0,1054
28875,2022-01-06,Caldas/MG,0,39,8,1062
34472,2022-01-07,Caldas/MG,0,39,15,1077
40069,2022-01-08,Caldas/MG,0,39,12,1089
45666,2022-01-09,Caldas/MG,0,39,0,1089
51263,2022-01-10,Caldas/MG,0,39,0,1089
56860,2022-01-11,Caldas/MG,0,39,0,1089
62457,2022-01-12,Caldas/MG,0,39,0,1089
68054,2022-01-13,Caldas/MG,0,39,0,1089
73651,2022-01-14,Caldas/MG,0,39,58,1147
79248,2022-01-15,Caldas/MG,0,39,29,1176
84845,2022-01-16,Caldas/MG,0,39,0,1176
90442,2022-01-17,Caldas/MG,0,39,0,1176
96039,2022-01-18,Caldas/MG,0,39,0,1176
101636,2022-01-19,Caldas/MG,0,39,66,1242
107233,2022-01-20,Caldas/MG,0,39,0,1242
112830,2022-01-21,Caldas/MG,0,39,0,1242
118427,2022-01-22,Caldas/MG,0,39,0,1242
124024,2022-01-23,Caldas/MG,0,39,0,1242
129621,2022-01-24,Caldas/MG,0,39,0,1242
135218,2022-01-25,Caldas/MG,0,39,0,1242
140815,2022-01-26,Caldas/MG,0,39,0,1242
146412,2022-01-27,Caldas/MG,0,39,122,1364
152009,2022-01-28,Caldas/MG,0,39,8,1372
157606,2022-01-29,Caldas/MG,0,39,0,1372
163203,2022-01-30,Caldas/MG,1,40,0,1372
168800,2022-01-31,Caldas/MG,0,40,0,1372
174397,2022-02-01,Caldas/MG,0,40,53,1425
179994,2022-02-02,Caldas/MG,0,40,26,1451
185591,2022-02-03,Caldas/MG,0,40,7,1458
191188,2022-02-04,Caldas/MG,0,40,16,1474
196785,2022-02-05,Caldas/MG,0,40,17,1491
202382,2022-02-06,Caldas/MG,0,40,0,1491
207979,2022-02-07,Caldas/MG,0,40,0,1491
213576,2022-02-08,Caldas/MG,0,40,30,1521
219173,2022-02-09,Caldas/MG,0,40,0,1521
224770,2022-02-10,Caldas/MG,0,40,32,1553
230367,2022-02-11,Caldas/MG,0,40,0,1553
235964,2022-02-12,Caldas/MG,0,40,20,1573
241561,2022-02-13,Caldas/MG,0,40,0,1573
247158,2022-02-14,Caldas/MG,0,40,0,1573
252755,2022-02-15,Caldas/MG,0,40,0,1573
258352,2022-02-16,Caldas/MG,0,40,0,1573
263949,2022-02-17,Caldas/MG,0,40,26,1599
269546,2022-02-18,Caldas/MG,1,41,0,1599
275143,2022-02-19,Caldas/MG,0,41,19,1618
280740,2022-02-20,Caldas/MG,0,41,0,1618
286337,2022-02-21,Caldas/MG,0,41,0,1618
291934,2022-02-22,Caldas/MG,0,41,10,1628
297531,2022-02-23,Caldas/MG,0,41,6,1634
303128,2022-02-24,Caldas/MG,0,41,1,1635
308725,2022-02-25,Caldas/MG,0,41,0,1635
314322,2022-02-26,Caldas/MG,0,41,7,1642
319919,2022-02-27,Caldas/MG,0,41,0,1642
325516,2022-02-28,Caldas/MG,0,41,0,1642
331113,2022-03-01,Caldas/MG,0,41,0,1642
336710,2022-03-02,Caldas/MG,0,41,0,1642
342307,2022-03-03,Caldas/MG,0,41,0,1642
347904,2022-03-04,Caldas/MG,1,42,0,1642
353501,2022-03-05,Caldas/MG,0,42,18,1660
359098,2022-03-06,Caldas/MG,0,42,0,1660
364695,2022-03-07,Caldas/MG,0,42,0,1660
370292,2022-03-08,Caldas/MG,0,42,0,1660
375889,2022-03-09,Caldas/MG,0,42,0,1660
381486,2022-03-10,Caldas/MG,0,42,2,1662
387083,2022-03-11,Caldas/MG,0,42,2,1664
392680,2022-03-12,Caldas/MG,0,42,0,1664
398277,2022-03-13,Caldas/MG,0,42,0,1664
403874,2022-03-14,Caldas/MG,0,42,0,1664
409471,2022-03-15,Caldas/MG,0,42,1,1665
415068,2022-03-16,Caldas/MG,0,42,0,1665
420665,2022-03-17,Caldas/MG,0,42,0,1665
426262,2022-03-18,Caldas/MG,0,42,0,1665
431859,2022-03-19,Caldas/MG,0,42,2,1667
437456,2022-03-20,Caldas/MG,0,42,0,1667
443053,2022-03-21,Caldas/MG,0,42,0,1667
448650,2022-03-22,Caldas/MG,0,42,0,1667
454247,2022-03-23,Caldas/MG,0,42,6,1673
459844,2022-03-24,Caldas/MG,0,42,0,1673
465441,2022-03-25,Caldas/MG,0,42,0,1673
471038,2022-03-26,Caldas/MG,0,42,3,1676
476635,2022-03-27,Caldas/MG,0,42,0,1676
482232,2022-03-28,Caldas/MG,0,42,0,1676
487829,2022-03-29,Caldas/MG,0,42,1,1677
493426,2022-03-30,Caldas/MG,0,42,2,1679
499023,2022-03-31,Caldas/MG,0,42,0,1679
504620,2022-04-01,Caldas/MG,0,42,0,1679
510217,2022-04-02,Caldas/MG,0,42,0,1679
515814,2022-04-03,Caldas/MG,0,42,0,1679
521411,2022-04-04,Caldas/MG,0,42,2,1681
527008,2022-04-05,Caldas/MG,0,42,0,1681
532605,2022-04-06,Caldas/MG,0,42,0,1681
538202,2022-04-07,Caldas/MG,0,42,0,1681
543799,2022-04-08,Caldas/MG,0,42,0,1681
549396,2022-04-09,Caldas/MG,0,42,0,1681
554993,2022-04-10,Caldas/MG,0,42,0,1681
560590,2022-04-11,Caldas/MG,0,42,0,1681
566187,2022-04-12,Caldas/MG,0,42,4,1685
571784,2022-04-13,Caldas/MG,0,42,0,1685
577381,2022-04-14,Caldas/MG,0,42,2,1687
582978,2022-04-15,Caldas/MG,0,42,0,1687
588575,2022-04-16,Caldas/MG,0,42,0,1687
594172,2022-04-17,Caldas/MG,0,42,0,1687
599769,2022-04-18,Caldas/MG,0,42,0,1687
605366,2022-04-19,Caldas/MG,0,42,0,1687
610963,2022-04-20,Caldas/MG,0,42,0,1687
616560,2022-04-21,Caldas/MG,0,42,0,1687
622157,2022-04-22,Caldas/MG,0,42,0,1687
627754,2022-04-23,Caldas/MG,0,42,0,1687
633351,2022-04-24,Caldas/MG,0,42,0,1687
638948,2022-04-25,Caldas/MG,0,42,0,1687
644545,2022-04-26,Caldas/MG,0,42,4,1691
650142,2022-04-27,Caldas/MG,0,42,0,1691
655739,2022-04-28,Caldas/MG,0,42,0,1691
661336,2022-04-29,Caldas/MG,0,42,0,1691
666933,2022-04-30,Caldas/MG,0,42,7,1698
672530,2022-05-01,Caldas/MG,0,42,0,1698
678127,2022-05-02,Caldas/MG,0,42,0,1698
683724,2022-05-03,Caldas/MG,0,42,0,1698
689321,2022-05-04,Caldas/MG,0,42,0,1698
694918,2022-05-05,Caldas/MG,0,42,0,1698
700515,2022-05-06,Caldas/MG,0,42,0,1698
706112,2022-05-07,Caldas/MG,0,42,0,1698
711709,2022-05-08,Caldas/MG,0,42,0,1698
717306,2022-05-09,Caldas/MG,0,42,4,1702
722903,2022-05-10,Caldas/MG,0,42,3,1705
728500,2022-05-11,Caldas/MG,0,42,0,1705
734097,2022-05-12,Caldas/MG,1,43,0,1705
739694,2022-05-13,Caldas/MG,0,43,0,1705
745291,2022-05-14,Caldas/MG,0,43,0,1705
750888,2022-05-15,Caldas/MG,0,43,0,1705
756485,2022-05-16,Caldas/MG,0,43,0,1705
762082,2022-05-17,Caldas/MG,0,43,0,1705
767679,2022-05-18,Caldas/MG,0,43,4,1709
773276,2022-05-19,Caldas/MG,0,43,0,1709
778873,2022-05-20,Caldas/MG,0,43,4,1713
784470,2022-05-21,Caldas/MG,0,43,0,1713
790067,2022-05-22,Caldas/MG,0,43,0,1713
795664,2022-05-23,Caldas/MG,0,43,0,1713
801261,2022-05-24,Caldas/MG,0,43,4,1717
806858,2022-05-25,Caldas/MG,0,43,0,1717
812455,2022-05-26,Caldas/MG,0,43,0,1717
818052,2022-05-27,Caldas/MG,0,43,0,1717
823649,2022-05-28,Caldas/MG,0,43,0,1717
829246,2022-05-29,Caldas/MG,0,43,0,1717
834843,2022-05-30,Caldas/MG,0,43,27,1744
840440,2022-05-31,Caldas/MG,0,43,6,1750
846037,2022-06-01,Caldas/MG,0,43,0,1750
851634,2022-06-02,Caldas/MG,0,43,0,1750
857231,2022-06-03,Caldas/MG,0,43,18,1768
862828,2022-06-04,Caldas/MG,0,43,0,1768
868425,2022-06-05,Caldas/MG,0,43,0,1768
874022,2022-06-06,Caldas/MG,0,43,39,1807
879619,2022-06-07,Caldas/MG,0,43,13,1820
885216,2022-06-08,Caldas/MG,0,43,7,1827
890813,2022-06-09,Caldas/MG,0,43,7,1834
896410,2022-06-10,Caldas/MG,0,43,0,1834
902007,2022-06-11,Caldas/MG,0,43,0,1834
907604,2022-06-12,Caldas/MG,0,43,0,1834
913201,2022-06-13,Caldas/MG,0,43,14,1848
918798,2022-06-14,Caldas/MG,0,43,0,1848
924395,2022-06-15,Caldas/MG,0,43,0,1848
929992,2022-06-16,Caldas/MG,0,43,0,1848
935589,2022-06-17,Caldas/MG,0,43,0,1848
941186,2022-06-18,Caldas/MG,0,43,0,1848
946783,2022-06-19,Caldas/MG,0,43,0,1848
952380,2022-06-20,Caldas/MG,0,43,0,1848
957977,2022-06-21,Caldas/MG,0,43,30,1878
963574,2022-06-22,Caldas/MG,0,43,19,1897
969171,2022-06-23,Caldas/MG,0,43,8,1905
974768,2022-06-24,Caldas/MG,0,43,0,1905
980365,2022-06-25,Caldas/MG,0,43,0,1905
985962,2022-06-26,Caldas/MG,0,43,0,1905
991559,2022-06-27,Caldas/MG,0,43,0,1905
997156,2022-06-28,Caldas/MG,0,43,24,1929
1002753,2022-06-29,Caldas/MG,0,43,11,1940
1008350,2022-06-30,Caldas/MG,0,43,3,1943
1013947,2022-07-01,Caldas/MG,0,43,0,1943
1019544,2022-07-02,Caldas/MG,0,43,0,1943
1025141,2022-07-03,Caldas/MG,0,43,0,1943
1030738,2022-07-04,Caldas/MG,0,43,10,1953
1036335,2022-07-05,Caldas/MG,0,43,10,1963
1041932,2022-07-06,Caldas/MG,0,43,8,1971
1047529,2022-07-07,Caldas/MG,0,43,0,1971
1053126,2022-07-08,Caldas/MG,0,43,0,1971
1058723,2022-07-09,Caldas/MG,0,43,0,1971
1064320,2022-07-10,Caldas/MG,0,43,0,1971
1069917,2022-07-11,Caldas/MG,0,43,42,2013
1075514,2022-07-12,Caldas/MG,0,43,12,2025
1081111,2022-07-13,Caldas/MG,0,43,0,2025
1086708,2022-07-14,Caldas/MG,0,43,19,2044
1092305,2022-07-15,Caldas/MG,0,43,7,2051
1097902,2022-07-16,Caldas/MG,0,43,0,2051
1103499,2022-07-17,Caldas/MG,0,43,0,2051
1109096,2022-07-18,Caldas/MG,0,43,0,2051
1114693,2022-07-19,Caldas/MG,0,43,0,2051
1120290,2022-07-20,Caldas/MG,0,43,0,2051
1125887,2022-07-21,Caldas/MG,0,43,0,2051
1131484,2022-07-22,Caldas/MG,0,43,0,2051
1137081,2022-07-23,Caldas/MG,0,43,0,2051
1142678,2022-07-24,Caldas/MG,0,43,0,2051
1148275,2022-07-25,Caldas/MG,0,43,12,2063
1153872,2022-07-26,Caldas/MG,0,43,0,2063
1159469,2022-07-27,Caldas/MG,0,43,0,2063
1165066,2022-07-28,Caldas/MG,0,43,16,2079
1170663,2022-07-29,Caldas/MG,0,43,0,2079
1176260,2022-07-30,Caldas/MG,0,43,0,2079
1181857,2022-07-31,Caldas/MG,0,43,0,2079
1187454,2022-08-01,Caldas/MG,0,43,0,2079
1193051,2022-08-02,Caldas/MG,0,43,0,2079
1198648,2022-08-03,Caldas/MG,0,43,5,2084
1204245,2022-08-04,Caldas/MG,1,44,21,2105
1209842,2022-08-05,Caldas/MG,0,44,0,2105
1215439,2022-08-06,Caldas/MG,0,44,0,2105
1221036,2022-08-07,Caldas/MG,0,44,0,2105
1226633,2022-08-08,Caldas/MG,-1,43,7,2112
1232230,2022-08-09,Caldas/MG,0,43,7,2119
1237827,2022-08-10,Caldas/MG,0,43,4,2123
1243424,2022-08-11,Caldas/MG,0,43,7,2130
1249021,2022-08-12,Caldas/MG,0,43,6,2136
1254618,2022-08-13,Caldas/MG,0,43,0,2136
1260215,2022-08-14,Caldas/MG,0,43,0,2136
1265812,2022-08-15,Caldas/MG,0,43,0,2136
1271409,2022-08-16,Caldas/MG,0,43,10,2146
1277006,2022-08-17,Caldas/MG,0,43,0,2146
1282603,2022-08-18,Caldas/MG,0,43,0,2146
1288200,2022-08-19,Caldas/MG,0,43,6,2152
1293797,2022-08-20,Caldas/MG,0,43,0,2152
1299394,2022-08-21,Caldas/MG,0,43,0,2152
1304991,2022-08-22,Caldas/MG,0,43,0,2152
1310588,2022-08-23,Caldas/MG,0,43,0,2152
1316185,2022-08-24,Caldas/MG,0,43,2,2154
1321782,2022-08-25,Caldas/MG,0,43,4,2158
915,2022-01-01,Cambuí/MG,0,62,0,4250
6512,2022-01-02,Cambuí/MG,0,62,0,4250
12109,2022-01-03,Cambuí/MG,0,62,0,4250
17706,2022-01-04,Cambuí/MG,0,62,0,4250
23303,2022-01-05,Cambuí/MG,0,62,0,4250
28900,2022-01-06,Cambuí/MG,0,62,0,4250
34497,2022-01-07,Cambuí/MG,0,62,122,4372
40094,2022-01-08,Cambuí/MG,0,62,0,4372
45691,2022-01-09,Cambuí/MG,0,62,0,4372
51288,2022-01-10,Cambuí/MG,0,62,0,4372
56885,2022-01-11,Cambuí/MG,0,62,0,4372
62482,2022-01-12,Cambuí/MG,0,62,0,4372
68079,2022-01-13,Cambuí/MG,0,62,0,4372
73676,2022-01-14,Cambuí/MG,0,62,0,4372
79273,2022-01-15,Cambuí/MG,0,62,0,4372
84870,2022-01-16,Cambuí/MG,0,62,0,4372
90467,2022-01-17,Cambuí/MG,0,62,0,4372
96064,2022-01-18,Cambuí/MG,0,62,706,5078
101661,2022-01-19,Cambuí/MG,0,62,110,5188
107258,2022-01-20,Cambuí/MG,0,62,118,5306
112855,2022-01-21,Cambuí/MG,0,62,0,5306
118452,2022-01-22,Cambuí/MG,0,62,244,5550
124049,2022-01-23,Cambuí/MG,0,62,0,5550
129646,2022-01-24,Cambuí/MG,0,62,0,5550
135243,2022-01-25,Cambuí/MG,0,62,83,5633
140840,2022-01-26,Cambuí/MG,0,62,178,5811
146437,2022-01-27,Cambuí/MG,0,62,28,5839
152034,2022-01-28,Cambuí/MG,0,62,140,5979
157631,2022-01-29,Cambuí/MG,0,62,0,5979
163228,2022-01-30,Cambuí/MG,0,62,146,6125
168825,2022-01-31,Cambuí/MG,0,62,0,6125
174422,2022-02-01,Cambuí/MG,0,62,87,6212
180019,2022-02-02,Cambuí/MG,0,62,249,6461
185616,2022-02-03,Cambuí/MG,0,62,0,6461
191213,2022-02-04,Cambuí/MG,0,62,217,6678
196810,2022-02-05,Cambuí/MG,0,62,0,6678
202407,2022-02-06,Cambuí/MG,0,62,0,6678
208004,2022-02-07,Cambuí/MG,0,62,0,6678
213601,2022-02-08,Cambuí/MG,0,62,0,6678
219198,2022-02-09,Cambuí/MG,0,62,311,6989
224795,2022-02-10,Cambuí/MG,0,62,70,7059
230392,2022-02-11,Cambuí/MG,0,62,40,7099
235989,2022-02-12,Cambuí/MG,0,62,0,7099
241586,2022-02-13,Cambuí/MG,1,63,0,7099
247183,2022-02-14,Cambuí/MG,0,63,0,7099
252780,2022-02-15,Cambuí/MG,0,63,78,7177
258377,2022-02-16,Cambuí/MG,0,63,0,7177
263974,2022-02-17,Cambuí/MG,0,63,0,7177
269571,2022-02-18,Cambuí/MG,0,63,126,7303
275168,2022-02-19,Cambuí/MG,0,63,0,7303
280765,2022-02-20,Cambuí/MG,0,63,0,7303
286362,2022-02-21,Cambuí/MG,0,63,0,7303
291959,2022-02-22,Cambuí/MG,0,63,0,7303
297556,2022-02-23,Cambuí/MG,0,63,0,7303
303153,2022-02-24,Cambuí/MG,0,63,81,7384
308750,2022-02-25,Cambuí/MG,0,63,0,7384
314347,2022-02-26,Cambuí/MG,0,63,38,7422
319944,2022-02-27,Cambuí/MG,0,63,0,7422
325541,2022-02-28,Cambuí/MG,0,63,0,7422
331138,2022-03-01,Cambuí/MG,0,63,0,7422
336735,2022-03-02,Cambuí/MG,0,63,0,7422
342332,2022-03-03,Cambuí/MG,0,63,25,7447
347929,2022-03-04,Cambuí/MG,0,63,0,7447
353526,2022-03-05,Cambuí/MG,0,63,0,7447
359123,2022-03-06,Cambuí/MG,0,63,0,7447
364720,2022-03-07,Cambuí/MG,0,63,0,7447
370317,2022-03-08,Cambuí/MG,0,63,0,7447
375914,2022-03-09,Cambuí/MG,0,63,0,7447
381511,2022-03-10,Cambuí/MG,0,63,0,7447
387108,2022-03-11,Cambuí/MG,0,63,0,7447
392705,2022-03-12,Cambuí/MG,0,63,0,7447
398302,2022-03-13,Cambuí/MG,0,63,0,7447
403899,2022-03-14,Cambuí/MG,0,63,0,7447
409496,2022-03-15,Cambuí/MG,0,63,0,7447
415093,2022-03-16,Cambuí/MG,0,63,73,7520
420690,2022-03-17,Cambuí/MG,0,63,1,7521
426287,2022-03-18,Cambuí/MG,0,63,0,7521
431884,2022-03-19,Cambuí/MG,0,63,11,7532
437481,2022-03-20,Cambuí/MG,0,63,0,7532
443078,2022-03-21,Cambuí/MG,0,63,0,7532
448675,2022-03-22,Cambuí/MG,0,63,1,7533
454272,2022-03-23,Cambuí/MG,0,63,2,7535
459869,2022-03-24,Cambuí/MG,0,63,0,7535
465466,2022-03-25,Cambuí/MG,0,63,0,7535
471063,2022-03-26,Cambuí/MG,0,63,0,7535
476660,2022-03-27,Cambuí/MG,0,63,0,7535
482257,2022-03-28,Cambuí/MG,0,63,0,7535
487854,2022-03-29,Cambuí/MG,0,63,7,7542
493451,2022-03-30,Cambuí/MG,0,63,0,7542
499048,2022-03-31,Cambuí/MG,0,63,0,7542
504645,2022-04-01,Cambuí/MG,0,63,0,7542
510242,2022-04-02,Cambuí/MG,0,63,0,7542
515839,2022-04-03,Cambuí/MG,0,63,0,7542
521436,2022-04-04,Cambuí/MG,1,64,0,7542
527033,2022-04-05,Cambuí/MG,1,65,0,7542
532630,2022-04-06,Cambuí/MG,0,65,0,7542
538227,2022-04-07,Cambuí/MG,0,65,0,7542
543824,2022-04-08,Cambuí/MG,0,65,0,7542
549421,2022-04-09,Cambuí/MG,0,65,0,7542
555018,2022-04-10,Cambuí/MG,0,65,0,7542
560615,2022-04-11,Cambuí/MG,0,65,0,7542
566212,2022-04-12,Cambuí/MG,0,65,19,7561
571809,2022-04-13,Cambuí/MG,0,65,0,7561
577406,2022-04-14,Cambuí/MG,0,65,0,7561
583003,2022-04-15,Cambuí/MG,0,65,0,7561
588600,2022-04-16,Cambuí/MG,0,65,0,7561
594197,2022-04-17,Cambuí/MG,0,65,0,7561
599794,2022-04-18,Cambuí/MG,0,65,0,7561
605391,2022-04-19,Cambuí/MG,0,65,7,7568
610988,2022-04-20,Cambuí/MG,0,65,0,7568
616585,2022-04-21,Cambuí/MG,0,65,0,7568
622182,2022-04-22,Cambuí/MG,0,65,0,7568
627779,2022-04-23,Cambuí/MG,0,65,0,7568
633376,2022-04-24,Cambuí/MG,0,65,0,7568
638973,2022-04-25,Cambuí/MG,0,65,0,7568
644570,2022-04-26,Cambuí/MG,0,65,0,7568
650167,2022-04-27,Cambuí/MG,0,65,2,7570
655764,2022-04-28,Cambuí/MG,0,65,0,7570
661361,2022-04-29,Cambuí/MG,0,65,0,7570
666958,2022-04-30,Cambuí/MG,0,65,0,7570
672555,2022-05-01,Cambuí/MG,0,65,0,7570
678152,2022-05-02,Cambuí/MG,0,65,0,7570
683749,2022-05-03,Cambuí/MG,0,65,0,7570
689346,2022-05-04,Cambuí/MG,0,65,0,7570
694943,2022-05-05,Cambuí/MG,0,65,0,7570
700540,2022-05-06,Cambuí/MG,0,65,0,7570
706137,2022-05-07,Cambuí/MG,0,65,0,7570
711734,2022-05-08,Cambuí/MG,0,65,0,7570
717331,2022-05-09,Cambuí/MG,0,65,5,7575
722928,2022-05-10,Cambuí/MG,0,65,0,7575
728525,2022-05-11,Cambuí/MG,0,65,0,7575
734122,2022-05-12,Cambuí/MG,0,65,0,7575
739719,2022-05-13,Cambuí/MG,0,65,0,7575
745316,2022-05-14,Cambuí/MG,0,65,0,7575
750913,2022-05-15,Cambuí/MG,0,65,0,7575
756510,2022-05-16,Cambuí/MG,0,65,15,7590
762107,2022-05-17,Cambuí/MG,0,65,0,7590
767704,2022-05-18,Cambuí/MG,0,65,0,7590
773301,2022-05-19,Cambuí/MG,0,65,0,7590
778898,2022-05-20,Cambuí/MG,0,65,0,7590
784495,2022-05-21,Cambuí/MG,0,65,0,7590
790092,2022-05-22,Cambuí/MG,0,65,0,7590
795689,2022-05-23,Cambuí/MG,0,65,0,7590
801286,2022-05-24,Cambuí/MG,0,65,0,7590
806883,2022-05-25,Cambuí/MG,0,65,0,7590
812480,2022-05-26,Cambuí/MG,0,65,0,7590
818077,2022-05-27,Cambuí/MG,0,65,78,7668
823674,2022-05-28,Cambuí/MG,0,65,0,7668
829271,2022-05-29,Cambuí/MG,0,65,0,7668
834868,2022-05-30,Cambuí/MG,0,65,0,7668
840465,2022-05-31,Cambuí/MG,0,65,0,7668
846062,2022-06-01,Cambuí/MG,0,65,69,7737
851659,2022-06-02,Cambuí/MG,0,65,0,7737
857256,2022-06-03,Cambuí/MG,0,65,0,7737
862853,2022-06-04,Cambuí/MG,0,65,0,7737
868450,2022-06-05,Cambuí/MG,0,65,0,7737
874047,2022-06-06,Cambuí/MG,0,65,0,7737
879644,2022-06-07,Cambuí/MG,0,65,0,7737
885241,2022-06-08,Cambuí/MG,0,65,0,7737
890838,2022-06-09,Cambuí/MG,0,65,300,8037
896435,2022-06-10,Cambuí/MG,0,65,0,8037
902032,2022-06-11,Cambuí/MG,0,65,0,8037
907629,2022-06-12,Cambuí/MG,0,65,0,8037
913226,2022-06-13,Cambuí/MG,0,65,0,8037
918823,2022-06-14,Cambuí/MG,0,65,0,8037
924420,2022-06-15,Cambuí/MG,0,65,0,8037
930017,2022-06-16,Cambuí/MG,0,65,0,8037
935614,2022-06-17,Cambuí/MG,0,65,0,8037
941211,2022-06-18,Cambuí/MG,0,65,0,8037
946808,2022-06-19,Cambuí/MG,0,65,0,8037
952405,2022-06-20,Cambuí/MG,0,65,0,8037
958002,2022-06-21,Cambuí/MG,0,65,0,8037
963599,2022-06-22,Cambuí/MG,0,65,563,8600
969196,2022-06-23,Cambuí/MG,0,65,0,8600
974793,2022-06-24,Cambuí/MG,0,65,0,8600
980390,2022-06-25,Cambuí/MG,0,65,0,8600
985987,2022-06-26,Cambuí/MG,0,65,0,8600
991584,2022-06-27,Cambuí/MG,0,65,0,8600
997181,2022-06-28,Cambuí/MG,0,65,0,8600
1002778,2022-06-29,Cambuí/MG,0,65,273,8873
1008375,2022-06-30,Cambuí/MG,0,65,0,8873
1013972,2022-07-01,Cambuí/MG,0,65,0,8873
1019569,2022-07-02,Cambuí/MG,0,65,0,8873
1025166,2022-07-03,Cambuí/MG,0,65,0,8873
1030763,2022-07-04,Cambuí/MG,0,65,0,8873
1036360,2022-07-05,Cambuí/MG,0,65,130,9003
1041957,2022-07-06,Cambuí/MG,0,65,0,9003
1047554,2022-07-07,Cambuí/MG,0,65,0,9003
1053151,2022-07-08,Cambuí/MG,0,65,0,9003
1058748,2022-07-09,Cambuí/MG,0,65,0,9003
1064345,2022-07-10,Cambuí/MG,0,65,0,9003
1069942,2022-07-11,Cambuí/MG,0,65,0,9003
1075539,2022-07-12,Cambuí/MG,0,65,0,9003
1081136,2022-07-13,Cambuí/MG,0,65,101,9104
1086733,2022-07-14,Cambuí/MG,0,65,0,9104
1092330,2022-07-15,Cambuí/MG,0,65,0,9104
1097927,2022-07-16,Cambuí/MG,0,65,0,9104
1103524,2022-07-17,Cambuí/MG,0,65,0,9104
1109121,2022-07-18,Cambuí/MG,0,65,0,9104
1114718,2022-07-19,Cambuí/MG,0,65,53,9157
1120315,2022-07-20,Cambuí/MG,1,66,0,9157
1125912,2022-07-21,Cambuí/MG,0,66,0,9157
1131509,2022-07-22,Cambuí/MG,0,66,0,9157
1137106,2022-07-23,Cambuí/MG,0,66,0,9157
1142703,2022-07-24,Cambuí/MG,0,66,0,9157
1148300,2022-07-25,Cambuí/MG,0,66,73,9230
1153897,2022-07-26,Cambuí/MG,0,66,0,9230
1159494,2022-07-27,Cambuí/MG,0,66,0,9230
1165091,2022-07-28,Cambuí/MG,0,66,0,9230
1170688,2022-07-29,Cambuí/MG,0,66,0,9230
1176285,2022-07-30,Cambuí/MG,0,66,0,9230
1181882,2022-07-31,Cambuí/MG,0,66,0,9230
1187479,2022-08-01,Cambuí/MG,0,66,38,9268
1193076,2022-08-02,Cambuí/MG,0,66,0,9268
1198673,2022-08-03,Cambuí/MG,0,66,0,9268
1204270,2022-08-04,Cambuí/MG,0,66,0,9268
1209867,2022-08-05,Cambuí/MG,0,66,0,9268
1215464,2022-08-06,Cambuí/MG,0,66,0,9268
1221061,2022-08-07,Cambuí/MG,0,66,0,9268
1226658,2022-08-08,Cambuí/MG,0,66,25,9293
1232255,2022-08-09,Cambuí/MG,0,66,0,9293
1237852,2022-08-10,Cambuí/MG,0,66,0,9293
1243449,2022-08-11,Cambuí/MG,0,66,0,9293
1249046,2022-08-12,Cambuí/MG,0,66,0,9293
1254643,2022-08-13,Cambuí/MG,0,66,0,9293
1260240,2022-08-14,Cambuí/MG,0,66,0,9293
1265837,2022-08-15,Cambuí/MG,0,66,0,9293
1271434,2022-08-16,Cambuí/MG,0,66,11,9304
1277031,2022-08-17,Cambuí/MG,0,66,0,9304
1282628,2022-08-18,Cambuí/MG,0,66,0,9304
1288225,2022-08-19,Cambuí/MG,0,66,0,9304
1293822,2022-08-20,Cambuí/MG,0,66,0,9304
1299419,2022-08-21,Cambuí/MG,0,66,0,9304
1305016,2022-08-22,Cambuí/MG,0,66,0,9304
1310613,2022-08-23,Cambuí/MG,0,66,0,9304
1316210,2022-08-24,Cambuí/MG,0,66,0,9304
1321807,2022-08-25,Cambuí/MG,0,66,0,9304
914,2022-01-01,Cambuquira/MG,0,28,2,877
6511,2022-01-02,Cambuquira/MG,0,28,0,877
12108,2022-01-03,Cambuquira/MG,0,28,0,877
17705,2022-01-04,Cambuquira/MG,0,28,0,877
23302,2022-01-05,Cambuquira/MG,0,28,0,877
28899,2022-01-06,Cambuquira/MG,0,28,0,877
34496,2022-01-07,Cambuquira/MG,0,28,8,885
40093,2022-01-08,Cambuquira/MG,0,28,8,893
45690,2022-01-09,Cambuquira/MG,0,28,14,907
51287,2022-01-10,Cambuquira/MG,0,28,0,907
56884,2022-01-11,Cambuquira/MG,0,28,4,911
62481,2022-01-12,Cambuquira/MG,0,28,36,947
68078,2022-01-13,Cambuquira/MG,0,28,27,974
73675,2022-01-14,Cambuquira/MG,0,28,22,996
79272,2022-01-15,Cambuquira/MG,0,28,10,1006
84869,2022-01-16,Cambuquira/MG,0,28,0,1006
90466,2022-01-17,Cambuquira/MG,0,28,0,1006
96063,2022-01-18,Cambuquira/MG,0,28,28,1034
101660,2022-01-19,Cambuquira/MG,0,28,13,1047
107257,2022-01-20,Cambuquira/MG,0,28,10,1057
112854,2022-01-21,Cambuquira/MG,0,28,0,1057
118451,2022-01-22,Cambuquira/MG,0,28,9,1066
124048,2022-01-23,Cambuquira/MG,0,28,0,1066
129645,2022-01-24,Cambuquira/MG,0,28,0,1066
135242,2022-01-25,Cambuquira/MG,0,28,19,1085
140839,2022-01-26,Cambuquira/MG,0,28,42,1127
146436,2022-01-27,Cambuquira/MG,1,29,7,1134
152033,2022-01-28,Cambuquira/MG,0,29,7,1141
157630,2022-01-29,Cambuquira/MG,0,29,11,1152
163227,2022-01-30,Cambuquira/MG,0,29,0,1152
168824,2022-01-31,Cambuquira/MG,0,29,0,1152
174421,2022-02-01,Cambuquira/MG,0,29,8,1160
180018,2022-02-02,Cambuquira/MG,1,30,16,1176
185615,2022-02-03,Cambuquira/MG,1,31,17,1193
191212,2022-02-04,Cambuquira/MG,0,31,9,1202
196809,2022-02-05,Cambuquira/MG,0,31,11,1213
202406,2022-02-06,Cambuquira/MG,0,31,0,1213
208003,2022-02-07,Cambuquira/MG,0,31,0,1213
213600,2022-02-08,Cambuquira/MG,0,31,11,1224
219197,2022-02-09,Cambuquira/MG,1,32,25,1249
224794,2022-02-10,Cambuquira/MG,0,32,15,1264
230391,2022-02-11,Cambuquira/MG,0,32,6,1270
235988,2022-02-12,Cambuquira/MG,0,32,6,1276
241585,2022-02-13,Cambuquira/MG,0,32,0,1276
247182,2022-02-14,Cambuquira/MG,0,32,0,1276
252779,2022-02-15,Cambuquira/MG,0,32,8,1284
258376,2022-02-16,Cambuquira/MG,0,32,16,1300
263973,2022-02-17,Cambuquira/MG,0,32,24,1324
269570,2022-02-18,Cambuquira/MG,0,32,9,1333
275167,2022-02-19,Cambuquira/MG,0,32,11,1344
280764,2022-02-20,Cambuquira/MG,0,32,0,1344
286361,2022-02-21,Cambuquira/MG,0,32,0,1344
291958,2022-02-22,Cambuquira/MG,0,32,10,1354
297555,2022-02-23,Cambuquira/MG,1,33,15,1369
303152,2022-02-24,Cambuquira/MG,1,34,12,1381
308749,2022-02-25,Cambuquira/MG,0,34,5,1386
314346,2022-02-26,Cambuquira/MG,0,34,5,1391
319943,2022-02-27,Cambuquira/MG,0,34,0,1391
325540,2022-02-28,Cambuquira/MG,0,34,0,1391
331137,2022-03-01,Cambuquira/MG,0,34,0,1391
336734,2022-03-02,Cambuquira/MG,0,34,0,1391
342331,2022-03-03,Cambuquira/MG,0,34,0,1391
347928,2022-03-04,Cambuquira/MG,0,34,21,1412
353525,2022-03-05,Cambuquira/MG,0,34,9,1421
359122,2022-03-06,Cambuquira/MG,0,34,0,1421
364719,2022-03-07,Cambuquira/MG,0,34,0,1421
370316,2022-03-08,Cambuquira/MG,0,34,8,1429
375913,2022-03-09,Cambuquira/MG,0,34,0,1429
381510,2022-03-10,Cambuquira/MG,1,35,14,1443
387107,2022-03-11,Cambuquira/MG,0,35,1,1444
392704,2022-03-12,Cambuquira/MG,0,35,0,1444
398301,2022-03-13,Cambuquira/MG,0,35,0,1444
403898,2022-03-14,Cambuquira/MG,0,35,0,1444
409495,2022-03-15,Cambuquira/MG,0,35,7,1451
415092,2022-03-16,Cambuquira/MG,1,36,6,1457
420689,2022-03-17,Cambuquira/MG,0,36,3,1460
426286,2022-03-18,Cambuquira/MG,0,36,0,1460
431883,2022-03-19,Cambuquira/MG,0,36,2,1462
437480,2022-03-20,Cambuquira/MG,0,36,0,1462
443077,2022-03-21,Cambuquira/MG,0,36,0,1462
448674,2022-03-22,Cambuquira/MG,0,36,0,1462
454271,2022-03-23,Cambuquira/MG,0,36,0,1462
459868,2022-03-24,Cambuquira/MG,0,36,0,1462
465465,2022-03-25,Cambuquira/MG,0,36,2,1464
471062,2022-03-26,Cambuquira/MG,0,36,0,1464
476659,2022-03-27,Cambuquira/MG,0,36,0,1464
482256,2022-03-28,Cambuquira/MG,0,36,0,1464
487853,2022-03-29,Cambuquira/MG,0,36,6,1470
493450,2022-03-30,Cambuquira/MG,0,36,0,1470
499047,2022-03-31,Cambuquira/MG,0,36,4,1474
504644,2022-04-01,Cambuquira/MG,1,37,6,1480
510241,2022-04-02,Cambuquira/MG,0,37,0,1480
515838,2022-04-03,Cambuquira/MG,0,37,0,1480
521435,2022-04-04,Cambuquira/MG,0,37,0,1480
527032,2022-04-05,Cambuquira/MG,0,37,1,1481
532629,2022-04-06,Cambuquira/MG,0,37,3,1484
538226,2022-04-07,Cambuquira/MG,0,37,2,1486
543823,2022-04-08,Cambuquira/MG,0,37,0,1486
549420,2022-04-09,Cambuquira/MG,0,37,0,1486
555017,2022-04-10,Cambuquira/MG,0,37,0,1486
560614,2022-04-11,Cambuquira/MG,0,37,0,1486
566211,2022-04-12,Cambuquira/MG,0,37,1,1487
571808,2022-04-13,Cambuquira/MG,0,37,2,1489
577405,2022-04-14,Cambuquira/MG,1,38,0,1489
583002,2022-04-15,Cambuquira/MG,0,38,0,1489
588599,2022-04-16,Cambuquira/MG,0,38,0,1489
594196,2022-04-17,Cambuquira/MG,0,38,0,1489
599793,2022-04-18,Cambuquira/MG,0,38,0,1489
605390,2022-04-19,Cambuquira/MG,0,38,0,1489
610987,2022-04-20,Cambuquira/MG,0,38,1,1490
616584,2022-04-21,Cambuquira/MG,0,38,0,1490
622181,2022-04-22,Cambuquira/MG,0,38,0,1490
627778,2022-04-23,Cambuquira/MG,0,38,0,1490
633375,2022-04-24,Cambuquira/MG,0,38,0,1490
638972,2022-04-25,Cambuquira/MG,0,38,0,1490
644569,2022-04-26,Cambuquira/MG,0,38,2,1492
650166,2022-04-27,Cambuquira/MG,0,38,0,1492
655763,2022-04-28,Cambuquira/MG,0,38,0,1492
661360,2022-04-29,Cambuquira/MG,0,38,4,1496
666957,2022-04-30,Cambuquira/MG,0,38,0,1496
672554,2022-05-01,Cambuquira/MG,0,38,0,1496
678151,2022-05-02,Cambuquira/MG,0,38,0,1496
683748,2022-05-03,Cambuquira/MG,0,38,2,1498
689345,2022-05-04,Cambuquira/MG,0,38,2,1500
694942,2022-05-05,Cambuquira/MG,0,38,2,1502
700539,2022-05-06,Cambuquira/MG,0,38,1,1503
706136,2022-05-07,Cambuquira/MG,0,38,0,1503
711733,2022-05-08,Cambuquira/MG,0,38,0,1503
717330,2022-05-09,Cambuquira/MG,0,38,0,1503
722927,2022-05-10,Cambuquira/MG,0,38,3,1506
728524,2022-05-11,Cambuquira/MG,0,38,3,1509
734121,2022-05-12,Cambuquira/MG,0,38,2,1511
739718,2022-05-13,Cambuquira/MG,0,38,0,1511
745315,2022-05-14,Cambuquira/MG,0,38,0,1511
750912,2022-05-15,Cambuquira/MG,0,38,0,1511
756509,2022-05-16,Cambuquira/MG,0,38,0,1511
762106,2022-05-17,Cambuquira/MG,0,38,0,1511
767703,2022-05-18,Cambuquira/MG,0,38,6,1517
773300,2022-05-19,Cambuquira/MG,0,38,3,1520
778897,2022-05-20,Cambuquira/MG,0,38,5,1525
784494,2022-05-21,Cambuquira/MG,0,38,0,1525
790091,2022-05-22,Cambuquira/MG,0,38,0,1525
795688,2022-05-23,Cambuquira/MG,0,38,1,1526
801285,2022-05-24,Cambuquira/MG,0,38,7,1533
806882,2022-05-25,Cambuquira/MG,0,38,15,1548
812479,2022-05-26,Cambuquira/MG,0,38,0,1548
818076,2022-05-27,Cambuquira/MG,0,38,22,1570
823673,2022-05-28,Cambuquira/MG,0,38,0,1570
829270,2022-05-29,Cambuquira/MG,0,38,0,1570
834867,2022-05-30,Cambuquira/MG,0,38,6,1576
840464,2022-05-31,Cambuquira/MG,0,38,17,1593
846061,2022-06-01,Cambuquira/MG,0,38,24,1617
851658,2022-06-02,Cambuquira/MG,0,38,6,1623
857255,2022-06-03,Cambuquira/MG,0,38,6,1629
862852,2022-06-04,Cambuquira/MG,0,38,0,1629
868449,2022-06-05,Cambuquira/MG,0,38,0,1629
874046,2022-06-06,Cambuquira/MG,0,38,0,1629
879643,2022-06-07,Cambuquira/MG,0,38,0,1629
885240,2022-06-08,Cambuquira/MG,0,38,0,1629
890837,2022-06-09,Cambuquira/MG,0,38,0,1629
896434,2022-06-10,Cambuquira/MG,0,38,0,1629
902031,2022-06-11,Cambuquira/MG,0,38,0,1629
907628,2022-06-12,Cambuquira/MG,0,38,0,1629
913225,2022-06-13,Cambuquira/MG,0,38,65,1694
918822,2022-06-14,Cambuquira/MG,0,38,4,1698
924419,2022-06-15,Cambuquira/MG,0,38,15,1713
930016,2022-06-16,Cambuquira/MG,0,38,0,1713
935613,2022-06-17,Cambuquira/MG,0,38,0,1713
941210,2022-06-18,Cambuquira/MG,0,38,0,1713
946807,2022-06-19,Cambuquira/MG,0,38,0,1713
952404,2022-06-20,Cambuquira/MG,0,38,11,1724
958001,2022-06-21,Cambuquira/MG,0,38,13,1737
963598,2022-06-22,Cambuquira/MG,0,38,0,1737
969195,2022-06-23,Cambuquira/MG,0,38,21,1758
974792,2022-06-24,Cambuquira/MG,0,38,9,1767
980389,2022-06-25,Cambuquira/MG,0,38,0,1767
985986,2022-06-26,Cambuquira/MG,0,38,0,1767
991583,2022-06-27,Cambuquira/MG,0,38,10,1777
997180,2022-06-28,Cambuquira/MG,0,38,20,1797
1002777,2022-06-29,Cambuquira/MG,0,38,18,1815
1008374,2022-06-30,Cambuquira/MG,0,38,0,1815
1013971,2022-07-01,Cambuquira/MG,0,38,0,1815
1019568,2022-07-02,Cambuquira/MG,0,38,0,1815
1025165,2022-07-03,Cambuquira/MG,0,38,0,1815
1030762,2022-07-04,Cambuquira/MG,0,38,33,1848
1036359,2022-07-05,Cambuquira/MG,0,38,19,1867
1041956,2022-07-06,Cambuquira/MG,0,38,20,1887
1047553,2022-07-07,Cambuquira/MG,0,38,12,1899
1053150,2022-07-08,Cambuquira/MG,0,38,0,1899
1058747,2022-07-09,Cambuquira/MG,0,38,0,1899
1064344,2022-07-10,Cambuquira/MG,0,38,0,1899
1069941,2022-07-11,Cambuquira/MG,0,38,17,1916
1075538,2022-07-12,Cambuquira/MG,0,38,0,1916
1081135,2022-07-13,Cambuquira/MG,0,38,0,1916
1086732,2022-07-14,Cambuquira/MG,0,38,30,1946
1092329,2022-07-15,Cambuquira/MG,0,38,0,1946
1097926,2022-07-16,Cambuquira/MG,0,38,0,1946
1103523,2022-07-17,Cambuquira/MG,0,38,0,1946
1109120,2022-07-18,Cambuquira/MG,0,38,0,1946
1114717,2022-07-19,Cambuquira/MG,0,38,15,1961
1120314,2022-07-20,Cambuquira/MG,0,38,0,1961
1125911,2022-07-21,Cambuquira/MG,0,38,16,1977
1131508,2022-07-22,Cambuquira/MG,0,38,7,1984
1137105,2022-07-23,Cambuquira/MG,0,38,0,1984
1142702,2022-07-24,Cambuquira/MG,0,38,0,1984
1148299,2022-07-25,Cambuquira/MG,0,38,6,1990
1153896,2022-07-26,Cambuquira/MG,0,38,11,2001
1159493,2022-07-27,Cambuquira/MG,0,38,7,2008
1165090,2022-07-28,Cambuquira/MG,0,38,5,2013
1170687,2022-07-29,Cambuquira/MG,0,38,0,2013
1176284,2022-07-30,Cambuquira/MG,0,38,0,2013
1181881,2022-07-31,Cambuquira/MG,0,38,0,2013
1187478,2022-08-01,Cambuquira/MG,0,38,4,2017
1193075,2022-08-02,Cambuquira/MG,0,38,0,2017
1198672,2022-08-03,Cambuquira/MG,0,38,3,2020
1204269,2022-08-04,Cambuquira/MG,0,38,2,2022
1209866,2022-08-05,Cambuquira/MG,0,38,2,2024
1215463,2022-08-06,Cambuquira/MG,0,38,0,2024
1221060,2022-08-07,Cambuquira/MG,0,38,0,2024
1226657,2022-08-08,Cambuquira/MG,0,38,0,2024
1232254,2022-08-09,Cambuquira/MG,1,39,2,2026
1237851,2022-08-10,Cambuquira/MG,0,39,4,2030
1243448,2022-08-11,Cambuquira/MG,0,39,0,2030
1249045,2022-08-12,Cambuquira/MG,0,39,0,2030
1254642,2022-08-13,Cambuquira/MG,0,39,0,2030
1260239,2022-08-14,Cambuquira/MG,0,39,0,2030
1265836,2022-08-15,Cambuquira/MG,0,39,0,2030
1271433,2022-08-16,Cambuquira/MG,0,39,1,2031
1277030,2022-08-17,Cambuquira/MG,0,39,0,2031
1282627,2022-08-18,Cambuquira/MG,0,39,0,2031
1288224,2022-08-19,Cambuquira/MG,0,39,0,2031
1293821,2022-08-20,Cambuquira/MG,0,39,0,2031
1299418,2022-08-21,Cambuquira/MG,0,39,0,2031
1305015,2022-08-22,Cambuquira/MG,0,39,2,2033
1310612,2022-08-23,Cambuquira/MG,0,39,0,2033
1316209,2022-08-24,Cambuquira/MG,0,39,4,2037
1321806,2022-08-25,Cambuquira/MG,0,39,2,2039
920,2022-01-01,Campanha/MG,0,52,0,2262
6517,2022-01-02,Campanha/MG,0,52,0,2262
12114,2022-01-03,Campanha/MG,0,52,0,2262
17711,2022-01-04,Campanha/MG,0,52,8,2270
23308,2022-01-05,Campanha/MG,0,52,0,2270
28905,2022-01-06,Campanha/MG,0,52,20,2290
34502,2022-01-07,Campanha/MG,0,52,24,2314
40099,2022-01-08,Campanha/MG,0,52,19,2333
45696,2022-01-09,Campanha/MG,0,52,0,2333
51293,2022-01-10,Campanha/MG,0,52,0,2333
56890,2022-01-11,Campanha/MG,0,52,37,2370
62487,2022-01-12,Campanha/MG,0,52,16,2386
68084,2022-01-13,Campanha/MG,0,52,16,2402
73681,2022-01-14,Campanha/MG,0,52,27,2429
79278,2022-01-15,Campanha/MG,0,52,26,2455
84875,2022-01-16,Campanha/MG,0,52,0,2455
90472,2022-01-17,Campanha/MG,0,52,0,2455
96069,2022-01-18,Campanha/MG,0,52,61,2516
101666,2022-01-19,Campanha/MG,0,52,0,2516
107263,2022-01-20,Campanha/MG,0,52,67,2583
112860,2022-01-21,Campanha/MG,0,52,20,2603
118457,2022-01-22,Campanha/MG,0,52,28,2631
124054,2022-01-23,Campanha/MG,0,52,0,2631
129651,2022-01-24,Campanha/MG,0,52,0,2631
135248,2022-01-25,Campanha/MG,0,52,36,2667
140845,2022-01-26,Campanha/MG,0,52,65,2732
146442,2022-01-27,Campanha/MG,0,52,33,2765
152039,2022-01-28,Campanha/MG,0,52,29,2794
157636,2022-01-29,Campanha/MG,1,53,34,2828
163233,2022-01-30,Campanha/MG,0,53,0,2828
168830,2022-01-31,Campanha/MG,1,54,73,2901
174427,2022-02-01,Campanha/MG,0,54,3,2904
180024,2022-02-02,Campanha/MG,0,54,41,2945
185621,2022-02-03,Campanha/MG,0,54,0,2945
191218,2022-02-04,Campanha/MG,0,54,52,2997
196815,2022-02-05,Campanha/MG,0,54,24,3021
202412,2022-02-06,Campanha/MG,0,54,0,3021
208009,2022-02-07,Campanha/MG,0,54,0,3021
213606,2022-02-08,Campanha/MG,0,54,40,3061
219203,2022-02-09,Campanha/MG,3,57,39,3100
224800,2022-02-10,Campanha/MG,0,57,21,3121
230397,2022-02-11,Campanha/MG,3,60,16,3137
235994,2022-02-12,Campanha/MG,0,60,14,3151
241591,2022-02-13,Campanha/MG,0,60,0,3151
247188,2022-02-14,Campanha/MG,0,60,8,3159
252785,2022-02-15,Campanha/MG,0,60,0,3159
258382,2022-02-16,Campanha/MG,1,61,52,3211
263979,2022-02-17,Campanha/MG,1,62,32,3243
269576,2022-02-18,Campanha/MG,0,62,15,3258
275173,2022-02-19,Campanha/MG,1,63,13,3271
280770,2022-02-20,Campanha/MG,0,63,10,3281
286367,2022-02-21,Campanha/MG,0,63,11,3292
291964,2022-02-22,Campanha/MG,0,63,0,3292
297561,2022-02-23,Campanha/MG,0,63,20,3312
303158,2022-02-24,Campanha/MG,2,65,10,3322
308755,2022-02-25,Campanha/MG,-1,64,15,3337
314352,2022-02-26,Campanha/MG,0,64,16,3353
319949,2022-02-27,Campanha/MG,0,64,0,3353
325546,2022-02-28,Campanha/MG,0,64,0,3353
331143,2022-03-01,Campanha/MG,0,64,32,3385
336740,2022-03-02,Campanha/MG,0,64,0,3385
342337,2022-03-03,Campanha/MG,0,64,22,3407
347934,2022-03-04,Campanha/MG,0,64,10,3417
353531,2022-03-05,Campanha/MG,0,64,12,3429
359128,2022-03-06,Campanha/MG,0,64,0,3429
364725,2022-03-07,Campanha/MG,0,64,0,3429
370322,2022-03-08,Campanha/MG,0,64,16,3445
375919,2022-03-09,Campanha/MG,0,64,10,3455
381516,2022-03-10,Campanha/MG,0,64,6,3461
387113,2022-03-11,Campanha/MG,1,65,2,3463
392710,2022-03-12,Campanha/MG,1,66,6,3469
398307,2022-03-13,Campanha/MG,0,66,0,3469
403904,2022-03-14,Campanha/MG,0,66,0,3469
409501,2022-03-15,Campanha/MG,0,66,4,3473
415098,2022-03-16,Campanha/MG,0,66,4,3477
420695,2022-03-17,Campanha/MG,0,66,5,3482
426292,2022-03-18,Campanha/MG,0,66,2,3484
431889,2022-03-19,Campanha/MG,0,66,2,3486
437486,2022-03-20,Campanha/MG,0,66,0,3486
443083,2022-03-21,Campanha/MG,0,66,0,3486
448680,2022-03-22,Campanha/MG,0,66,5,3491
454277,2022-03-23,Campanha/MG,0,66,7,3498
459874,2022-03-24,Campanha/MG,0,66,4,3502
465471,2022-03-25,Campanha/MG,0,66,2,3504
471068,2022-03-26,Campanha/MG,1,67,5,3509
476665,2022-03-27,Campanha/MG,0,67,0,3509
482262,2022-03-28,Campanha/MG,0,67,0,3509
487859,2022-03-29,Campanha/MG,0,67,0,3509
493456,2022-03-30,Campanha/MG,1,68,5,3514
499053,2022-03-31,Campanha/MG,0,68,3,3517
504650,2022-04-01,Campanha/MG,0,68,0,3517
510247,2022-04-02,Campanha/MG,0,68,0,3517
515844,2022-04-03,Campanha/MG,0,68,0,3517
521441,2022-04-04,Campanha/MG,0,68,1,3518
527038,2022-04-05,Campanha/MG,0,68,3,3521
532635,2022-04-06,Campanha/MG,0,68,0,3521
538232,2022-04-07,Campanha/MG,0,68,0,3521
543829,2022-04-08,Campanha/MG,0,68,1,3522
549426,2022-04-09,Campanha/MG,0,68,4,3526
555023,2022-04-10,Campanha/MG,0,68,0,3526
560620,2022-04-11,Campanha/MG,0,68,0,3526
566217,2022-04-12,Campanha/MG,0,68,1,3527
571814,2022-04-13,Campanha/MG,0,68,1,3528
577411,2022-04-14,Campanha/MG,0,68,0,3528
583008,2022-04-15,Campanha/MG,0,68,1,3529
588605,2022-04-16,Campanha/MG,0,68,1,3530
594202,2022-04-17,Campanha/MG,0,68,0,3530
599799,2022-04-18,Campanha/MG,0,68,0,3530
605396,2022-04-19,Campanha/MG,0,68,1,3531
610993,2022-04-20,Campanha/MG,0,68,0,3531
616590,2022-04-21,Campanha/MG,0,68,0,3531
622187,2022-04-22,Campanha/MG,0,68,0,3531
627784,2022-04-23,Campanha/MG,0,68,0,3531
633381,2022-04-24,Campanha/MG,0,68,0,3531
638978,2022-04-25,Campanha/MG,0,68,0,3531
644575,2022-04-26,Campanha/MG,0,68,0,3531
650172,2022-04-27,Campanha/MG,0,68,0,3531
655769,2022-04-28,Campanha/MG,0,68,0,3531
661366,2022-04-29,Campanha/MG,0,68,0,3531
666963,2022-04-30,Campanha/MG,0,68,0,3531
672560,2022-05-01,Campanha/MG,0,68,0,3531
678157,2022-05-02,Campanha/MG,0,68,0,3531
683754,2022-05-03,Campanha/MG,0,68,3,3534
689351,2022-05-04,Campanha/MG,0,68,1,3535
694948,2022-05-05,Campanha/MG,0,68,1,3536
700545,2022-05-06,Campanha/MG,0,68,1,3537
706142,2022-05-07,Campanha/MG,0,68,0,3537
711739,2022-05-08,Campanha/MG,0,68,0,3537
717336,2022-05-09,Campanha/MG,0,68,4,3541
722933,2022-05-10,Campanha/MG,0,68,7,3548
728530,2022-05-11,Campanha/MG,0,68,6,3554
734127,2022-05-12,Campanha/MG,0,68,4,3558
739724,2022-05-13,Campanha/MG,0,68,3,3561
745321,2022-05-14,Campanha/MG,0,68,0,3561
750918,2022-05-15,Campanha/MG,0,68,0,3561
756515,2022-05-16,Campanha/MG,0,68,1,3562
762112,2022-05-17,Campanha/MG,0,68,3,3565
767709,2022-05-18,Campanha/MG,0,68,3,3568
773306,2022-05-19,Campanha/MG,0,68,1,3569
778903,2022-05-20,Campanha/MG,0,68,3,3572
784500,2022-05-21,Campanha/MG,0,68,0,3572
790097,2022-05-22,Campanha/MG,0,68,0,3572
795694,2022-05-23,Campanha/MG,0,68,0,3572
801291,2022-05-24,Campanha/MG,0,68,1,3573
806888,2022-05-25,Campanha/MG,1,69,5,3578
812485,2022-05-26,Campanha/MG,0,69,5,3583
818082,2022-05-27,Campanha/MG,0,69,1,3584
823679,2022-05-28,Campanha/MG,0,69,0,3584
829276,2022-05-29,Campanha/MG,0,69,0,3584
834873,2022-05-30,Campanha/MG,0,69,7,3591
840470,2022-05-31,Campanha/MG,0,69,13,3604
846067,2022-06-01,Campanha/MG,0,69,11,3615
851664,2022-06-02,Campanha/MG,0,69,7,3622
857261,2022-06-03,Campanha/MG,0,69,7,3629
862858,2022-06-04,Campanha/MG,0,69,0,3629
868455,2022-06-05,Campanha/MG,0,69,0,3629
874052,2022-06-06,Campanha/MG,0,69,7,3636
879649,2022-06-07,Campanha/MG,0,69,14,3650
885246,2022-06-08,Campanha/MG,0,69,16,3666
890843,2022-06-09,Campanha/MG,0,69,17,3683
896440,2022-06-10,Campanha/MG,0,69,16,3699
902037,2022-06-11,Campanha/MG,0,69,0,3699
907634,2022-06-12,Campanha/MG,0,69,0,3699
913231,2022-06-13,Campanha/MG,0,69,12,3711
918828,2022-06-14,Campanha/MG,0,69,0,3711
924425,2022-06-15,Campanha/MG,0,69,14,3725
930022,2022-06-16,Campanha/MG,0,69,0,3725
935619,2022-06-17,Campanha/MG,0,69,0,3725
941216,2022-06-18,Campanha/MG,0,69,0,3725
946813,2022-06-19,Campanha/MG,0,69,0,3725
952410,2022-06-20,Campanha/MG,0,69,21,3746
958007,2022-06-21,Campanha/MG,0,69,36,3782
963604,2022-06-22,Campanha/MG,0,69,20,3802
969201,2022-06-23,Campanha/MG,0,69,10,3812
974798,2022-06-24,Campanha/MG,0,69,17,3829
980395,2022-06-25,Campanha/MG,0,69,0,3829
985992,2022-06-26,Campanha/MG,0,69,0,3829
991589,2022-06-27,Campanha/MG,0,69,17,3846
997186,2022-06-28,Campanha/MG,0,69,29,3875
1002783,2022-06-29,Campanha/MG,0,69,0,3875
1008380,2022-06-30,Campanha/MG,0,69,42,3917
1013977,2022-07-01,Campanha/MG,0,69,4,3921
1019574,2022-07-02,Campanha/MG,0,69,0,3921
1025171,2022-07-03,Campanha/MG,0,69,0,3921
1030768,2022-07-04,Campanha/MG,0,69,19,3940
1036365,2022-07-05,Campanha/MG,0,69,28,3968
1041962,2022-07-06,Campanha/MG,0,69,0,3968
1047559,2022-07-07,Campanha/MG,0,69,22,3990
1053156,2022-07-08,Campanha/MG,0,69,12,4002
1058753,2022-07-09,Campanha/MG,0,69,0,4002
1064350,2022-07-10,Campanha/MG,0,69,0,4002
1069947,2022-07-11,Campanha/MG,0,69,15,4017
1075544,2022-07-12,Campanha/MG,0,69,14,4031
1081141,2022-07-13,Campanha/MG,0,69,23,4054
1086738,2022-07-14,Campanha/MG,0,69,11,4065
1092335,2022-07-15,Campanha/MG,0,69,6,4071
1097932,2022-07-16,Campanha/MG,0,69,0,4071
1103529,2022-07-17,Campanha/MG,0,69,0,4071
1109126,2022-07-18,Campanha/MG,0,69,9,4080
1114723,2022-07-19,Campanha/MG,0,69,17,4097
1120320,2022-07-20,Campanha/MG,0,69,20,4117
1125917,2022-07-21,Campanha/MG,0,69,6,4123
1131514,2022-07-22,Campanha/MG,0,69,2,4125
1137111,2022-07-23,Campanha/MG,0,69,0,4125
1142708,2022-07-24,Campanha/MG,0,69,0,4125
1148305,2022-07-25,Campanha/MG,0,69,7,4132
1153902,2022-07-26,Campanha/MG,0,69,5,4137
1159499,2022-07-27,Campanha/MG,0,69,3,4140
1165096,2022-07-28,Campanha/MG,0,69,0,4140
1170693,2022-07-29,Campanha/MG,1,70,1,4141
1176290,2022-07-30,Campanha/MG,0,70,0,4141
1181887,2022-07-31,Campanha/MG,0,70,0,4141
1187484,2022-08-01,Campanha/MG,0,70,3,4144
1193081,2022-08-02,Campanha/MG,0,70,1,4145
1198678,2022-08-03,Campanha/MG,0,70,1,4146
1204275,2022-08-04,Campanha/MG,0,70,1,4147
1209872,2022-08-05,Campanha/MG,0,70,0,4147
1215469,2022-08-06,Campanha/MG,0,70,0,4147
1221066,2022-08-07,Campanha/MG,0,70,0,4147
1226663,2022-08-08,Campanha/MG,0,70,2,4149
1232260,2022-08-09,Campanha/MG,0,70,0,4149
1237857,2022-08-10,Campanha/MG,0,70,0,4149
1243454,2022-08-11,Campanha/MG,0,70,0,4149
1249051,2022-08-12,Campanha/MG,0,70,1,4150
1254648,2022-08-13,Campanha/MG,0,70,0,4150
1260245,2022-08-14,Campanha/MG,0,70,0,4150
1265842,2022-08-15,Campanha/MG,0,70,0,4150
1271439,2022-08-16,Campanha/MG,0,70,0,4150
1277036,2022-08-17,Campanha/MG,0,70,0,4150
1282633,2022-08-18,Campanha/MG,0,70,5,4155
1288230,2022-08-19,Campanha/MG,0,70,0,4155
1293827,2022-08-20,Campanha/MG,0,70,0,4155
1299424,2022-08-21,Campanha/MG,0,70,0,4155
1305021,2022-08-22,Campanha/MG,1,71,0,4155
1310618,2022-08-23,Campanha/MG,0,71,0,4155
1316215,2022-08-24,Campanha/MG,0,71,0,4155
1321812,2022-08-25,Campanha/MG,0,71,0,4155
926,2022-01-01,Campestre/MG,0,47,1,2184
6523,2022-01-02,Campestre/MG,0,47,0,2184
12120,2022-01-03,Campestre/MG,0,47,0,2184
17717,2022-01-04,Campestre/MG,0,47,0,2184
23314,2022-01-05,Campestre/MG,0,47,1,2185
28911,2022-01-06,Campestre/MG,0,47,2,2187
34508,2022-01-07,Campestre/MG,0,47,10,2197
40105,2022-01-08,Campestre/MG,0,47,24,2221
45702,2022-01-09,Campestre/MG,0,47,80,2301
51299,2022-01-10,Campestre/MG,0,47,-80,2221
56896,2022-01-11,Campestre/MG,0,47,80,2301
62493,2022-01-12,Campestre/MG,0,47,65,2366
68090,2022-01-13,Campestre/MG,0,47,27,2393
73687,2022-01-14,Campestre/MG,0,47,29,2422
79284,2022-01-15,Campestre/MG,0,47,45,2467
84881,2022-01-16,Campestre/MG,0,47,0,2467
90478,2022-01-17,Campestre/MG,0,47,0,2467
96075,2022-01-18,Campestre/MG,0,47,35,2502
101672,2022-01-19,Campestre/MG,0,47,57,2559
107269,2022-01-20,Campestre/MG,0,47,69,2628
112866,2022-01-21,Campestre/MG,0,47,70,2698
118463,2022-01-22,Campestre/MG,0,47,64,2762
124060,2022-01-23,Campestre/MG,0,47,0,2762
129657,2022-01-24,Campestre/MG,0,47,0,2762
135254,2022-01-25,Campestre/MG,0,47,76,2838
140851,2022-01-26,Campestre/MG,1,48,68,2906
146448,2022-01-27,Campestre/MG,0,48,64,2970
152045,2022-01-28,Campestre/MG,0,48,65,3035
157642,2022-01-29,Campestre/MG,0,48,71,3106
163239,2022-01-30,Campestre/MG,3,51,0,3106
168836,2022-01-31,Campestre/MG,0,51,0,3106
174433,2022-02-01,Campestre/MG,0,51,74,3180
180030,2022-02-02,Campestre/MG,0,51,77,3257
185627,2022-02-03,Campestre/MG,0,51,71,3328
191224,2022-02-04,Campestre/MG,0,51,73,3401
196821,2022-02-05,Campestre/MG,0,51,79,3480
202418,2022-02-06,Campestre/MG,0,51,0,3480
208015,2022-02-07,Campestre/MG,0,51,0,3480
213612,2022-02-08,Campestre/MG,0,51,83,3563
219209,2022-02-09,Campestre/MG,0,51,0,3563
224806,2022-02-10,Campestre/MG,0,51,389,3952
230403,2022-02-11,Campestre/MG,0,51,34,3986
236000,2022-02-12,Campestre/MG,0,51,0,3986
241597,2022-02-13,Campestre/MG,1,52,0,3986
247194,2022-02-14,Campestre/MG,0,52,0,3986
252791,2022-02-15,Campestre/MG,0,52,73,4059
258388,2022-02-16,Campestre/MG,0,52,95,4154
263985,2022-02-17,Campestre/MG,0,52,20,4174
269582,2022-02-18,Campestre/MG,0,52,23,4197
275179,2022-02-19,Campestre/MG,1,53,34,4231
280776,2022-02-20,Campestre/MG,-1,52,0,4231
286373,2022-02-21,Campestre/MG,0,52,0,4231
291970,2022-02-22,Campestre/MG,0,52,24,4255
297567,2022-02-23,Campestre/MG,0,52,51,4306
303164,2022-02-24,Campestre/MG,0,52,19,4325
308761,2022-02-25,Campestre/MG,0,52,17,4342
314358,2022-02-26,Campestre/MG,0,52,15,4357
319955,2022-02-27,Campestre/MG,0,52,0,4357
325552,2022-02-28,Campestre/MG,0,52,0,4357
331149,2022-03-01,Campestre/MG,0,52,0,4357
336746,2022-03-02,Campestre/MG,0,52,0,4357
342343,2022-03-03,Campestre/MG,0,52,8,4365
347940,2022-03-04,Campestre/MG,0,52,47,4412
353537,2022-03-05,Campestre/MG,0,52,10,4422
359134,2022-03-06,Campestre/MG,0,52,0,4422
364731,2022-03-07,Campestre/MG,0,52,0,4422
370328,2022-03-08,Campestre/MG,0,52,5,4427
375925,2022-03-09,Campestre/MG,0,52,15,4442
381522,2022-03-10,Campestre/MG,0,52,4,4446
387119,2022-03-11,Campestre/MG,0,52,6,4452
392716,2022-03-12,Campestre/MG,0,52,1,4453
398313,2022-03-13,Campestre/MG,0,52,0,4453
403910,2022-03-14,Campestre/MG,0,52,0,4453
409507,2022-03-15,Campestre/MG,0,52,0,4453
415104,2022-03-16,Campestre/MG,0,52,3,4456
420701,2022-03-17,Campestre/MG,0,52,1,4457
426298,2022-03-18,Campestre/MG,0,52,0,4457
431895,2022-03-19,Campestre/MG,0,52,3,4460
437492,2022-03-20,Campestre/MG,0,52,0,4460
443089,2022-03-21,Campestre/MG,0,52,0,4460
448686,2022-03-22,Campestre/MG,0,52,0,4460
454283,2022-03-23,Campestre/MG,0,52,0,4460
459880,2022-03-24,Campestre/MG,0,52,0,4460
465477,2022-03-25,Campestre/MG,0,52,6,4466
471074,2022-03-26,Campestre/MG,0,52,0,4466
476671,2022-03-27,Campestre/MG,0,52,0,4466
482268,2022-03-28,Campestre/MG,0,52,0,4466
487865,2022-03-29,Campestre/MG,0,52,0,4466
493462,2022-03-30,Campestre/MG,0,52,5,4471
499059,2022-03-31,Campestre/MG,0,52,0,4471
504656,2022-04-01,Campestre/MG,0,52,2,4473
510253,2022-04-02,Campestre/MG,0,52,0,4473
515850,2022-04-03,Campestre/MG,0,52,0,4473
521447,2022-04-04,Campestre/MG,0,52,3,4476
527044,2022-04-05,Campestre/MG,0,52,0,4476
532641,2022-04-06,Campestre/MG,0,52,0,4476
538238,2022-04-07,Campestre/MG,0,52,0,4476
543835,2022-04-08,Campestre/MG,0,52,0,4476
549432,2022-04-09,Campestre/MG,0,52,0,4476
555029,2022-04-10,Campestre/MG,0,52,0,4476
560626,2022-04-11,Campestre/MG,0,52,0,4476
566223,2022-04-12,Campestre/MG,0,52,0,4476
571820,2022-04-13,Campestre/MG,0,52,0,4476
577417,2022-04-14,Campestre/MG,0,52,1,4477
583014,2022-04-15,Campestre/MG,0,52,0,4477
588611,2022-04-16,Campestre/MG,0,52,0,4477
594208,2022-04-17,Campestre/MG,0,52,0,4477
599805,2022-04-18,Campestre/MG,0,52,0,4477
605402,2022-04-19,Campestre/MG,0,52,0,4477
610999,2022-04-20,Campestre/MG,0,52,3,4480
616596,2022-04-21,Campestre/MG,0,52,0,4480
622193,2022-04-22,Campestre/MG,0,52,0,4480
627790,2022-04-23,Campestre/MG,0,52,0,4480
633387,2022-04-24,Campestre/MG,0,52,0,4480
638984,2022-04-25,Campestre/MG,0,52,0,4480
644581,2022-04-26,Campestre/MG,0,52,0,4480
650178,2022-04-27,Campestre/MG,0,52,0,4480
655775,2022-04-28,Campestre/MG,0,52,0,4480
661372,2022-04-29,Campestre/MG,0,52,0,4480
666969,2022-04-30,Campestre/MG,0,52,0,4480
672566,2022-05-01,Campestre/MG,0,52,0,4480
678163,2022-05-02,Campestre/MG,0,52,0,4480
683760,2022-05-03,Campestre/MG,0,52,0,4480
689357,2022-05-04,Campestre/MG,0,52,4,4484
694954,2022-05-05,Campestre/MG,0,52,0,4484
700551,2022-05-06,Campestre/MG,0,52,0,4484
706148,2022-05-07,Campestre/MG,0,52,0,4484
711745,2022-05-08,Campestre/MG,0,52,0,4484
717342,2022-05-09,Campestre/MG,0,52,1,4485
722939,2022-05-10,Campestre/MG,0,52,0,4485
728536,2022-05-11,Campestre/MG,0,52,1,4486
734133,2022-05-12,Campestre/MG,0,52,1,4487
739730,2022-05-13,Campestre/MG,0,52,1,4488
745327,2022-05-14,Campestre/MG,0,52,0,4488
750924,2022-05-15,Campestre/MG,0,52,0,4488
756521,2022-05-16,Campestre/MG,0,52,0,4488
762118,2022-05-17,Campestre/MG,0,52,0,4488
767715,2022-05-18,Campestre/MG,0,52,11,4499
773312,2022-05-19,Campestre/MG,0,52,2,4501
778909,2022-05-20,Campestre/MG,0,52,0,4501
784506,2022-05-21,Campestre/MG,0,52,0,4501
790103,2022-05-22,Campestre/MG,0,52,0,4501
795700,2022-05-23,Campestre/MG,0,52,17,4518
801297,2022-05-24,Campestre/MG,0,52,14,4532
806894,2022-05-25,Campestre/MG,0,52,11,4543
812491,2022-05-26,Campestre/MG,0,52,6,4549
818088,2022-05-27,Campestre/MG,0,52,11,4560
823685,2022-05-28,Campestre/MG,0,52,0,4560
829282,2022-05-29,Campestre/MG,0,52,0,4560
834879,2022-05-30,Campestre/MG,0,52,0,4560
840476,2022-05-31,Campestre/MG,0,52,26,4586
846073,2022-06-01,Campestre/MG,0,52,36,4622
851670,2022-06-02,Campestre/MG,0,52,28,4650
857267,2022-06-03,Campestre/MG,0,52,10,4660
862864,2022-06-04,Campestre/MG,0,52,0,4660
868461,2022-06-05,Campestre/MG,0,52,0,4660
874058,2022-06-06,Campestre/MG,0,52,39,4699
879655,2022-06-07,Campestre/MG,0,52,27,4726
885252,2022-06-08,Campestre/MG,1,53,48,4774
890849,2022-06-09,Campestre/MG,0,53,36,4810
896446,2022-06-10,Campestre/MG,0,53,0,4810
902043,2022-06-11,Campestre/MG,0,53,0,4810
907640,2022-06-12,Campestre/MG,0,53,0,4810
913237,2022-06-13,Campestre/MG,0,53,52,4862
918834,2022-06-14,Campestre/MG,0,53,45,4907
924431,2022-06-15,Campestre/MG,-1,52,52,4959
930028,2022-06-16,Campestre/MG,0,52,0,4959
935625,2022-06-17,Campestre/MG,0,52,0,4959
941222,2022-06-18,Campestre/MG,0,52,0,4959
946819,2022-06-19,Campestre/MG,0,52,0,4959
952416,2022-06-20,Campestre/MG,0,52,0,4959
958013,2022-06-21,Campestre/MG,0,52,75,5034
963610,2022-06-22,Campestre/MG,0,52,0,5034
969207,2022-06-23,Campestre/MG,0,52,53,5087
974804,2022-06-24,Campestre/MG,0,52,18,5105
980401,2022-06-25,Campestre/MG,0,52,0,5105
985998,2022-06-26,Campestre/MG,0,52,0,5105
991595,2022-06-27,Campestre/MG,0,52,19,5124
997192,2022-06-28,Campestre/MG,0,52,28,5152
1002789,2022-06-29,Campestre/MG,0,52,0,5152
1008386,2022-06-30,Campestre/MG,0,52,54,5206
1013983,2022-07-01,Campestre/MG,0,52,30,5236
1019580,2022-07-02,Campestre/MG,0,52,0,5236
1025177,2022-07-03,Campestre/MG,0,52,0,5236
1030774,2022-07-04,Campestre/MG,0,52,25,5261
1036371,2022-07-05,Campestre/MG,0,52,30,5291
1041968,2022-07-06,Campestre/MG,0,52,49,5340
1047565,2022-07-07,Campestre/MG,0,52,13,5353
1053162,2022-07-08,Campestre/MG,0,52,0,5353
1058759,2022-07-09,Campestre/MG,0,52,0,5353
1064356,2022-07-10,Campestre/MG,0,52,0,5353
1069953,2022-07-11,Campestre/MG,0,52,21,5374
1075550,2022-07-12,Campestre/MG,0,52,31,5405
1081147,2022-07-13,Campestre/MG,0,52,36,5441
1086744,2022-07-14,Campestre/MG,0,52,23,5464
1092341,2022-07-15,Campestre/MG,0,52,22,5486
1097938,2022-07-16,Campestre/MG,0,52,0,5486
1103535,2022-07-17,Campestre/MG,0,52,0,5486
1109132,2022-07-18,Campestre/MG,0,52,0,5486
1114729,2022-07-19,Campestre/MG,0,52,0,5486
1120326,2022-07-20,Campestre/MG,0,52,53,5539
1125923,2022-07-21,Campestre/MG,0,52,17,5556
1131520,2022-07-22,Campestre/MG,0,52,14,5570
1137117,2022-07-23,Campestre/MG,0,52,0,5570
1142714,2022-07-24,Campestre/MG,0,52,0,5570
1148311,2022-07-25,Campestre/MG,0,52,6,5576
1153908,2022-07-26,Campestre/MG,0,52,15,5591
1159505,2022-07-27,Campestre/MG,0,52,9,5600
1165102,2022-07-28,Campestre/MG,0,52,6,5606
1170699,2022-07-29,Campestre/MG,0,52,13,5619
1176296,2022-07-30,Campestre/MG,0,52,0,5619
1181893,2022-07-31,Campestre/MG,0,52,0,5619
1187490,2022-08-01,Campestre/MG,0,52,8,5627
1193087,2022-08-02,Campestre/MG,0,52,2,5629
1198684,2022-08-03,Campestre/MG,0,52,5,5634
1204281,2022-08-04,Campestre/MG,0,52,0,5634
1209878,2022-08-05,Campestre/MG,0,52,10,5644
1215475,2022-08-06,Campestre/MG,0,52,0,5644
1221072,2022-08-07,Campestre/MG,0,52,0,5644
1226669,2022-08-08,Campestre/MG,0,52,2,5646
1232266,2022-08-09,Campestre/MG,0,52,10,5656
1237863,2022-08-10,Campestre/MG,0,52,3,5659
1243460,2022-08-11,Campestre/MG,0,52,0,5659
1249057,2022-08-12,Campestre/MG,0,52,6,5665
1254654,2022-08-13,Campestre/MG,0,52,0,5665
1260251,2022-08-14,Campestre/MG,0,52,0,5665
1265848,2022-08-15,Campestre/MG,0,52,0,5665
1271445,2022-08-16,Campestre/MG,0,52,8,5673
1277042,2022-08-17,Campestre/MG,0,52,0,5673
1282639,2022-08-18,Campestre/MG,0,52,3,5676
1288236,2022-08-19,Campestre/MG,0,52,4,5680
1293833,2022-08-20,Campestre/MG,0,52,0,5680
1299430,2022-08-21,Campestre/MG,0,52,0,5680
1305027,2022-08-22,Campestre/MG,0,52,7,5687
1310624,2022-08-23,Campestre/MG,0,52,4,5691
1316221,2022-08-24,Campestre/MG,0,52,0,5691
1321818,2022-08-25,Campestre/MG,0,52,8,5699
970,2022-01-01,Campo do Meio/MG,0,16,0,965
6567,2022-01-02,Campo do Meio/MG,0,16,0,965
12164,2022-01-03,Campo do Meio/MG,0,16,0,965
17761,2022-01-04,Campo do Meio/MG,-1,15,0,965
23358,2022-01-05,Campo do Meio/MG,0,15,0,965
28955,2022-01-06,Campo do Meio/MG,0,15,0,965
34552,2022-01-07,Campo do Meio/MG,0,15,43,1008
40149,2022-01-08,Campo do Meio/MG,0,15,109,1117
45746,2022-01-09,Campo do Meio/MG,0,15,0,1117
51343,2022-01-10,Campo do Meio/MG,0,15,0,1117
56940,2022-01-11,Campo do Meio/MG,0,15,173,1290
62537,2022-01-12,Campo do Meio/MG,0,15,0,1290
68134,2022-01-13,Campo do Meio/MG,0,15,0,1290
73731,2022-01-14,Campo do Meio/MG,0,15,135,1425
79328,2022-01-15,Campo do Meio/MG,0,15,50,1475
84925,2022-01-16,Campo do Meio/MG,0,15,0,1475
90522,2022-01-17,Campo do Meio/MG,0,15,0,1475
96119,2022-01-18,Campo do Meio/MG,0,15,0,1475
101716,2022-01-19,Campo do Meio/MG,1,16,0,1475
107313,2022-01-20,Campo do Meio/MG,0,16,93,1568
112910,2022-01-21,Campo do Meio/MG,0,16,15,1583
118507,2022-01-22,Campo do Meio/MG,0,16,0,1583
124104,2022-01-23,Campo do Meio/MG,0,16,0,1583
129701,2022-01-24,Campo do Meio/MG,0,16,0,1583
135298,2022-01-25,Campo do Meio/MG,0,16,102,1685
140895,2022-01-26,Campo do Meio/MG,0,16,34,1719
146492,2022-01-27,Campo do Meio/MG,0,16,0,1719
152089,2022-01-28,Campo do Meio/MG,0,16,0,1719
157686,2022-01-29,Campo do Meio/MG,0,16,49,1768
163283,2022-01-30,Campo do Meio/MG,0,16,0,1768
168880,2022-01-31,Campo do Meio/MG,0,16,0,1768
174477,2022-02-01,Campo do Meio/MG,0,16,0,1768
180074,2022-02-02,Campo do Meio/MG,0,16,80,1848
185671,2022-02-03,Campo do Meio/MG,0,16,9,1857
191268,2022-02-04,Campo do Meio/MG,0,16,6,1863
196865,2022-02-05,Campo do Meio/MG,0,16,5,1868
202462,2022-02-06,Campo do Meio/MG,0,16,0,1868
208059,2022-02-07,Campo do Meio/MG,0,16,0,1868
213656,2022-02-08,Campo do Meio/MG,0,16,38,1906
219253,2022-02-09,Campo do Meio/MG,0,16,9,1915
224850,2022-02-10,Campo do Meio/MG,0,16,0,1915
230447,2022-02-11,Campo do Meio/MG,1,17,23,1938
236044,2022-02-12,Campo do Meio/MG,0,17,0,1938
241641,2022-02-13,Campo do Meio/MG,0,17,0,1938
247238,2022-02-14,Campo do Meio/MG,0,17,0,1938
252835,2022-02-15,Campo do Meio/MG,0,17,20,1958
258432,2022-02-16,Campo do Meio/MG,0,17,0,1958
264029,2022-02-17,Campo do Meio/MG,0,17,19,1977
269626,2022-02-18,Campo do Meio/MG,0,17,0,1977
275223,2022-02-19,Campo do Meio/MG,0,17,12,1989
280820,2022-02-20,Campo do Meio/MG,0,17,0,1989
286417,2022-02-21,Campo do Meio/MG,0,17,0,1989
292014,2022-02-22,Campo do Meio/MG,0,17,14,2003
297611,2022-02-23,Campo do Meio/MG,0,17,8,2011
303208,2022-02-24,Campo do Meio/MG,0,17,6,2017
308805,2022-02-25,Campo do Meio/MG,0,17,0,2017
314402,2022-02-26,Campo do Meio/MG,0,17,13,2030
319999,2022-02-27,Campo do Meio/MG,0,17,0,2030
325596,2022-02-28,Campo do Meio/MG,0,17,0,2030
331193,2022-03-01,Campo do Meio/MG,0,17,0,2030
336790,2022-03-02,Campo do Meio/MG,0,17,0,2030
342387,2022-03-03,Campo do Meio/MG,0,17,0,2030
347984,2022-03-04,Campo do Meio/MG,0,17,9,2039
353581,2022-03-05,Campo do Meio/MG,0,17,5,2044
359178,2022-03-06,Campo do Meio/MG,0,17,0,2044
364775,2022-03-07,Campo do Meio/MG,0,17,0,2044
370372,2022-03-08,Campo do Meio/MG,0,17,0,2044
375969,2022-03-09,Campo do Meio/MG,0,17,26,2070
381566,2022-03-10,Campo do Meio/MG,0,17,0,2070
387163,2022-03-11,Campo do Meio/MG,0,17,-7,2063
392760,2022-03-12,Campo do Meio/MG,0,17,2,2065
398357,2022-03-13,Campo do Meio/MG,0,17,0,2065
403954,2022-03-14,Campo do Meio/MG,0,17,0,2065
409551,2022-03-15,Campo do Meio/MG,0,17,0,2065
415148,2022-03-16,Campo do Meio/MG,0,17,6,2071
420745,2022-03-17,Campo do Meio/MG,0,17,0,2071
426342,2022-03-18,Campo do Meio/MG,0,17,0,2071
431939,2022-03-19,Campo do Meio/MG,0,17,0,2071
437536,2022-03-20,Campo do Meio/MG,0,17,0,2071
443133,2022-03-21,Campo do Meio/MG,0,17,0,2071
448730,2022-03-22,Campo do Meio/MG,0,17,0,2071
454327,2022-03-23,Campo do Meio/MG,0,17,0,2071
459924,2022-03-24,Campo do Meio/MG,0,17,7,2078
465521,2022-03-25,Campo do Meio/MG,0,17,0,2078
471118,2022-03-26,Campo do Meio/MG,0,17,0,2078
476715,2022-03-27,Campo do Meio/MG,0,17,0,2078
482312,2022-03-28,Campo do Meio/MG,0,17,0,2078
487909,2022-03-29,Campo do Meio/MG,0,17,5,2083
493506,2022-03-30,Campo do Meio/MG,0,17,0,2083
499103,2022-03-31,Campo do Meio/MG,0,17,1,2084
504700,2022-04-01,Campo do Meio/MG,0,17,0,2084
510297,2022-04-02,Campo do Meio/MG,0,17,0,2084
515894,2022-04-03,Campo do Meio/MG,0,17,0,2084
521491,2022-04-04,Campo do Meio/MG,0,17,0,2084
527088,2022-04-05,Campo do Meio/MG,0,17,0,2084
532685,2022-04-06,Campo do Meio/MG,0,17,0,2084
538282,2022-04-07,Campo do Meio/MG,0,17,0,2084
543879,2022-04-08,Campo do Meio/MG,0,17,0,2084
549476,2022-04-09,Campo do Meio/MG,0,17,0,2084
555073,2022-04-10,Campo do Meio/MG,0,17,0,2084
560670,2022-04-11,Campo do Meio/MG,0,17,0,2084
566267,2022-04-12,Campo do Meio/MG,0,17,1,2085
571864,2022-04-13,Campo do Meio/MG,0,17,0,2085
577461,2022-04-14,Campo do Meio/MG,0,17,0,2085
583058,2022-04-15,Campo do Meio/MG,1,18,0,2085
588655,2022-04-16,Campo do Meio/MG,0,18,0,2085
594252,2022-04-17,Campo do Meio/MG,0,18,0,2085
599849,2022-04-18,Campo do Meio/MG,0,18,0,2085
605446,2022-04-19,Campo do Meio/MG,0,18,1,2086
611043,2022-04-20,Campo do Meio/MG,0,18,0,2086
616640,2022-04-21,Campo do Meio/MG,0,18,0,2086
622237,2022-04-22,Campo do Meio/MG,0,18,0,2086
627834,2022-04-23,Campo do Meio/MG,0,18,0,2086
633431,2022-04-24,Campo do Meio/MG,0,18,0,2086
639028,2022-04-25,Campo do Meio/MG,0,18,0,2086
644625,2022-04-26,Campo do Meio/MG,0,18,1,2087
650222,2022-04-27,Campo do Meio/MG,0,18,0,2087
655819,2022-04-28,Campo do Meio/MG,0,18,0,2087
661416,2022-04-29,Campo do Meio/MG,0,18,0,2087
667013,2022-04-30,Campo do Meio/MG,0,18,0,2087
672610,2022-05-01,Campo do Meio/MG,0,18,0,2087
678207,2022-05-02,Campo do Meio/MG,0,18,0,2087
683804,2022-05-03,Campo do Meio/MG,0,18,3,2090
689401,2022-05-04,Campo do Meio/MG,0,18,0,2090
694998,2022-05-05,Campo do Meio/MG,0,18,2,2092
700595,2022-05-06,Campo do Meio/MG,0,18,1,2093
706192,2022-05-07,Campo do Meio/MG,0,18,0,2093
711789,2022-05-08,Campo do Meio/MG,0,18,0,2093
717386,2022-05-09,Campo do Meio/MG,0,18,0,2093
722983,2022-05-10,Campo do Meio/MG,0,18,6,2099
728580,2022-05-11,Campo do Meio/MG,0,18,0,2099
734177,2022-05-12,Campo do Meio/MG,0,18,0,2099
739774,2022-05-13,Campo do Meio/MG,0,18,4,2103
745371,2022-05-14,Campo do Meio/MG,0,18,0,2103
750968,2022-05-15,Campo do Meio/MG,0,18,0,2103
756565,2022-05-16,Campo do Meio/MG,0,18,0,2103
762162,2022-05-17,Campo do Meio/MG,0,18,6,2109
767759,2022-05-18,Campo do Meio/MG,0,18,0,2109
773356,2022-05-19,Campo do Meio/MG,0,18,0,2109
778953,2022-05-20,Campo do Meio/MG,0,18,23,2132
784550,2022-05-21,Campo do Meio/MG,0,18,0,2132
790147,2022-05-22,Campo do Meio/MG,0,18,0,2132
795744,2022-05-23,Campo do Meio/MG,0,18,2,2134
801341,2022-05-24,Campo do Meio/MG,0,18,0,2134
806938,2022-05-25,Campo do Meio/MG,0,18,0,2134
812535,2022-05-26,Campo do Meio/MG,0,18,32,2166
818132,2022-05-27,Campo do Meio/MG,0,18,0,2166
823729,2022-05-28,Campo do Meio/MG,0,18,0,2166
829326,2022-05-29,Campo do Meio/MG,0,18,0,2166
834923,2022-05-30,Campo do Meio/MG,0,18,0,2166
840520,2022-05-31,Campo do Meio/MG,0,18,0,2166
846117,2022-06-01,Campo do Meio/MG,0,18,0,2166
851714,2022-06-02,Campo do Meio/MG,0,18,0,2166
857311,2022-06-03,Campo do Meio/MG,0,18,45,2211
862908,2022-06-04,Campo do Meio/MG,0,18,0,2211
868505,2022-06-05,Campo do Meio/MG,0,18,0,2211
874102,2022-06-06,Campo do Meio/MG,0,18,0,2211
879699,2022-06-07,Campo do Meio/MG,0,18,14,2225
885296,2022-06-08,Campo do Meio/MG,0,18,14,2239
890893,2022-06-09,Campo do Meio/MG,0,18,18,2257
896490,2022-06-10,Campo do Meio/MG,0,18,0,2257
902087,2022-06-11,Campo do Meio/MG,0,18,0,2257
907684,2022-06-12,Campo do Meio/MG,0,18,0,2257
913281,2022-06-13,Campo do Meio/MG,0,18,0,2257
918878,2022-06-14,Campo do Meio/MG,0,18,0,2257
924475,2022-06-15,Campo do Meio/MG,0,18,51,2308
930072,2022-06-16,Campo do Meio/MG,0,18,0,2308
935669,2022-06-17,Campo do Meio/MG,0,18,0,2308
941266,2022-06-18,Campo do Meio/MG,0,18,0,2308
946863,2022-06-19,Campo do Meio/MG,0,18,0,2308
952460,2022-06-20,Campo do Meio/MG,0,18,10,2318
958057,2022-06-21,Campo do Meio/MG,0,18,34,2352
963654,2022-06-22,Campo do Meio/MG,0,18,20,2372
969251,2022-06-23,Campo do Meio/MG,0,18,13,2385
974848,2022-06-24,Campo do Meio/MG,0,18,0,2385
980445,2022-06-25,Campo do Meio/MG,0,18,0,2385
986042,2022-06-26,Campo do Meio/MG,0,18,0,2385
991639,2022-06-27,Campo do Meio/MG,0,18,0,2385
997236,2022-06-28,Campo do Meio/MG,0,18,0,2385
1002833,2022-06-29,Campo do Meio/MG,0,18,0,2385
1008430,2022-06-30,Campo do Meio/MG,0,18,0,2385
1014027,2022-07-01,Campo do Meio/MG,0,18,190,2575
1019624,2022-07-02,Campo do Meio/MG,0,18,0,2575
1025221,2022-07-03,Campo do Meio/MG,0,18,0,2575
1030818,2022-07-04,Campo do Meio/MG,0,18,0,2575
1036415,2022-07-05,Campo do Meio/MG,0,18,7,2582
1042012,2022-07-06,Campo do Meio/MG,0,18,0,2582
1047609,2022-07-07,Campo do Meio/MG,0,18,0,2582
1053206,2022-07-08,Campo do Meio/MG,0,18,0,2582
1058803,2022-07-09,Campo do Meio/MG,0,18,0,2582
1064400,2022-07-10,Campo do Meio/MG,0,18,0,2582
1069997,2022-07-11,Campo do Meio/MG,0,18,0,2582
1075594,2022-07-12,Campo do Meio/MG,0,18,47,2629
1081191,2022-07-13,Campo do Meio/MG,0,18,8,2637
1086788,2022-07-14,Campo do Meio/MG,0,18,0,2637
1092385,2022-07-15,Campo do Meio/MG,0,18,16,2653
1097982,2022-07-16,Campo do Meio/MG,0,18,0,2653
1103579,2022-07-17,Campo do Meio/MG,0,18,0,2653
1109176,2022-07-18,Campo do Meio/MG,0,18,0,2653
1114773,2022-07-19,Campo do Meio/MG,0,18,0,2653
1120370,2022-07-20,Campo do Meio/MG,0,18,28,2681
1125967,2022-07-21,Campo do Meio/MG,0,18,0,2681
1131564,2022-07-22,Campo do Meio/MG,0,18,7,2688
1137161,2022-07-23,Campo do Meio/MG,0,18,0,2688
1142758,2022-07-24,Campo do Meio/MG,0,18,0,2688
1148355,2022-07-25,Campo do Meio/MG,0,18,0,2688
1153952,2022-07-26,Campo do Meio/MG,0,18,0,2688
1159549,2022-07-27,Campo do Meio/MG,0,18,26,2714
1165146,2022-07-28,Campo do Meio/MG,0,18,5,2719
1170743,2022-07-29,Campo do Meio/MG,0,18,0,2719
1176340,2022-07-30,Campo do Meio/MG,0,18,0,2719
1181937,2022-07-31,Campo do Meio/MG,0,18,0,2719
1187534,2022-08-01,Campo do Meio/MG,0,18,0,2719
1193131,2022-08-02,Campo do Meio/MG,0,18,11,2730
1198728,2022-08-03,Campo do Meio/MG,0,18,0,2730
1204325,2022-08-04,Campo do Meio/MG,0,18,3,2733
1209922,2022-08-05,Campo do Meio/MG,0,18,0,2733
1215519,2022-08-06,Campo do Meio/MG,0,18,0,2733
1221116,2022-08-07,Campo do Meio/MG,0,18,0,2733
1226713,2022-08-08,Campo do Meio/MG,0,18,0,2733
1232310,2022-08-09,Campo do Meio/MG,0,18,0,2733
1237907,2022-08-10,Campo do Meio/MG,0,18,0,2733
1243504,2022-08-11,Campo do Meio/MG,0,18,0,2733
1249101,2022-08-12,Campo do Meio/MG,0,18,0,2733
1254698,2022-08-13,Campo do Meio/MG,0,18,0,2733
1260295,2022-08-14,Campo do Meio/MG,0,18,0,2733
1265892,2022-08-15,Campo do Meio/MG,0,18,0,2733
1271489,2022-08-16,Campo do Meio/MG,0,18,11,2744
1277086,2022-08-17,Campo do Meio/MG,0,18,0,2744
1282683,2022-08-18,Campo do Meio/MG,0,18,0,2744
1288280,2022-08-19,Campo do Meio/MG,0,18,0,2744
1293877,2022-08-20,Campo do Meio/MG,0,18,0,2744
1299474,2022-08-21,Campo do Meio/MG,0,18,0,2744
1305071,2022-08-22,Campo do Meio/MG,0,18,0,2744
1310668,2022-08-23,Campo do Meio/MG,0,18,9,2753
1316265,2022-08-24,Campo do Meio/MG,0,18,0,2753
1321862,2022-08-25,Campo do Meio/MG,0,18,0,2753
975,2022-01-01,Campos Gerais/MG,0,45,0,2459
6572,2022-01-02,Campos Gerais/MG,0,45,0,2459
12169,2022-01-03,Campos Gerais/MG,0,45,7,2466
17766,2022-01-04,Campos Gerais/MG,0,45,0,2466
23363,2022-01-05,Campos Gerais/MG,0,45,22,2488
28960,2022-01-06,Campos Gerais/MG,0,45,37,2525
34557,2022-01-07,Campos Gerais/MG,0,45,65,2590
40154,2022-01-08,Campos Gerais/MG,0,45,83,2673
45751,2022-01-09,Campos Gerais/MG,0,45,0,2673
51348,2022-01-10,Campos Gerais/MG,0,45,144,2817
56945,2022-01-11,Campos Gerais/MG,0,45,28,2845
62542,2022-01-12,Campos Gerais/MG,0,45,69,2914
68139,2022-01-13,Campos Gerais/MG,0,45,82,2996
73736,2022-01-14,Campos Gerais/MG,0,45,0,2996
79333,2022-01-15,Campos Gerais/MG,0,45,169,3165
84930,2022-01-16,Campos Gerais/MG,0,45,0,3165
90527,2022-01-17,Campos Gerais/MG,0,45,195,3360
96124,2022-01-18,Campos Gerais/MG,0,45,38,3398
101721,2022-01-19,Campos Gerais/MG,0,45,92,3490
107318,2022-01-20,Campos Gerais/MG,0,45,112,3602
112915,2022-01-21,Campos Gerais/MG,0,45,81,3683
118512,2022-01-22,Campos Gerais/MG,0,45,62,3745
124109,2022-01-23,Campos Gerais/MG,0,45,0,3745
129706,2022-01-24,Campos Gerais/MG,0,45,0,3745
135303,2022-01-25,Campos Gerais/MG,0,45,91,3836
140900,2022-01-26,Campos Gerais/MG,0,45,68,3904
146497,2022-01-27,Campos Gerais/MG,0,45,31,3935
152094,2022-01-28,Campos Gerais/MG,0,45,55,3990
157691,2022-01-29,Campos Gerais/MG,0,45,0,3990
163288,2022-01-30,Campos Gerais/MG,0,45,93,4083
168885,2022-01-31,Campos Gerais/MG,0,45,0,4083
174482,2022-02-01,Campos Gerais/MG,0,45,30,4113
180079,2022-02-02,Campos Gerais/MG,0,45,60,4173
185676,2022-02-03,Campos Gerais/MG,0,45,15,4188
191273,2022-02-04,Campos Gerais/MG,0,45,27,4215
196870,2022-02-05,Campos Gerais/MG,0,45,42,4257
202467,2022-02-06,Campos Gerais/MG,1,46,0,4257
208064,2022-02-07,Campos Gerais/MG,0,46,0,4257
213661,2022-02-08,Campos Gerais/MG,0,46,48,4305
219258,2022-02-09,Campos Gerais/MG,0,46,35,4340
224855,2022-02-10,Campos Gerais/MG,0,46,30,4370
230452,2022-02-11,Campos Gerais/MG,0,46,21,4391
236049,2022-02-12,Campos Gerais/MG,0,46,23,4414
241646,2022-02-13,Campos Gerais/MG,0,46,0,4414
247243,2022-02-14,Campos Gerais/MG,0,46,35,4449
252840,2022-02-15,Campos Gerais/MG,0,46,2,4451
258437,2022-02-16,Campos Gerais/MG,0,46,29,4480
264034,2022-02-17,Campos Gerais/MG,0,46,28,4508
269631,2022-02-18,Campos Gerais/MG,0,46,22,4530
275228,2022-02-19,Campos Gerais/MG,0,46,0,4530
280825,2022-02-20,Campos Gerais/MG,0,46,0,4530
286422,2022-02-21,Campos Gerais/MG,0,46,0,4530
292019,2022-02-22,Campos Gerais/MG,0,46,65,4595
297616,2022-02-23,Campos Gerais/MG,0,46,14,4609
303213,2022-02-24,Campos Gerais/MG,0,46,18,4627
308810,2022-02-25,Campos Gerais/MG,0,46,8,4635
314407,2022-02-26,Campos Gerais/MG,0,46,12,4647
320004,2022-02-27,Campos Gerais/MG,0,46,0,4647
325601,2022-02-28,Campos Gerais/MG,0,46,21,4668
331198,2022-03-01,Campos Gerais/MG,0,46,0,4668
336795,2022-03-02,Campos Gerais/MG,0,46,0,4668
342392,2022-03-03,Campos Gerais/MG,0,46,8,4676
347989,2022-03-04,Campos Gerais/MG,0,46,5,4681
353586,2022-03-05,Campos Gerais/MG,0,46,13,4694
359183,2022-03-06,Campos Gerais/MG,0,46,0,4694
364780,2022-03-07,Campos Gerais/MG,0,46,0,4694
370377,2022-03-08,Campos Gerais/MG,0,46,13,4707
375974,2022-03-09,Campos Gerais/MG,0,46,8,4715
381571,2022-03-10,Campos Gerais/MG,0,46,3,4718
387168,2022-03-11,Campos Gerais/MG,0,46,0,4718
392765,2022-03-12,Campos Gerais/MG,0,46,12,4730
398362,2022-03-13,Campos Gerais/MG,0,46,0,4730
403959,2022-03-14,Campos Gerais/MG,0,46,0,4730
409556,2022-03-15,Campos Gerais/MG,0,46,4,4734
415153,2022-03-16,Campos Gerais/MG,0,46,5,4739
420750,2022-03-17,Campos Gerais/MG,0,46,0,4739
426347,2022-03-18,Campos Gerais/MG,1,47,24,4763
431944,2022-03-19,Campos Gerais/MG,0,47,5,4768
437541,2022-03-20,Campos Gerais/MG,0,47,0,4768
443138,2022-03-21,Campos Gerais/MG,0,47,0,4768
448735,2022-03-22,Campos Gerais/MG,1,48,2,4770
454332,2022-03-23,Campos Gerais/MG,0,48,4,4774
459929,2022-03-24,Campos Gerais/MG,0,48,4,4778
465526,2022-03-25,Campos Gerais/MG,0,48,2,4780
471123,2022-03-26,Campos Gerais/MG,0,48,0,4780
476720,2022-03-27,Campos Gerais/MG,0,48,0,4780
482317,2022-03-28,Campos Gerais/MG,0,48,0,4780
487914,2022-03-29,Campos Gerais/MG,1,49,7,4787
493511,2022-03-30,Campos Gerais/MG,0,49,0,4787
499108,2022-03-31,Campos Gerais/MG,0,49,4,4791
504705,2022-04-01,Campos Gerais/MG,0,49,0,4791
510302,2022-04-02,Campos Gerais/MG,0,49,0,4791
515899,2022-04-03,Campos Gerais/MG,0,49,0,4791
521496,2022-04-04,Campos Gerais/MG,0,49,4,4795
527093,2022-04-05,Campos Gerais/MG,0,49,0,4795
532690,2022-04-06,Campos Gerais/MG,0,49,0,4795
538287,2022-04-07,Campos Gerais/MG,0,49,0,4795
543884,2022-04-08,Campos Gerais/MG,0,49,0,4795
549481,2022-04-09,Campos Gerais/MG,0,49,0,4795
555078,2022-04-10,Campos Gerais/MG,0,49,0,4795
560675,2022-04-11,Campos Gerais/MG,0,49,0,4795
566272,2022-04-12,Campos Gerais/MG,0,49,2,4797
571869,2022-04-13,Campos Gerais/MG,0,49,0,4797
577466,2022-04-14,Campos Gerais/MG,0,49,1,4798
583063,2022-04-15,Campos Gerais/MG,0,49,0,4798
588660,2022-04-16,Campos Gerais/MG,0,49,0,4798
594257,2022-04-17,Campos Gerais/MG,0,49,0,4798
599854,2022-04-18,Campos Gerais/MG,0,49,2,4800
605451,2022-04-19,Campos Gerais/MG,0,49,0,4800
611048,2022-04-20,Campos Gerais/MG,0,49,2,4802
616645,2022-04-21,Campos Gerais/MG,0,49,0,4802
622242,2022-04-22,Campos Gerais/MG,0,49,0,4802
627839,2022-04-23,Campos Gerais/MG,0,49,0,4802
633436,2022-04-24,Campos Gerais/MG,0,49,0,4802
639033,2022-04-25,Campos Gerais/MG,0,49,1,4803
644630,2022-04-26,Campos Gerais/MG,0,49,0,4803
650227,2022-04-27,Campos Gerais/MG,0,49,0,4803
655824,2022-04-28,Campos Gerais/MG,0,49,0,4803
661421,2022-04-29,Campos Gerais/MG,0,49,1,4804
667018,2022-04-30,Campos Gerais/MG,0,49,0,4804
672615,2022-05-01,Campos Gerais/MG,0,49,0,4804
678212,2022-05-02,Campos Gerais/MG,0,49,0,4804
683809,2022-05-03,Campos Gerais/MG,0,49,3,4807
689406,2022-05-04,Campos Gerais/MG,0,49,0,4807
695003,2022-05-05,Campos Gerais/MG,0,49,5,4812
700600,2022-05-06,Campos Gerais/MG,0,49,0,4812
706197,2022-05-07,Campos Gerais/MG,0,49,0,4812
711794,2022-05-08,Campos Gerais/MG,0,49,0,4812
717391,2022-05-09,Campos Gerais/MG,0,49,0,4812
722988,2022-05-10,Campos Gerais/MG,0,49,3,4815
728585,2022-05-11,Campos Gerais/MG,0,49,0,4815
734182,2022-05-12,Campos Gerais/MG,0,49,5,4820
739779,2022-05-13,Campos Gerais/MG,0,49,6,4826
745376,2022-05-14,Campos Gerais/MG,0,49,0,4826
750973,2022-05-15,Campos Gerais/MG,0,49,0,4826
756570,2022-05-16,Campos Gerais/MG,0,49,0,4826
762167,2022-05-17,Campos Gerais/MG,0,49,17,4843
767764,2022-05-18,Campos Gerais/MG,0,49,0,4843
773361,2022-05-19,Campos Gerais/MG,0,49,13,4856
778958,2022-05-20,Campos Gerais/MG,0,49,0,4856
784555,2022-05-21,Campos Gerais/MG,0,49,0,4856
790152,2022-05-22,Campos Gerais/MG,0,49,0,4856
795749,2022-05-23,Campos Gerais/MG,0,49,8,4864
801346,2022-05-24,Campos Gerais/MG,0,49,7,4871
806943,2022-05-25,Campos Gerais/MG,0,49,0,4871
812540,2022-05-26,Campos Gerais/MG,0,49,20,4891
818137,2022-05-27,Campos Gerais/MG,0,49,0,4891
823734,2022-05-28,Campos Gerais/MG,0,49,0,4891
829331,2022-05-29,Campos Gerais/MG,0,49,0,4891
834928,2022-05-30,Campos Gerais/MG,0,49,34,4925
840525,2022-05-31,Campos Gerais/MG,0,49,14,4939
846122,2022-06-01,Campos Gerais/MG,0,49,0,4939
851719,2022-06-02,Campos Gerais/MG,0,49,42,4981
857316,2022-06-03,Campos Gerais/MG,0,49,0,4981
862913,2022-06-04,Campos Gerais/MG,0,49,0,4981
868510,2022-06-05,Campos Gerais/MG,0,49,0,4981
874107,2022-06-06,Campos Gerais/MG,0,49,36,5017
879704,2022-06-07,Campos Gerais/MG,0,49,25,5042
885301,2022-06-08,Campos Gerais/MG,0,49,0,5042
890898,2022-06-09,Campos Gerais/MG,0,49,47,5089
896495,2022-06-10,Campos Gerais/MG,0,49,25,5114
902092,2022-06-11,Campos Gerais/MG,0,49,0,5114
907689,2022-06-12,Campos Gerais/MG,0,49,0,5114
913286,2022-06-13,Campos Gerais/MG,0,49,39,5153
918883,2022-06-14,Campos Gerais/MG,0,49,0,5153
924480,2022-06-15,Campos Gerais/MG,0,49,16,5169
930077,2022-06-16,Campos Gerais/MG,0,49,0,5169
935674,2022-06-17,Campos Gerais/MG,0,49,0,5169
941271,2022-06-18,Campos Gerais/MG,0,49,0,5169
946868,2022-06-19,Campos Gerais/MG,0,49,0,5169
952465,2022-06-20,Campos Gerais/MG,0,49,12,5181
958062,2022-06-21,Campos Gerais/MG,0,49,44,5225
963659,2022-06-22,Campos Gerais/MG,0,49,0,5225
969256,2022-06-23,Campos Gerais/MG,0,49,22,5247
974853,2022-06-24,Campos Gerais/MG,0,49,0,5247
980450,2022-06-25,Campos Gerais/MG,0,49,0,5247
986047,2022-06-26,Campos Gerais/MG,0,49,0,5247
991644,2022-06-27,Campos Gerais/MG,0,49,40,5287
997241,2022-06-28,Campos Gerais/MG,0,49,26,5313
1002838,2022-06-29,Campos Gerais/MG,0,49,0,5313
1008435,2022-06-30,Campos Gerais/MG,0,49,0,5313
1014032,2022-07-01,Campos Gerais/MG,0,49,56,5369
1019629,2022-07-02,Campos Gerais/MG,0,49,0,5369
1025226,2022-07-03,Campos Gerais/MG,0,49,0,5369
1030823,2022-07-04,Campos Gerais/MG,0,49,0,5369
1036420,2022-07-05,Campos Gerais/MG,0,49,32,5401
1042017,2022-07-06,Campos Gerais/MG,0,49,0,5401
1047614,2022-07-07,Campos Gerais/MG,0,49,63,5464
1053211,2022-07-08,Campos Gerais/MG,0,49,0,5464
1058808,2022-07-09,Campos Gerais/MG,0,49,0,5464
1064405,2022-07-10,Campos Gerais/MG,0,49,0,5464
1070002,2022-07-11,Campos Gerais/MG,0,49,0,5464
1075599,2022-07-12,Campos Gerais/MG,0,49,50,5514
1081196,2022-07-13,Campos Gerais/MG,0,49,0,5514
1086793,2022-07-14,Campos Gerais/MG,0,49,0,5514
1092390,2022-07-15,Campos Gerais/MG,0,49,0,5514
1097987,2022-07-16,Campos Gerais/MG,0,49,0,5514
1103584,2022-07-17,Campos Gerais/MG,0,49,0,5514
1109181,2022-07-18,Campos Gerais/MG,0,49,54,5568
1114778,2022-07-19,Campos Gerais/MG,0,49,9,5577
1120375,2022-07-20,Campos Gerais/MG,0,49,0,5577
1125972,2022-07-21,Campos Gerais/MG,0,49,25,5602
1131569,2022-07-22,Campos Gerais/MG,0,49,0,5602
1137166,2022-07-23,Campos Gerais/MG,0,49,0,5602
1142763,2022-07-24,Campos Gerais/MG,0,49,0,5602
1148360,2022-07-25,Campos Gerais/MG,0,49,0,5602
1153957,2022-07-26,Campos Gerais/MG,0,49,15,5617
1159554,2022-07-27,Campos Gerais/MG,0,49,0,5617
1165151,2022-07-28,Campos Gerais/MG,0,49,0,5617
1170748,2022-07-29,Campos Gerais/MG,0,49,0,5617
1176345,2022-07-30,Campos Gerais/MG,0,49,0,5617
1181942,2022-07-31,Campos Gerais/MG,0,49,0,5617
1187539,2022-08-01,Campos Gerais/MG,0,49,32,5649
1193136,2022-08-02,Campos Gerais/MG,0,49,2,5651
1198733,2022-08-03,Campos Gerais/MG,0,49,0,5651
1204330,2022-08-04,Campos Gerais/MG,0,49,14,5665
1209927,2022-08-05,Campos Gerais/MG,0,49,0,5665
1215524,2022-08-06,Campos Gerais/MG,0,49,0,5665
1221121,2022-08-07,Campos Gerais/MG,0,49,0,5665
1226718,2022-08-08,Campos Gerais/MG,0,49,12,5677
1232315,2022-08-09,Campos Gerais/MG,0,49,0,5677
1237912,2022-08-10,Campos Gerais/MG,0,49,12,5689
1243509,2022-08-11,Campos Gerais/MG,0,49,0,5689
1249106,2022-08-12,Campos Gerais/MG,0,49,0,5689
1254703,2022-08-13,Campos Gerais/MG,0,49,0,5689
1260300,2022-08-14,Campos Gerais/MG,0,49,0,5689
1265897,2022-08-15,Campos Gerais/MG,0,49,0,5689
1271494,2022-08-16,Campos Gerais/MG,0,49,6,5695
1277091,2022-08-17,Campos Gerais/MG,0,49,10,5705
1282688,2022-08-18,Campos Gerais/MG,0,49,0,5705
1288285,2022-08-19,Campos Gerais/MG,0,49,0,5705
1293882,2022-08-20,Campos Gerais/MG,0,49,0,5705
1299479,2022-08-21,Campos Gerais/MG,0,49,0,5705
1305076,2022-08-22,Campos Gerais/MG,0,49,7,5712
1310673,2022-08-23,Campos Gerais/MG,0,49,8,5720
1316270,2022-08-24,Campos Gerais/MG,0,49,0,5720
1321867,2022-08-25,Campos Gerais/MG,0,49,0,5720
1106,2022-01-01,Carmo da Cachoeira/MG,0,18,0,730
6703,2022-01-02,Carmo da Cachoeira/MG,0,18,0,730
12300,2022-01-03,Carmo da Cachoeira/MG,0,18,0,730
17897,2022-01-04,Carmo da Cachoeira/MG,0,18,6,736
23494,2022-01-05,Carmo da Cachoeira/MG,0,18,13,749
29091,2022-01-06,Carmo da Cachoeira/MG,0,18,5,754
34688,2022-01-07,Carmo da Cachoeira/MG,0,18,8,762
40285,2022-01-08,Carmo da Cachoeira/MG,0,18,24,786
45882,2022-01-09,Carmo da Cachoeira/MG,0,18,8,794
51479,2022-01-10,Carmo da Cachoeira/MG,0,18,0,794
57076,2022-01-11,Carmo da Cachoeira/MG,0,18,0,794
62673,2022-01-12,Carmo da Cachoeira/MG,0,18,17,811
68270,2022-01-13,Carmo da Cachoeira/MG,0,18,30,841
73867,2022-01-14,Carmo da Cachoeira/MG,0,18,17,858
79464,2022-01-15,Carmo da Cachoeira/MG,0,18,30,888
85061,2022-01-16,Carmo da Cachoeira/MG,0,18,0,888
90658,2022-01-17,Carmo da Cachoeira/MG,0,18,20,908
96255,2022-01-18,Carmo da Cachoeira/MG,0,18,0,908
101852,2022-01-19,Carmo da Cachoeira/MG,0,18,0,908
107449,2022-01-20,Carmo da Cachoeira/MG,0,18,112,1020
113046,2022-01-21,Carmo da Cachoeira/MG,0,18,29,1049
118643,2022-01-22,Carmo da Cachoeira/MG,1,19,50,1099
124240,2022-01-23,Carmo da Cachoeira/MG,0,19,0,1099
129837,2022-01-24,Carmo da Cachoeira/MG,0,19,32,1131
135434,2022-01-25,Carmo da Cachoeira/MG,0,19,0,1131
141031,2022-01-26,Carmo da Cachoeira/MG,0,19,0,1131
146628,2022-01-27,Carmo da Cachoeira/MG,0,19,45,1176
152225,2022-01-28,Carmo da Cachoeira/MG,0,19,28,1204
157822,2022-01-29,Carmo da Cachoeira/MG,0,19,0,1204
163419,2022-01-30,Carmo da Cachoeira/MG,0,19,0,1204
169016,2022-01-31,Carmo da Cachoeira/MG,0,19,23,1227
174613,2022-02-01,Carmo da Cachoeira/MG,0,19,0,1227
180210,2022-02-02,Carmo da Cachoeira/MG,1,20,39,1266
185807,2022-02-03,Carmo da Cachoeira/MG,2,22,12,1278
191404,2022-02-04,Carmo da Cachoeira/MG,0,22,23,1301
197001,2022-02-05,Carmo da Cachoeira/MG,0,22,0,1301
202598,2022-02-06,Carmo da Cachoeira/MG,0,22,42,1343
208195,2022-02-07,Carmo da Cachoeira/MG,0,22,0,1343
213792,2022-02-08,Carmo da Cachoeira/MG,0,22,0,1343
219389,2022-02-09,Carmo da Cachoeira/MG,0,22,6,1349
224986,2022-02-10,Carmo da Cachoeira/MG,0,22,0,1349
230583,2022-02-11,Carmo da Cachoeira/MG,0,22,23,1372
236180,2022-02-12,Carmo da Cachoeira/MG,0,22,10,1382
241777,2022-02-13,Carmo da Cachoeira/MG,0,22,0,1382
247374,2022-02-14,Carmo da Cachoeira/MG,0,22,2,1384
252971,2022-02-15,Carmo da Cachoeira/MG,0,22,0,1384
258568,2022-02-16,Carmo da Cachoeira/MG,0,22,25,1409
264165,2022-02-17,Carmo da Cachoeira/MG,0,22,7,1416
269762,2022-02-18,Carmo da Cachoeira/MG,0,22,11,1427
275359,2022-02-19,Carmo da Cachoeira/MG,0,22,3,1430
280956,2022-02-20,Carmo da Cachoeira/MG,0,22,10,1440
286553,2022-02-21,Carmo da Cachoeira/MG,0,22,0,1440
292150,2022-02-22,Carmo da Cachoeira/MG,0,22,0,1440
297747,2022-02-23,Carmo da Cachoeira/MG,0,22,4,1444
303344,2022-02-24,Carmo da Cachoeira/MG,0,22,9,1453
308941,2022-02-25,Carmo da Cachoeira/MG,0,22,0,1453
314538,2022-02-26,Carmo da Cachoeira/MG,0,22,1,1454
320135,2022-02-27,Carmo da Cachoeira/MG,0,22,4,1458
325732,2022-02-28,Carmo da Cachoeira/MG,0,22,0,1458
331329,2022-03-01,Carmo da Cachoeira/MG,0,22,0,1458
336926,2022-03-02,Carmo da Cachoeira/MG,0,22,0,1458
342523,2022-03-03,Carmo da Cachoeira/MG,0,22,0,1458
348120,2022-03-04,Carmo da Cachoeira/MG,0,22,0,1458
353717,2022-03-05,Carmo da Cachoeira/MG,0,22,0,1458
359314,2022-03-06,Carmo da Cachoeira/MG,0,22,0,1458
364911,2022-03-07,Carmo da Cachoeira/MG,0,22,0,1458
370508,2022-03-08,Carmo da Cachoeira/MG,0,22,0,1458
376105,2022-03-09,Carmo da Cachoeira/MG,0,22,2,1460
381702,2022-03-10,Carmo da Cachoeira/MG,0,22,5,1465
387299,2022-03-11,Carmo da Cachoeira/MG,0,22,4,1469
392896,2022-03-12,Carmo da Cachoeira/MG,0,22,0,1469
398493,2022-03-13,Carmo da Cachoeira/MG,0,22,0,1469
404090,2022-03-14,Carmo da Cachoeira/MG,0,22,0,1469
409687,2022-03-15,Carmo da Cachoeira/MG,0,22,0,1469
415284,2022-03-16,Carmo da Cachoeira/MG,0,22,1,1470
420881,2022-03-17,Carmo da Cachoeira/MG,0,22,0,1470
426478,2022-03-18,Carmo da Cachoeira/MG,1,23,5,1475
432075,2022-03-19,Carmo da Cachoeira/MG,0,23,2,1477
437672,2022-03-20,Carmo da Cachoeira/MG,0,23,0,1477
443269,2022-03-21,Carmo da Cachoeira/MG,0,23,0,1477
448866,2022-03-22,Carmo da Cachoeira/MG,0,23,0,1477
454463,2022-03-23,Carmo da Cachoeira/MG,0,23,3,1480
460060,2022-03-24,Carmo da Cachoeira/MG,0,23,0,1480
465657,2022-03-25,Carmo da Cachoeira/MG,0,23,0,1480
471254,2022-03-26,Carmo da Cachoeira/MG,0,23,0,1480
476851,2022-03-27,Carmo da Cachoeira/MG,0,23,1,1481
482448,2022-03-28,Carmo da Cachoeira/MG,0,23,0,1481
488045,2022-03-29,Carmo da Cachoeira/MG,0,23,0,1481
493642,2022-03-30,Carmo da Cachoeira/MG,0,23,1,1482
499239,2022-03-31,Carmo da Cachoeira/MG,0,23,1,1483
504836,2022-04-01,Carmo da Cachoeira/MG,0,23,0,1483
510433,2022-04-02,Carmo da Cachoeira/MG,0,23,0,1483
516030,2022-04-03,Carmo da Cachoeira/MG,0,23,0,1483
521627,2022-04-04,Carmo da Cachoeira/MG,0,23,1,1484
527224,2022-04-05,Carmo da Cachoeira/MG,1,24,0,1484
532821,2022-04-06,Carmo da Cachoeira/MG,0,24,2,1486
538418,2022-04-07,Carmo da Cachoeira/MG,0,24,0,1486
544015,2022-04-08,Carmo da Cachoeira/MG,0,24,0,1486
549612,2022-04-09,Carmo da Cachoeira/MG,0,24,0,1486
555209,2022-04-10,Carmo da Cachoeira/MG,0,24,0,1486
560806,2022-04-11,Carmo da Cachoeira/MG,0,24,0,1486
566403,2022-04-12,Carmo da Cachoeira/MG,0,24,0,1486
572000,2022-04-13,Carmo da Cachoeira/MG,0,24,0,1486
577597,2022-04-14,Carmo da Cachoeira/MG,0,24,0,1486
583194,2022-04-15,Carmo da Cachoeira/MG,0,24,0,1486
588791,2022-04-16,Carmo da Cachoeira/MG,0,24,0,1486
594388,2022-04-17,Carmo da Cachoeira/MG,0,24,0,1486
599985,2022-04-18,Carmo da Cachoeira/MG,0,24,0,1486
605582,2022-04-19,Carmo da Cachoeira/MG,0,24,0,1486
611179,2022-04-20,Carmo da Cachoeira/MG,0,24,0,1486
616776,2022-04-21,Carmo da Cachoeira/MG,0,24,0,1486
622373,2022-04-22,Carmo da Cachoeira/MG,0,24,0,1486
627970,2022-04-23,Carmo da Cachoeira/MG,0,24,0,1486
633567,2022-04-24,Carmo da Cachoeira/MG,0,24,0,1486
639164,2022-04-25,Carmo da Cachoeira/MG,0,24,0,1486
644761,2022-04-26,Carmo da Cachoeira/MG,0,24,0,1486
650358,2022-04-27,Carmo da Cachoeira/MG,0,24,0,1486
655955,2022-04-28,Carmo da Cachoeira/MG,0,24,0,1486
661552,2022-04-29,Carmo da Cachoeira/MG,0,24,0,1486
667149,2022-04-30,Carmo da Cachoeira/MG,0,24,0,1486
672746,2022-05-01,Carmo da Cachoeira/MG,0,24,0,1486
678343,2022-05-02,Carmo da Cachoeira/MG,0,24,0,1486
683940,2022-05-03,Carmo da Cachoeira/MG,0,24,0,1486
689537,2022-05-04,Carmo da Cachoeira/MG,0,24,0,1486
695134,2022-05-05,Carmo da Cachoeira/MG,0,24,0,1486
700731,2022-05-06,Carmo da Cachoeira/MG,0,24,0,1486
706328,2022-05-07,Carmo da Cachoeira/MG,0,24,0,1486
711925,2022-05-08,Carmo da Cachoeira/MG,0,24,0,1486
717522,2022-05-09,Carmo da Cachoeira/MG,0,24,0,1486
723119,2022-05-10,Carmo da Cachoeira/MG,0,24,0,1486
728716,2022-05-11,Carmo da Cachoeira/MG,0,24,0,1486
734313,2022-05-12,Carmo da Cachoeira/MG,0,24,0,1486
739910,2022-05-13,Carmo da Cachoeira/MG,0,24,0,1486
745507,2022-05-14,Carmo da Cachoeira/MG,0,24,0,1486
751104,2022-05-15,Carmo da Cachoeira/MG,0,24,0,1486
756701,2022-05-16,Carmo da Cachoeira/MG,0,24,0,1486
762298,2022-05-17,Carmo da Cachoeira/MG,0,24,0,1486
767895,2022-05-18,Carmo da Cachoeira/MG,0,24,1,1487
773492,2022-05-19,Carmo da Cachoeira/MG,0,24,0,1487
779089,2022-05-20,Carmo da Cachoeira/MG,0,24,0,1487
784686,2022-05-21,Carmo da Cachoeira/MG,0,24,0,1487
790283,2022-05-22,Carmo da Cachoeira/MG,0,24,0,1487
795880,2022-05-23,Carmo da Cachoeira/MG,0,24,0,1487
801477,2022-05-24,Carmo da Cachoeira/MG,0,24,0,1487
807074,2022-05-25,Carmo da Cachoeira/MG,0,24,0,1487
812671,2022-05-26,Carmo da Cachoeira/MG,0,24,12,1499
818268,2022-05-27,Carmo da Cachoeira/MG,0,24,7,1506
823865,2022-05-28,Carmo da Cachoeira/MG,0,24,0,1506
829462,2022-05-29,Carmo da Cachoeira/MG,0,24,0,1506
835059,2022-05-30,Carmo da Cachoeira/MG,0,24,5,1511
840656,2022-05-31,Carmo da Cachoeira/MG,0,24,7,1518
846253,2022-06-01,Carmo da Cachoeira/MG,0,24,9,1527
851850,2022-06-02,Carmo da Cachoeira/MG,0,24,0,1527
857447,2022-06-03,Carmo da Cachoeira/MG,0,24,0,1527
863044,2022-06-04,Carmo da Cachoeira/MG,0,24,0,1527
868641,2022-06-05,Carmo da Cachoeira/MG,0,24,0,1527
874238,2022-06-06,Carmo da Cachoeira/MG,0,24,0,1527
879835,2022-06-07,Carmo da Cachoeira/MG,0,24,40,1567
885432,2022-06-08,Carmo da Cachoeira/MG,0,24,0,1567
891029,2022-06-09,Carmo da Cachoeira/MG,0,24,17,1584
896626,2022-06-10,Carmo da Cachoeira/MG,0,24,30,1614
902223,2022-06-11,Carmo da Cachoeira/MG,0,24,0,1614
907820,2022-06-12,Carmo da Cachoeira/MG,0,24,0,1614
913417,2022-06-13,Carmo da Cachoeira/MG,0,24,0,1614
919014,2022-06-14,Carmo da Cachoeira/MG,0,24,9,1623
924611,2022-06-15,Carmo da Cachoeira/MG,0,24,5,1628
930208,2022-06-16,Carmo da Cachoeira/MG,0,24,0,1628
935805,2022-06-17,Carmo da Cachoeira/MG,0,24,0,1628
941402,2022-06-18,Carmo da Cachoeira/MG,0,24,0,1628
946999,2022-06-19,Carmo da Cachoeira/MG,0,24,0,1628
952596,2022-06-20,Carmo da Cachoeira/MG,0,24,31,1659
958193,2022-06-21,Carmo da Cachoeira/MG,0,24,0,1659
963790,2022-06-22,Carmo da Cachoeira/MG,0,24,0,1659
969387,2022-06-23,Carmo da Cachoeira/MG,0,24,61,1720
974984,2022-06-24,Carmo da Cachoeira/MG,1,25,0,1720
980581,2022-06-25,Carmo da Cachoeira/MG,0,25,0,1720
986178,2022-06-26,Carmo da Cachoeira/MG,0,25,0,1720
991775,2022-06-27,Carmo da Cachoeira/MG,0,25,60,1780
997372,2022-06-28,Carmo da Cachoeira/MG,0,25,0,1780
1002969,2022-06-29,Carmo da Cachoeira/MG,0,25,21,1801
1008566,2022-06-30,Carmo da Cachoeira/MG,0,25,20,1821
1014163,2022-07-01,Carmo da Cachoeira/MG,0,25,21,1842
1019760,2022-07-02,Carmo da Cachoeira/MG,0,25,0,1842
1025357,2022-07-03,Carmo da Cachoeira/MG,0,25,0,1842
1030954,2022-07-04,Carmo da Cachoeira/MG,0,25,15,1857
1036551,2022-07-05,Carmo da Cachoeira/MG,0,25,0,1857
1042148,2022-07-06,Carmo da Cachoeira/MG,0,25,25,1882
1047745,2022-07-07,Carmo da Cachoeira/MG,0,25,5,1887
1053342,2022-07-08,Carmo da Cachoeira/MG,0,25,0,1887
1058939,2022-07-09,Carmo da Cachoeira/MG,0,25,0,1887
1064536,2022-07-10,Carmo da Cachoeira/MG,0,25,0,1887
1070133,2022-07-11,Carmo da Cachoeira/MG,0,25,28,1915
1075730,2022-07-12,Carmo da Cachoeira/MG,0,25,0,1915
1081327,2022-07-13,Carmo da Cachoeira/MG,0,25,17,1932
1086924,2022-07-14,Carmo da Cachoeira/MG,0,25,0,1932
1092521,2022-07-15,Carmo da Cachoeira/MG,0,25,7,1939
1098118,2022-07-16,Carmo da Cachoeira/MG,0,25,0,1939
1103715,2022-07-17,Carmo da Cachoeira/MG,0,25,0,1939
1109312,2022-07-18,Carmo da Cachoeira/MG,0,25,6,1945
1114909,2022-07-19,Carmo da Cachoeira/MG,0,25,0,1945
1120506,2022-07-20,Carmo da Cachoeira/MG,0,25,0,1945
1126103,2022-07-21,Carmo da Cachoeira/MG,0,25,0,1945
1131700,2022-07-22,Carmo da Cachoeira/MG,0,25,4,1949
1137297,2022-07-23,Carmo da Cachoeira/MG,0,25,0,1949
1142894,2022-07-24,Carmo da Cachoeira/MG,0,25,0,1949
1148491,2022-07-25,Carmo da Cachoeira/MG,0,25,8,1957
1154088,2022-07-26,Carmo da Cachoeira/MG,0,25,2,1959
1159685,2022-07-27,Carmo da Cachoeira/MG,0,25,0,1959
1165282,2022-07-28,Carmo da Cachoeira/MG,0,25,2,1961
1170879,2022-07-29,Carmo da Cachoeira/MG,0,25,0,1961
1176476,2022-07-30,Carmo da Cachoeira/MG,0,25,0,1961
1182073,2022-07-31,Carmo da Cachoeira/MG,0,25,0,1961
1187670,2022-08-01,Carmo da Cachoeira/MG,0,25,0,1961
1193267,2022-08-02,Carmo da Cachoeira/MG,0,25,0,1961
1198864,2022-08-03,Carmo da Cachoeira/MG,0,25,1,1962
1204461,2022-08-04,Carmo da Cachoeira/MG,0,25,1,1963
1210058,2022-08-05,Carmo da Cachoeira/MG,0,25,3,1966
1215655,2022-08-06,Carmo da Cachoeira/MG,0,25,0,1966
1221252,2022-08-07,Carmo da Cachoeira/MG,0,25,0,1966
1226849,2022-08-08,Carmo da Cachoeira/MG,0,25,1,1967
1232446,2022-08-09,Carmo da Cachoeira/MG,0,25,0,1967
1238043,2022-08-10,Carmo da Cachoeira/MG,0,25,0,1967
1243640,2022-08-11,Carmo da Cachoeira/MG,0,25,0,1967
1249237,2022-08-12,Carmo da Cachoeira/MG,0,25,0,1967
1254834,2022-08-13,Carmo da Cachoeira/MG,0,25,0,1967
1260431,2022-08-14,Carmo da Cachoeira/MG,0,25,0,1967
1266028,2022-08-15,Carmo da Cachoeira/MG,0,25,0,1967
1271625,2022-08-16,Carmo da Cachoeira/MG,0,25,2,1969
1277222,2022-08-17,Carmo da Cachoeira/MG,0,25,1,1970
1282819,2022-08-18,Carmo da Cachoeira/MG,0,25,0,1970
1288416,2022-08-19,Carmo da Cachoeira/MG,0,25,0,1970
1294013,2022-08-20,Carmo da Cachoeira/MG,0,25,0,1970
1299610,2022-08-21,Carmo da Cachoeira/MG,0,25,0,1970
1305207,2022-08-22,Carmo da Cachoeira/MG,0,25,0,1970
1310804,2022-08-23,Carmo da Cachoeira/MG,0,25,0,1970
1316401,2022-08-24,Carmo da Cachoeira/MG,0,25,0,1970
1321998,2022-08-25,Carmo da Cachoeira/MG,0,25,0,1970
1111,2022-01-01,Carmo do Rio Claro/MG,0,64,1,1648
6708,2022-01-02,Carmo do Rio Claro/MG,0,64,0,1648
12305,2022-01-03,Carmo do Rio Claro/MG,0,64,4,1652
17902,2022-01-04,Carmo do Rio Claro/MG,0,64,0,1652
23499,2022-01-05,Carmo do Rio Claro/MG,0,64,2,1654
29096,2022-01-06,Carmo do Rio Claro/MG,0,64,15,1669
34693,2022-01-07,Carmo do Rio Claro/MG,0,64,35,1704
40290,2022-01-08,Carmo do Rio Claro/MG,0,64,0,1704
45887,2022-01-09,Carmo do Rio Claro/MG,0,64,149,1853
51484,2022-01-10,Carmo do Rio Claro/MG,0,64,20,1873
57081,2022-01-11,Carmo do Rio Claro/MG,0,64,-169,1704
62678,2022-01-12,Carmo do Rio Claro/MG,0,64,0,1704
68275,2022-01-13,Carmo do Rio Claro/MG,0,64,0,1704
73872,2022-01-14,Carmo do Rio Claro/MG,0,64,348,2052
79469,2022-01-15,Carmo do Rio Claro/MG,1,65,0,2052
85066,2022-01-16,Carmo do Rio Claro/MG,0,65,0,2052
90663,2022-01-17,Carmo do Rio Claro/MG,0,65,0,2052
96260,2022-01-18,Carmo do Rio Claro/MG,0,65,0,2052
101857,2022-01-19,Carmo do Rio Claro/MG,0,65,332,2384
107454,2022-01-20,Carmo do Rio Claro/MG,0,65,112,2496
113051,2022-01-21,Carmo do Rio Claro/MG,0,65,71,2567
118648,2022-01-22,Carmo do Rio Claro/MG,1,66,85,2652
124245,2022-01-23,Carmo do Rio Claro/MG,0,66,0,2652
129842,2022-01-24,Carmo do Rio Claro/MG,0,66,147,2799
135439,2022-01-25,Carmo do Rio Claro/MG,1,67,16,2815
141036,2022-01-26,Carmo do Rio Claro/MG,1,68,0,2815
146633,2022-01-27,Carmo do Rio Claro/MG,0,68,183,2998
152230,2022-01-28,Carmo do Rio Claro/MG,0,68,41,3039
157827,2022-01-29,Carmo do Rio Claro/MG,0,68,21,3060
163424,2022-01-30,Carmo do Rio Claro/MG,0,68,32,3092
169021,2022-01-31,Carmo do Rio Claro/MG,0,68,11,3103
174618,2022-02-01,Carmo do Rio Claro/MG,0,68,1,3104
180215,2022-02-02,Carmo do Rio Claro/MG,1,69,0,3104
185812,2022-02-03,Carmo do Rio Claro/MG,2,71,58,3162
191409,2022-02-04,Carmo do Rio Claro/MG,0,71,65,3227
197006,2022-02-05,Carmo do Rio Claro/MG,0,71,32,3259
202603,2022-02-06,Carmo do Rio Claro/MG,0,71,45,3304
208200,2022-02-07,Carmo do Rio Claro/MG,0,71,14,3318
213797,2022-02-08,Carmo do Rio Claro/MG,1,72,9,3327
219394,2022-02-09,Carmo do Rio Claro/MG,0,72,0,3327
224991,2022-02-10,Carmo do Rio Claro/MG,0,72,83,3410
230588,2022-02-11,Carmo do Rio Claro/MG,2,74,30,3440
236185,2022-02-12,Carmo do Rio Claro/MG,0,74,30,3470
241782,2022-02-13,Carmo do Rio Claro/MG,0,74,0,3470
247379,2022-02-14,Carmo do Rio Claro/MG,0,74,52,3522
252976,2022-02-15,Carmo do Rio Claro/MG,0,74,0,3522
258573,2022-02-16,Carmo do Rio Claro/MG,0,74,2,3524
264170,2022-02-17,Carmo do Rio Claro/MG,0,74,54,3578
269767,2022-02-18,Carmo do Rio Claro/MG,0,74,59,3637
275364,2022-02-19,Carmo do Rio Claro/MG,0,74,0,3637
280961,2022-02-20,Carmo do Rio Claro/MG,0,74,65,3702
286558,2022-02-21,Carmo do Rio Claro/MG,0,74,3,3705
292155,2022-02-22,Carmo do Rio Claro/MG,1,75,3,3708
297752,2022-02-23,Carmo do Rio Claro/MG,0,75,42,3750
303349,2022-02-24,Carmo do Rio Claro/MG,0,75,20,3770
308946,2022-02-25,Carmo do Rio Claro/MG,0,75,0,3770
314543,2022-02-26,Carmo do Rio Claro/MG,0,75,68,3838
320140,2022-02-27,Carmo do Rio Claro/MG,0,75,0,3838
325737,2022-02-28,Carmo do Rio Claro/MG,0,75,43,3881
331334,2022-03-01,Carmo do Rio Claro/MG,0,75,3,3884
336931,2022-03-02,Carmo do Rio Claro/MG,0,75,0,3884
342528,2022-03-03,Carmo do Rio Claro/MG,0,75,40,3924
348125,2022-03-04,Carmo do Rio Claro/MG,0,75,31,3955
353722,2022-03-05,Carmo do Rio Claro/MG,0,75,42,3997
359319,2022-03-06,Carmo do Rio Claro/MG,0,75,0,3997
364916,2022-03-07,Carmo do Rio Claro/MG,0,75,46,4043
370513,2022-03-08,Carmo do Rio Claro/MG,0,75,0,4043
376110,2022-03-09,Carmo do Rio Claro/MG,0,75,27,4070
381707,2022-03-10,Carmo do Rio Claro/MG,0,75,16,4086
387304,2022-03-11,Carmo do Rio Claro/MG,0,75,5,4091
392901,2022-03-12,Carmo do Rio Claro/MG,0,75,8,4099
398498,2022-03-13,Carmo do Rio Claro/MG,0,75,17,4116
404095,2022-03-14,Carmo do Rio Claro/MG,0,75,0,4116
409692,2022-03-15,Carmo do Rio Claro/MG,0,75,0,4116
415289,2022-03-16,Carmo do Rio Claro/MG,1,76,10,4126
420886,2022-03-17,Carmo do Rio Claro/MG,0,76,3,4129
426483,2022-03-18,Carmo do Rio Claro/MG,0,76,0,4129
432080,2022-03-19,Carmo do Rio Claro/MG,0,76,9,4138
437677,2022-03-20,Carmo do Rio Claro/MG,1,77,2,4140
443274,2022-03-21,Carmo do Rio Claro/MG,0,77,0,4140
448871,2022-03-22,Carmo do Rio Claro/MG,0,77,3,4143
454468,2022-03-23,Carmo do Rio Claro/MG,0,77,0,4143
460065,2022-03-24,Carmo do Rio Claro/MG,0,77,10,4153
465662,2022-03-25,Carmo do Rio Claro/MG,0,77,7,4160
471259,2022-03-26,Carmo do Rio Claro/MG,0,77,1,4161
476856,2022-03-27,Carmo do Rio Claro/MG,0,77,0,4161
482453,2022-03-28,Carmo do Rio Claro/MG,0,77,1,4162
488050,2022-03-29,Carmo do Rio Claro/MG,0,77,0,4162
493647,2022-03-30,Carmo do Rio Claro/MG,0,77,0,4162
499244,2022-03-31,Carmo do Rio Claro/MG,0,77,0,4162
504841,2022-04-01,Carmo do Rio Claro/MG,0,77,3,4165
510438,2022-04-02,Carmo do Rio Claro/MG,0,77,0,4165
516035,2022-04-03,Carmo do Rio Claro/MG,0,77,0,4165
521632,2022-04-04,Carmo do Rio Claro/MG,0,77,1,4166
527229,2022-04-05,Carmo do Rio Claro/MG,0,77,0,4166
532826,2022-04-06,Carmo do Rio Claro/MG,0,77,1,4167
538423,2022-04-07,Carmo do Rio Claro/MG,0,77,0,4167
544020,2022-04-08,Carmo do Rio Claro/MG,0,77,0,4167
549617,2022-04-09,Carmo do Rio Claro/MG,0,77,1,4168
555214,2022-04-10,Carmo do Rio Claro/MG,0,77,0,4168
560811,2022-04-11,Carmo do Rio Claro/MG,0,77,0,4168
566408,2022-04-12,Carmo do Rio Claro/MG,0,77,0,4168
572005,2022-04-13,Carmo do Rio Claro/MG,0,77,0,4168
577602,2022-04-14,Carmo do Rio Claro/MG,0,77,0,4168
583199,2022-04-15,Carmo do Rio Claro/MG,0,77,0,4168
588796,2022-04-16,Carmo do Rio Claro/MG,0,77,2,4170
594393,2022-04-17,Carmo do Rio Claro/MG,0,77,0,4170
599990,2022-04-18,Carmo do Rio Claro/MG,0,77,0,4170
605587,2022-04-19,Carmo do Rio Claro/MG,0,77,0,4170
611184,2022-04-20,Carmo do Rio Claro/MG,0,77,0,4170
616781,2022-04-21,Carmo do Rio Claro/MG,0,77,0,4170
622378,2022-04-22,Carmo do Rio Claro/MG,0,77,1,4171
627975,2022-04-23,Carmo do Rio Claro/MG,0,77,0,4171
633572,2022-04-24,Carmo do Rio Claro/MG,0,77,0,4171
639169,2022-04-25,Carmo do Rio Claro/MG,0,77,0,4171
644766,2022-04-26,Carmo do Rio Claro/MG,0,77,0,4171
650363,2022-04-27,Carmo do Rio Claro/MG,0,77,1,4172
655960,2022-04-28,Carmo do Rio Claro/MG,0,77,0,4172
661557,2022-04-29,Carmo do Rio Claro/MG,0,77,3,4175
667154,2022-04-30,Carmo do Rio Claro/MG,0,77,5,4180
672751,2022-05-01,Carmo do Rio Claro/MG,0,77,0,4180
678348,2022-05-02,Carmo do Rio Claro/MG,0,77,3,4183
683945,2022-05-03,Carmo do Rio Claro/MG,0,77,0,4183
689542,2022-05-04,Carmo do Rio Claro/MG,0,77,0,4183
695139,2022-05-05,Carmo do Rio Claro/MG,0,77,0,4183
700736,2022-05-06,Carmo do Rio Claro/MG,-1,76,19,4202
706333,2022-05-07,Carmo do Rio Claro/MG,0,76,0,4202
711930,2022-05-08,Carmo do Rio Claro/MG,0,76,0,4202
717527,2022-05-09,Carmo do Rio Claro/MG,0,76,18,4220
723124,2022-05-10,Carmo do Rio Claro/MG,0,76,0,4220
728721,2022-05-11,Carmo do Rio Claro/MG,0,76,0,4220
734318,2022-05-12,Carmo do Rio Claro/MG,0,76,20,4240
739915,2022-05-13,Carmo do Rio Claro/MG,0,76,0,4240
745512,2022-05-14,Carmo do Rio Claro/MG,0,76,0,4240
751109,2022-05-15,Carmo do Rio Claro/MG,0,76,0,4240
756706,2022-05-16,Carmo do Rio Claro/MG,0,76,10,4250
762303,2022-05-17,Carmo do Rio Claro/MG,0,76,12,4262
767900,2022-05-18,Carmo do Rio Claro/MG,0,76,5,4267
773497,2022-05-19,Carmo do Rio Claro/MG,0,76,0,4267
779094,2022-05-20,Carmo do Rio Claro/MG,0,76,15,4282
784691,2022-05-21,Carmo do Rio Claro/MG,0,76,0,4282
790288,2022-05-22,Carmo do Rio Claro/MG,0,76,0,4282
795885,2022-05-23,Carmo do Rio Claro/MG,0,76,4,4286
801482,2022-05-24,Carmo do Rio Claro/MG,0,76,15,4301
807079,2022-05-25,Carmo do Rio Claro/MG,0,76,8,4309
812676,2022-05-26,Carmo do Rio Claro/MG,0,76,5,4314
818273,2022-05-27,Carmo do Rio Claro/MG,0,76,0,4314
823870,2022-05-28,Carmo do Rio Claro/MG,0,76,0,4314
829467,2022-05-29,Carmo do Rio Claro/MG,0,76,0,4314
835064,2022-05-30,Carmo do Rio Claro/MG,0,76,0,4314
840661,2022-05-31,Carmo do Rio Claro/MG,0,76,50,4364
846258,2022-06-01,Carmo do Rio Claro/MG,0,76,0,4364
851855,2022-06-02,Carmo do Rio Claro/MG,0,76,0,4364
857452,2022-06-03,Carmo do Rio Claro/MG,0,76,49,4413
863049,2022-06-04,Carmo do Rio Claro/MG,0,76,0,4413
868646,2022-06-05,Carmo do Rio Claro/MG,0,76,0,4413
874243,2022-06-06,Carmo do Rio Claro/MG,0,76,77,4490
879840,2022-06-07,Carmo do Rio Claro/MG,0,76,3,4493
885437,2022-06-08,Carmo do Rio Claro/MG,0,76,58,4551
891034,2022-06-09,Carmo do Rio Claro/MG,0,76,13,4564
896631,2022-06-10,Carmo do Rio Claro/MG,0,76,34,4598
902228,2022-06-11,Carmo do Rio Claro/MG,0,76,0,4598
907825,2022-06-12,Carmo do Rio Claro/MG,0,76,0,4598
913422,2022-06-13,Carmo do Rio Claro/MG,0,76,16,4614
919019,2022-06-14,Carmo do Rio Claro/MG,0,76,0,4614
924616,2022-06-15,Carmo do Rio Claro/MG,0,76,69,4683
930213,2022-06-16,Carmo do Rio Claro/MG,0,76,0,4683
935810,2022-06-17,Carmo do Rio Claro/MG,0,76,0,4683
941407,2022-06-18,Carmo do Rio Claro/MG,0,76,0,4683
947004,2022-06-19,Carmo do Rio Claro/MG,0,76,0,4683
952601,2022-06-20,Carmo do Rio Claro/MG,0,76,102,4785
958198,2022-06-21,Carmo do Rio Claro/MG,0,76,0,4785
963795,2022-06-22,Carmo do Rio Claro/MG,0,76,25,4810
969392,2022-06-23,Carmo do Rio Claro/MG,0,76,0,4810
974989,2022-06-24,Carmo do Rio Claro/MG,0,76,163,4973
980586,2022-06-25,Carmo do Rio Claro/MG,0,76,0,4973
986183,2022-06-26,Carmo do Rio Claro/MG,0,76,0,4973
991780,2022-06-27,Carmo do Rio Claro/MG,0,76,147,5120
997377,2022-06-28,Carmo do Rio Claro/MG,0,76,9,5129
1002974,2022-06-29,Carmo do Rio Claro/MG,0,76,28,5157
1008571,2022-06-30,Carmo do Rio Claro/MG,0,76,34,5191
1014168,2022-07-01,Carmo do Rio Claro/MG,0,76,0,5191
1019765,2022-07-02,Carmo do Rio Claro/MG,0,76,0,5191
1025362,2022-07-03,Carmo do Rio Claro/MG,0,76,0,5191
1030959,2022-07-04,Carmo do Rio Claro/MG,0,76,97,5288
1036556,2022-07-05,Carmo do Rio Claro/MG,0,76,0,5288
1042153,2022-07-06,Carmo do Rio Claro/MG,0,76,1,5289
1047750,2022-07-07,Carmo do Rio Claro/MG,0,76,42,5331
1053347,2022-07-08,Carmo do Rio Claro/MG,0,76,15,5346
1058944,2022-07-09,Carmo do Rio Claro/MG,0,76,0,5346
1064541,2022-07-10,Carmo do Rio Claro/MG,0,76,0,5346
1070138,2022-07-11,Carmo do Rio Claro/MG,0,76,51,5397
1075735,2022-07-12,Carmo do Rio Claro/MG,0,76,0,5397
1081332,2022-07-13,Carmo do Rio Claro/MG,0,76,32,5429
1086929,2022-07-14,Carmo do Rio Claro/MG,0,76,0,5429
1092526,2022-07-15,Carmo do Rio Claro/MG,0,76,29,5458
1098123,2022-07-16,Carmo do Rio Claro/MG,0,76,0,5458
1103720,2022-07-17,Carmo do Rio Claro/MG,0,76,0,5458
1109317,2022-07-18,Carmo do Rio Claro/MG,0,76,7,5465
1114914,2022-07-19,Carmo do Rio Claro/MG,0,76,14,5479
1120511,2022-07-20,Carmo do Rio Claro/MG,0,76,0,5479
1126108,2022-07-21,Carmo do Rio Claro/MG,0,76,20,5499
1131705,2022-07-22,Carmo do Rio Claro/MG,0,76,5,5504
1137302,2022-07-23,Carmo do Rio Claro/MG,0,76,0,5504
1142899,2022-07-24,Carmo do Rio Claro/MG,0,76,0,5504
1148496,2022-07-25,Carmo do Rio Claro/MG,0,76,3,5507
1154093,2022-07-26,Carmo do Rio Claro/MG,0,76,12,5519
1159690,2022-07-27,Carmo do Rio Claro/MG,0,76,4,5523
1165287,2022-07-28,Carmo do Rio Claro/MG,1,77,2,5525
1170884,2022-07-29,Carmo do Rio Claro/MG,0,77,9,5534
1176481,2022-07-30,Carmo do Rio Claro/MG,0,77,0,5534
1182078,2022-07-31,Carmo do Rio Claro/MG,0,77,0,5534
1187675,2022-08-01,Carmo do Rio Claro/MG,0,77,7,5541
1193272,2022-08-02,Carmo do Rio Claro/MG,0,77,6,5547
1198869,2022-08-03,Carmo do Rio Claro/MG,0,77,0,5547
1204466,2022-08-04,Carmo do Rio Claro/MG,0,77,6,5553
1210063,2022-08-05,Carmo do Rio Claro/MG,0,77,2,5555
1215660,2022-08-06,Carmo do Rio Claro/MG,0,77,0,5555
1221257,2022-08-07,Carmo do Rio Claro/MG,0,77,0,5555
1226854,2022-08-08,Carmo do Rio Claro/MG,0,77,9,5564
1232451,2022-08-09,Carmo do Rio Claro/MG,0,77,3,5567
1238048,2022-08-10,Carmo do Rio Claro/MG,0,77,0,5567
1243645,2022-08-11,Carmo do Rio Claro/MG,0,77,0,5567
1249242,2022-08-12,Carmo do Rio Claro/MG,0,77,1,5568
1254839,2022-08-13,Carmo do Rio Claro/MG,0,77,0,5568
1260436,2022-08-14,Carmo do Rio Claro/MG,0,77,0,5568
1266033,2022-08-15,Carmo do Rio Claro/MG,0,77,0,5568
1271630,2022-08-16,Carmo do Rio Claro/MG,0,77,6,5574
1277227,2022-08-17,Carmo do Rio Claro/MG,0,77,3,5577
1282824,2022-08-18,Carmo do Rio Claro/MG,0,77,3,5580
1288421,2022-08-19,Carmo do Rio Claro/MG,0,77,5,5585
1294018,2022-08-20,Carmo do Rio Claro/MG,0,77,0,5585
1299615,2022-08-21,Carmo do Rio Claro/MG,0,77,0,5585
1305212,2022-08-22,Carmo do Rio Claro/MG,0,77,6,5591
1310809,2022-08-23,Carmo do Rio Claro/MG,0,77,0,5591
1316406,2022-08-24,Carmo do Rio Claro/MG,0,77,2,5593
1322003,2022-08-25,Carmo do Rio Claro/MG,0,77,3,5596
1181,2022-01-01,Caxambu/MG,0,57,0,2074
6778,2022-01-02,Caxambu/MG,0,57,0,2074
12375,2022-01-03,Caxambu/MG,0,57,0,2074
17972,2022-01-04,Caxambu/MG,0,57,6,2080
23569,2022-01-05,Caxambu/MG,0,57,3,2083
29166,2022-01-06,Caxambu/MG,0,57,3,2086
34763,2022-01-07,Caxambu/MG,0,57,7,2093
40360,2022-01-08,Caxambu/MG,0,57,8,2101
45957,2022-01-09,Caxambu/MG,0,57,0,2101
51554,2022-01-10,Caxambu/MG,0,57,0,2101
57151,2022-01-11,Caxambu/MG,0,57,26,2127
62748,2022-01-12,Caxambu/MG,0,57,14,2141
68345,2022-01-13,Caxambu/MG,0,57,13,2154
73942,2022-01-14,Caxambu/MG,0,57,0,2154
79539,2022-01-15,Caxambu/MG,0,57,13,2167
85136,2022-01-16,Caxambu/MG,0,57,0,2167
90733,2022-01-17,Caxambu/MG,0,57,0,2167
96330,2022-01-18,Caxambu/MG,0,57,8,2175
101927,2022-01-19,Caxambu/MG,0,57,39,2214
107524,2022-01-20,Caxambu/MG,0,57,20,2234
113121,2022-01-21,Caxambu/MG,0,57,33,2267
118718,2022-01-22,Caxambu/MG,0,57,16,2283
124315,2022-01-23,Caxambu/MG,0,57,0,2283
129912,2022-01-24,Caxambu/MG,0,57,0,2283
135509,2022-01-25,Caxambu/MG,0,57,13,2296
141106,2022-01-26,Caxambu/MG,0,57,49,2345
146703,2022-01-27,Caxambu/MG,1,58,34,2379
152300,2022-01-28,Caxambu/MG,0,58,37,2416
157897,2022-01-29,Caxambu/MG,0,58,54,2470
163494,2022-01-30,Caxambu/MG,1,59,0,2470
169091,2022-01-31,Caxambu/MG,0,59,0,2470
174688,2022-02-01,Caxambu/MG,0,59,27,2497
180285,2022-02-02,Caxambu/MG,1,60,39,2536
185882,2022-02-03,Caxambu/MG,0,60,20,2556
191479,2022-02-04,Caxambu/MG,0,60,7,2563
197076,2022-02-05,Caxambu/MG,0,60,72,2635
202673,2022-02-06,Caxambu/MG,0,60,0,2635
208270,2022-02-07,Caxambu/MG,0,60,0,2635
213867,2022-02-08,Caxambu/MG,0,60,52,2687
219464,2022-02-09,Caxambu/MG,0,60,49,2736
225061,2022-02-10,Caxambu/MG,0,60,13,2749
230658,2022-02-11,Caxambu/MG,1,61,69,2818
236255,2022-02-12,Caxambu/MG,0,61,63,2881
241852,2022-02-13,Caxambu/MG,2,63,0,2881
247449,2022-02-14,Caxambu/MG,0,63,0,2881
253046,2022-02-15,Caxambu/MG,0,63,0,2881
258643,2022-02-16,Caxambu/MG,0,63,135,3016
264240,2022-02-17,Caxambu/MG,0,63,3,3019
269837,2022-02-18,Caxambu/MG,0,63,10,3029
275434,2022-02-19,Caxambu/MG,0,63,45,3074
281031,2022-02-20,Caxambu/MG,0,63,0,3074
286628,2022-02-21,Caxambu/MG,0,63,0,3074
292225,2022-02-22,Caxambu/MG,0,63,15,3089
297822,2022-02-23,Caxambu/MG,0,63,23,3112
303419,2022-02-24,Caxambu/MG,0,63,22,3134
309016,2022-02-25,Caxambu/MG,0,63,23,3157
314613,2022-02-26,Caxambu/MG,0,63,1,3158
320210,2022-02-27,Caxambu/MG,0,63,0,3158
325807,2022-02-28,Caxambu/MG,0,63,0,3158
331404,2022-03-01,Caxambu/MG,0,63,0,3158
337001,2022-03-02,Caxambu/MG,0,63,0,3158
342598,2022-03-03,Caxambu/MG,0,63,1,3159
348195,2022-03-04,Caxambu/MG,0,63,20,3179
353792,2022-03-05,Caxambu/MG,0,63,39,3218
359389,2022-03-06,Caxambu/MG,0,63,0,3218
364986,2022-03-07,Caxambu/MG,0,63,0,3218
370583,2022-03-08,Caxambu/MG,0,63,0,3218
376180,2022-03-09,Caxambu/MG,0,63,0,3218
381777,2022-03-10,Caxambu/MG,0,63,0,3218
387374,2022-03-11,Caxambu/MG,0,63,0,3218
392971,2022-03-12,Caxambu/MG,0,63,0,3218
398568,2022-03-13,Caxambu/MG,0,63,0,3218
404165,2022-03-14,Caxambu/MG,0,63,0,3218
409762,2022-03-15,Caxambu/MG,0,63,32,3250
415359,2022-03-16,Caxambu/MG,0,63,5,3255
420956,2022-03-17,Caxambu/MG,0,63,3,3258
426553,2022-03-18,Caxambu/MG,0,63,4,3262
432150,2022-03-19,Caxambu/MG,0,63,1,3263
437747,2022-03-20,Caxambu/MG,0,63,0,3263
443344,2022-03-21,Caxambu/MG,0,63,0,3263
448941,2022-03-22,Caxambu/MG,0,63,0,3263
454538,2022-03-23,Caxambu/MG,0,63,4,3267
460135,2022-03-24,Caxambu/MG,0,63,1,3268
465732,2022-03-25,Caxambu/MG,0,63,0,3268
471329,2022-03-26,Caxambu/MG,0,63,0,3268
476926,2022-03-27,Caxambu/MG,0,63,0,3268
482523,2022-03-28,Caxambu/MG,0,63,0,3268
488120,2022-03-29,Caxambu/MG,0,63,0,3268
493717,2022-03-30,Caxambu/MG,0,63,9,3277
499314,2022-03-31,Caxambu/MG,0,63,1,3278
504911,2022-04-01,Caxambu/MG,0,63,0,3278
510508,2022-04-02,Caxambu/MG,0,63,0,3278
516105,2022-04-03,Caxambu/MG,0,63,0,3278
521702,2022-04-04,Caxambu/MG,1,64,3,3281
527299,2022-04-05,Caxambu/MG,0,64,0,3281
532896,2022-04-06,Caxambu/MG,0,64,2,3283
538493,2022-04-07,Caxambu/MG,0,64,2,3285
544090,2022-04-08,Caxambu/MG,0,64,0,3285
549687,2022-04-09,Caxambu/MG,0,64,4,3289
555284,2022-04-10,Caxambu/MG,0,64,0,3289
560881,2022-04-11,Caxambu/MG,0,64,0,3289
566478,2022-04-12,Caxambu/MG,0,64,0,3289
572075,2022-04-13,Caxambu/MG,0,64,0,3289
577672,2022-04-14,Caxambu/MG,0,64,0,3289
583269,2022-04-15,Caxambu/MG,0,64,1,3290
588866,2022-04-16,Caxambu/MG,0,64,0,3290
594463,2022-04-17,Caxambu/MG,0,64,0,3290
600060,2022-04-18,Caxambu/MG,0,64,0,3290
605657,2022-04-19,Caxambu/MG,0,64,0,3290
611254,2022-04-20,Caxambu/MG,0,64,0,3290
616851,2022-04-21,Caxambu/MG,0,64,1,3291
622448,2022-04-22,Caxambu/MG,0,64,0,3291
628045,2022-04-23,Caxambu/MG,0,64,0,3291
633642,2022-04-24,Caxambu/MG,0,64,0,3291
639239,2022-04-25,Caxambu/MG,0,64,0,3291
644836,2022-04-26,Caxambu/MG,0,64,0,3291
650433,2022-04-27,Caxambu/MG,0,64,3,3294
656030,2022-04-28,Caxambu/MG,0,64,4,3298
661627,2022-04-29,Caxambu/MG,0,64,3,3301
667224,2022-04-30,Caxambu/MG,0,64,0,3301
672821,2022-05-01,Caxambu/MG,0,64,0,3301
678418,2022-05-02,Caxambu/MG,0,64,0,3301
684015,2022-05-03,Caxambu/MG,0,64,0,3301
689612,2022-05-04,Caxambu/MG,0,64,10,3311
695209,2022-05-05,Caxambu/MG,0,64,5,3316
700806,2022-05-06,Caxambu/MG,0,64,5,3321
706403,2022-05-07,Caxambu/MG,0,64,0,3321
712000,2022-05-08,Caxambu/MG,0,64,0,3321
717597,2022-05-09,Caxambu/MG,0,64,0,3321
723194,2022-05-10,Caxambu/MG,0,64,4,3325
728791,2022-05-11,Caxambu/MG,0,64,6,3331
734388,2022-05-12,Caxambu/MG,0,64,3,3334
739985,2022-05-13,Caxambu/MG,0,64,3,3337
745582,2022-05-14,Caxambu/MG,0,64,0,3337
751179,2022-05-15,Caxambu/MG,0,64,0,3337
756776,2022-05-16,Caxambu/MG,-1,63,2,3339
762373,2022-05-17,Caxambu/MG,0,63,4,3343
767970,2022-05-18,Caxambu/MG,0,63,0,3343
773567,2022-05-19,Caxambu/MG,0,63,14,3357
779164,2022-05-20,Caxambu/MG,0,63,10,3367
784761,2022-05-21,Caxambu/MG,0,63,0,3367
790358,2022-05-22,Caxambu/MG,0,63,0,3367
795955,2022-05-23,Caxambu/MG,0,63,10,3377
801552,2022-05-24,Caxambu/MG,0,63,0,3377
807149,2022-05-25,Caxambu/MG,0,63,27,3404
812746,2022-05-26,Caxambu/MG,0,63,0,3404
818343,2022-05-27,Caxambu/MG,0,63,10,3414
823940,2022-05-28,Caxambu/MG,0,63,0,3414
829537,2022-05-29,Caxambu/MG,0,63,0,3414
835134,2022-05-30,Caxambu/MG,0,63,6,3420
840731,2022-05-31,Caxambu/MG,0,63,0,3420
846328,2022-06-01,Caxambu/MG,0,63,10,3430
851925,2022-06-02,Caxambu/MG,0,63,8,3438
857522,2022-06-03,Caxambu/MG,0,63,0,3438
863119,2022-06-04,Caxambu/MG,0,63,0,3438
868716,2022-06-05,Caxambu/MG,0,63,0,3438
874313,2022-06-06,Caxambu/MG,0,63,17,3455
879910,2022-06-07,Caxambu/MG,0,63,0,3455
885507,2022-06-08,Caxambu/MG,0,63,46,3501
891104,2022-06-09,Caxambu/MG,0,63,5,3506
896701,2022-06-10,Caxambu/MG,0,63,12,3518
902298,2022-06-11,Caxambu/MG,0,63,0,3518
907895,2022-06-12,Caxambu/MG,0,63,0,3518
913492,2022-06-13,Caxambu/MG,0,63,3,3521
919089,2022-06-14,Caxambu/MG,0,63,0,3521
924686,2022-06-15,Caxambu/MG,0,63,31,3552
930283,2022-06-16,Caxambu/MG,0,63,0,3552
935880,2022-06-17,Caxambu/MG,0,63,0,3552
941477,2022-06-18,Caxambu/MG,0,63,0,3552
947074,2022-06-19,Caxambu/MG,0,63,0,3552
952671,2022-06-20,Caxambu/MG,0,63,23,3575
958268,2022-06-21,Caxambu/MG,0,63,0,3575
963865,2022-06-22,Caxambu/MG,0,63,19,3594
969462,2022-06-23,Caxambu/MG,0,63,6,3600
975059,2022-06-24,Caxambu/MG,0,63,16,3616
980656,2022-06-25,Caxambu/MG,0,63,0,3616
986253,2022-06-26,Caxambu/MG,0,63,0,3616
991850,2022-06-27,Caxambu/MG,0,63,13,3629
997447,2022-06-28,Caxambu/MG,0,63,20,3649
1003044,2022-06-29,Caxambu/MG,0,63,10,3659
1008641,2022-06-30,Caxambu/MG,1,64,2,3661
1014238,2022-07-01,Caxambu/MG,0,64,4,3665
1019835,2022-07-02,Caxambu/MG,0,64,0,3665
1025432,2022-07-03,Caxambu/MG,0,64,0,3665
1031029,2022-07-04,Caxambu/MG,0,64,20,3685
1036626,2022-07-05,Caxambu/MG,0,64,10,3695
1042223,2022-07-06,Caxambu/MG,0,64,0,3695
1047820,2022-07-07,Caxambu/MG,0,64,15,3710
1053417,2022-07-08,Caxambu/MG,0,64,12,3722
1059014,2022-07-09,Caxambu/MG,0,64,0,3722
1064611,2022-07-10,Caxambu/MG,0,64,0,3722
1070208,2022-07-11,Caxambu/MG,0,64,18,3740
1075805,2022-07-12,Caxambu/MG,0,64,5,3745
1081402,2022-07-13,Caxambu/MG,0,64,10,3755
1086999,2022-07-14,Caxambu/MG,0,64,5,3760
1092596,2022-07-15,Caxambu/MG,0,64,11,3771
1098193,2022-07-16,Caxambu/MG,0,64,0,3771
1103790,2022-07-17,Caxambu/MG,0,64,0,3771
1109387,2022-07-18,Caxambu/MG,0,64,14,3785
1114984,2022-07-19,Caxambu/MG,0,64,3,3788
1120581,2022-07-20,Caxambu/MG,0,64,11,3799
1126178,2022-07-21,Caxambu/MG,1,65,9,3808
1131775,2022-07-22,Caxambu/MG,0,65,7,3815
1137372,2022-07-23,Caxambu/MG,0,65,0,3815
1142969,2022-07-24,Caxambu/MG,0,65,0,3815
1148566,2022-07-25,Caxambu/MG,0,65,15,3830
1154163,2022-07-26,Caxambu/MG,0,65,5,3835
1159760,2022-07-27,Caxambu/MG,0,65,8,3843
1165357,2022-07-28,Caxambu/MG,0,65,8,3851
1170954,2022-07-29,Caxambu/MG,0,65,17,3868
1176551,2022-07-30,Caxambu/MG,0,65,0,3868
1182148,2022-07-31,Caxambu/MG,0,65,0,3868
1187745,2022-08-01,Caxambu/MG,0,65,7,3875
1193342,2022-08-02,Caxambu/MG,0,65,8,3883
1198939,2022-08-03,Caxambu/MG,0,65,0,3883
1204536,2022-08-04,Caxambu/MG,0,65,12,3895
1210133,2022-08-05,Caxambu/MG,0,65,0,3895
1215730,2022-08-06,Caxambu/MG,0,65,0,3895
1221327,2022-08-07,Caxambu/MG,0,65,0,3895
1226924,2022-08-08,Caxambu/MG,0,65,17,3912
1232521,2022-08-09,Caxambu/MG,1,66,4,3916
1238118,2022-08-10,Caxambu/MG,0,66,6,3922
1243715,2022-08-11,Caxambu/MG,0,66,0,3922
1249312,2022-08-12,Caxambu/MG,0,66,11,3933
1254909,2022-08-13,Caxambu/MG,0,66,0,3933
1260506,2022-08-14,Caxambu/MG,0,66,0,3933
1266103,2022-08-15,Caxambu/MG,0,66,0,3933
1271700,2022-08-16,Caxambu/MG,0,66,14,3947
1277297,2022-08-17,Caxambu/MG,0,66,3,3950
1282894,2022-08-18,Caxambu/MG,0,66,2,3952
1288491,2022-08-19,Caxambu/MG,0,66,0,3952
1294088,2022-08-20,Caxambu/MG,0,66,0,3952
1299685,2022-08-21,Caxambu/MG,0,66,0,3952
1305282,2022-08-22,Caxambu/MG,1,67,2,3954
1310879,2022-08-23,Caxambu/MG,0,67,1,3955
1316476,2022-08-24,Caxambu/MG,0,67,1,3956
1322073,2022-08-25,Caxambu/MG,0,67,1,3957
1305,2022-01-01,Conceição da Aparecida/MG,0,10,0,807
6902,2022-01-02,Conceição da Aparecida/MG,0,10,0,807
12499,2022-01-03,Conceição da Aparecida/MG,0,10,0,807
18096,2022-01-04,Conceição da Aparecida/MG,0,10,0,807
23693,2022-01-05,Conceição da Aparecida/MG,0,10,0,807
29290,2022-01-06,Conceição da Aparecida/MG,0,10,34,841
34887,2022-01-07,Conceição da Aparecida/MG,0,10,39,880
40484,2022-01-08,Conceição da Aparecida/MG,0,10,38,918
46081,2022-01-09,Conceição da Aparecida/MG,0,10,33,951
51678,2022-01-10,Conceição da Aparecida/MG,0,10,0,951
57275,2022-01-11,Conceição da Aparecida/MG,0,10,60,1011
62872,2022-01-12,Conceição da Aparecida/MG,0,10,2,1013
68469,2022-01-13,Conceição da Aparecida/MG,0,10,70,1083
74066,2022-01-14,Conceição da Aparecida/MG,0,10,23,1106
79663,2022-01-15,Conceição da Aparecida/MG,0,10,23,1129
85260,2022-01-16,Conceição da Aparecida/MG,0,10,0,1129
90857,2022-01-17,Conceição da Aparecida/MG,0,10,26,1155
96454,2022-01-18,Conceição da Aparecida/MG,0,10,8,1163
102051,2022-01-19,Conceição da Aparecida/MG,0,10,27,1190
107648,2022-01-20,Conceição da Aparecida/MG,0,10,17,1207
113245,2022-01-21,Conceição da Aparecida/MG,0,10,7,1214
118842,2022-01-22,Conceição da Aparecida/MG,0,10,12,1226
124439,2022-01-23,Conceição da Aparecida/MG,1,11,13,1239
130036,2022-01-24,Conceição da Aparecida/MG,0,11,6,1245
135633,2022-01-25,Conceição da Aparecida/MG,0,11,1,1246
141230,2022-01-26,Conceição da Aparecida/MG,0,11,0,1246
146827,2022-01-27,Conceição da Aparecida/MG,0,11,16,1262
152424,2022-01-28,Conceição da Aparecida/MG,0,11,7,1269
158021,2022-01-29,Conceição da Aparecida/MG,0,11,8,1277
163618,2022-01-30,Conceição da Aparecida/MG,0,11,0,1277
169215,2022-01-31,Conceição da Aparecida/MG,0,11,0,1277
174812,2022-02-01,Conceição da Aparecida/MG,0,11,14,1291
180409,2022-02-02,Conceição da Aparecida/MG,0,11,3,1294
186006,2022-02-03,Conceição da Aparecida/MG,0,11,5,1299
191603,2022-02-04,Conceição da Aparecida/MG,0,11,2,1301
197200,2022-02-05,Conceição da Aparecida/MG,0,11,0,1301
202797,2022-02-06,Conceição da Aparecida/MG,0,11,8,1309
208394,2022-02-07,Conceição da Aparecida/MG,0,11,0,1309
213991,2022-02-08,Conceição da Aparecida/MG,0,11,11,1320
219588,2022-02-09,Conceição da Aparecida/MG,0,11,8,1328
225185,2022-02-10,Conceição da Aparecida/MG,0,11,4,1332
230782,2022-02-11,Conceição da Aparecida/MG,0,11,5,1337
236379,2022-02-12,Conceição da Aparecida/MG,0,11,7,1344
241976,2022-02-13,Conceição da Aparecida/MG,0,11,3,1347
247573,2022-02-14,Conceição da Aparecida/MG,0,11,0,1347
253170,2022-02-15,Conceição da Aparecida/MG,0,11,0,1347
258767,2022-02-16,Conceição da Aparecida/MG,0,11,6,1353
264364,2022-02-17,Conceição da Aparecida/MG,0,11,0,1353
269961,2022-02-18,Conceição da Aparecida/MG,0,11,3,1356
275558,2022-02-19,Conceição da Aparecida/MG,0,11,0,1356
281155,2022-02-20,Conceição da Aparecida/MG,0,11,0,1356
286752,2022-02-21,Conceição da Aparecida/MG,0,11,0,1356
292349,2022-02-22,Conceição da Aparecida/MG,0,11,15,1371
297946,2022-02-23,Conceição da Aparecida/MG,0,11,4,1375
303543,2022-02-24,Conceição da Aparecida/MG,0,11,3,1378
309140,2022-02-25,Conceição da Aparecida/MG,0,11,6,1384
314737,2022-02-26,Conceição da Aparecida/MG,0,11,10,1394
320334,2022-02-27,Conceição da Aparecida/MG,0,11,6,1400
325931,2022-02-28,Conceição da Aparecida/MG,0,11,0,1400
331528,2022-03-01,Conceição da Aparecida/MG,0,11,2,1402
337125,2022-03-02,Conceição da Aparecida/MG,0,11,0,1402
342722,2022-03-03,Conceição da Aparecida/MG,0,11,7,1409
348319,2022-03-04,Conceição da Aparecida/MG,0,11,7,1416
353916,2022-03-05,Conceição da Aparecida/MG,0,11,3,1419
359513,2022-03-06,Conceição da Aparecida/MG,0,11,7,1426
365110,2022-03-07,Conceição da Aparecida/MG,0,11,0,1426
370707,2022-03-08,Conceição da Aparecida/MG,0,11,0,1426
376304,2022-03-09,Conceição da Aparecida/MG,0,11,11,1437
381901,2022-03-10,Conceição da Aparecida/MG,0,11,4,1441
387498,2022-03-11,Conceição da Aparecida/MG,0,11,4,1445
393095,2022-03-12,Conceição da Aparecida/MG,0,11,0,1445
398692,2022-03-13,Conceição da Aparecida/MG,0,11,0,1445
404289,2022-03-14,Conceição da Aparecida/MG,0,11,0,1445
409886,2022-03-15,Conceição da Aparecida/MG,0,11,2,1447
415483,2022-03-16,Conceição da Aparecida/MG,0,11,4,1451
421080,2022-03-17,Conceição da Aparecida/MG,0,11,6,1457
426677,2022-03-18,Conceição da Aparecida/MG,0,11,2,1459
432274,2022-03-19,Conceição da Aparecida/MG,0,11,5,1464
437871,2022-03-20,Conceição da Aparecida/MG,0,11,0,1464
443468,2022-03-21,Conceição da Aparecida/MG,0,11,0,1464
449065,2022-03-22,Conceição da Aparecida/MG,0,11,0,1464
454662,2022-03-23,Conceição da Aparecida/MG,0,11,0,1464
460259,2022-03-24,Conceição da Aparecida/MG,0,11,8,1472
465856,2022-03-25,Conceição da Aparecida/MG,0,11,2,1474
471453,2022-03-26,Conceição da Aparecida/MG,0,11,0,1474
477050,2022-03-27,Conceição da Aparecida/MG,0,11,0,1474
482647,2022-03-28,Conceição da Aparecida/MG,0,11,0,1474
488244,2022-03-29,Conceição da Aparecida/MG,0,11,1,1475
493841,2022-03-30,Conceição da Aparecida/MG,0,11,0,1475
499438,2022-03-31,Conceição da Aparecida/MG,0,11,2,1477
505035,2022-04-01,Conceição da Aparecida/MG,0,11,0,1477
510632,2022-04-02,Conceição da Aparecida/MG,0,11,0,1477
516229,2022-04-03,Conceição da Aparecida/MG,0,11,0,1477
521826,2022-04-04,Conceição da Aparecida/MG,0,11,0,1477
527423,2022-04-05,Conceição da Aparecida/MG,0,11,2,1479
533020,2022-04-06,Conceição da Aparecida/MG,0,11,0,1479
538617,2022-04-07,Conceição da Aparecida/MG,0,11,0,1479
544214,2022-04-08,Conceição da Aparecida/MG,0,11,0,1479
549811,2022-04-09,Conceição da Aparecida/MG,0,11,0,1479
555408,2022-04-10,Conceição da Aparecida/MG,0,11,0,1479
561005,2022-04-11,Conceição da Aparecida/MG,0,11,0,1479
566602,2022-04-12,Conceição da Aparecida/MG,0,11,0,1479
572199,2022-04-13,Conceição da Aparecida/MG,0,11,0,1479
577796,2022-04-14,Conceição da Aparecida/MG,0,11,0,1479
583393,2022-04-15,Conceição da Aparecida/MG,0,11,0,1479
588990,2022-04-16,Conceição da Aparecida/MG,0,11,0,1479
594587,2022-04-17,Conceição da Aparecida/MG,0,11,0,1479
600184,2022-04-18,Conceição da Aparecida/MG,0,11,0,1479
605781,2022-04-19,Conceição da Aparecida/MG,0,11,0,1479
611378,2022-04-20,Conceição da Aparecida/MG,0,11,0,1479
616975,2022-04-21,Conceição da Aparecida/MG,0,11,0,1479
622572,2022-04-22,Conceição da Aparecida/MG,0,11,0,1479
628169,2022-04-23,Conceição da Aparecida/MG,0,11,0,1479
633766,2022-04-24,Conceição da Aparecida/MG,0,11,0,1479
639363,2022-04-25,Conceição da Aparecida/MG,0,11,0,1479
644960,2022-04-26,Conceição da Aparecida/MG,0,11,0,1479
650557,2022-04-27,Conceição da Aparecida/MG,0,11,0,1479
656154,2022-04-28,Conceição da Aparecida/MG,0,11,0,1479
661751,2022-04-29,Conceição da Aparecida/MG,0,11,0,1479
667348,2022-04-30,Conceição da Aparecida/MG,0,11,0,1479
672945,2022-05-01,Conceição da Aparecida/MG,0,11,0,1479
678542,2022-05-02,Conceição da Aparecida/MG,0,11,0,1479
684139,2022-05-03,Conceição da Aparecida/MG,0,11,0,1479
689736,2022-05-04,Conceição da Aparecida/MG,0,11,0,1479
695333,2022-05-05,Conceição da Aparecida/MG,0,11,0,1479
700930,2022-05-06,Conceição da Aparecida/MG,0,11,0,1479
706527,2022-05-07,Conceição da Aparecida/MG,0,11,0,1479
712124,2022-05-08,Conceição da Aparecida/MG,0,11,0,1479
717721,2022-05-09,Conceição da Aparecida/MG,0,11,0,1479
723318,2022-05-10,Conceição da Aparecida/MG,0,11,0,1479
728915,2022-05-11,Conceição da Aparecida/MG,0,11,0,1479
734512,2022-05-12,Conceição da Aparecida/MG,0,11,1,1480
740109,2022-05-13,Conceição da Aparecida/MG,0,11,0,1480
745706,2022-05-14,Conceição da Aparecida/MG,0,11,0,1480
751303,2022-05-15,Conceição da Aparecida/MG,0,11,0,1480
756900,2022-05-16,Conceição da Aparecida/MG,0,11,0,1480
762497,2022-05-17,Conceição da Aparecida/MG,0,11,3,1483
768094,2022-05-18,Conceição da Aparecida/MG,0,11,0,1483
773691,2022-05-19,Conceição da Aparecida/MG,0,11,0,1483
779288,2022-05-20,Conceição da Aparecida/MG,0,11,0,1483
784885,2022-05-21,Conceição da Aparecida/MG,0,11,0,1483
790482,2022-05-22,Conceição da Aparecida/MG,0,11,0,1483
796079,2022-05-23,Conceição da Aparecida/MG,0,11,8,1491
801676,2022-05-24,Conceição da Aparecida/MG,0,11,4,1495
807273,2022-05-25,Conceição da Aparecida/MG,0,11,2,1497
812870,2022-05-26,Conceição da Aparecida/MG,0,11,1,1498
818467,2022-05-27,Conceição da Aparecida/MG,0,11,0,1498
824064,2022-05-28,Conceição da Aparecida/MG,0,11,0,1498
829661,2022-05-29,Conceição da Aparecida/MG,0,11,0,1498
835258,2022-05-30,Conceição da Aparecida/MG,0,11,0,1498
840855,2022-05-31,Conceição da Aparecida/MG,0,11,14,1512
846452,2022-06-01,Conceição da Aparecida/MG,0,11,6,1518
852049,2022-06-02,Conceição da Aparecida/MG,0,11,0,1518
857646,2022-06-03,Conceição da Aparecida/MG,0,11,5,1523
863243,2022-06-04,Conceição da Aparecida/MG,0,11,0,1523
868840,2022-06-05,Conceição da Aparecida/MG,0,11,0,1523
874437,2022-06-06,Conceição da Aparecida/MG,0,11,22,1545
880034,2022-06-07,Conceição da Aparecida/MG,0,11,9,1554
885631,2022-06-08,Conceição da Aparecida/MG,0,11,0,1554
891228,2022-06-09,Conceição da Aparecida/MG,0,11,7,1561
896825,2022-06-10,Conceição da Aparecida/MG,0,11,5,1566
902422,2022-06-11,Conceição da Aparecida/MG,0,11,0,1566
908019,2022-06-12,Conceição da Aparecida/MG,0,11,0,1566
913616,2022-06-13,Conceição da Aparecida/MG,0,11,3,1569
919213,2022-06-14,Conceição da Aparecida/MG,0,11,9,1578
924810,2022-06-15,Conceição da Aparecida/MG,0,11,0,1578
930407,2022-06-16,Conceição da Aparecida/MG,0,11,0,1578
936004,2022-06-17,Conceição da Aparecida/MG,0,11,0,1578
941601,2022-06-18,Conceição da Aparecida/MG,0,11,0,1578
947198,2022-06-19,Conceição da Aparecida/MG,0,11,0,1578
952795,2022-06-20,Conceição da Aparecida/MG,0,11,6,1584
958392,2022-06-21,Conceição da Aparecida/MG,0,11,10,1594
963989,2022-06-22,Conceição da Aparecida/MG,0,11,0,1594
969586,2022-06-23,Conceição da Aparecida/MG,0,11,6,1600
975183,2022-06-24,Conceição da Aparecida/MG,0,11,0,1600
980780,2022-06-25,Conceição da Aparecida/MG,0,11,0,1600
986377,2022-06-26,Conceição da Aparecida/MG,0,11,0,1600
991974,2022-06-27,Conceição da Aparecida/MG,1,12,7,1607
997571,2022-06-28,Conceição da Aparecida/MG,0,12,0,1607
1003168,2022-06-29,Conceição da Aparecida/MG,0,12,0,1607
1008765,2022-06-30,Conceição da Aparecida/MG,0,12,12,1619
1014362,2022-07-01,Conceição da Aparecida/MG,0,12,0,1619
1019959,2022-07-02,Conceição da Aparecida/MG,0,12,0,1619
1025556,2022-07-03,Conceição da Aparecida/MG,0,12,0,1619
1031153,2022-07-04,Conceição da Aparecida/MG,0,12,0,1619
1036750,2022-07-05,Conceição da Aparecida/MG,0,12,0,1619
1042347,2022-07-06,Conceição da Aparecida/MG,0,12,0,1619
1047944,2022-07-07,Conceição da Aparecida/MG,0,12,0,1619
1053541,2022-07-08,Conceição da Aparecida/MG,0,12,0,1619
1059138,2022-07-09,Conceição da Aparecida/MG,0,12,0,1619
1064735,2022-07-10,Conceição da Aparecida/MG,0,12,0,1619
1070332,2022-07-11,Conceição da Aparecida/MG,0,12,0,1619
1075929,2022-07-12,Conceição da Aparecida/MG,0,12,0,1619
1081526,2022-07-13,Conceição da Aparecida/MG,0,12,0,1619
1087123,2022-07-14,Conceição da Aparecida/MG,0,12,0,1619
1092720,2022-07-15,Conceição da Aparecida/MG,0,12,0,1619
1098317,2022-07-16,Conceição da Aparecida/MG,0,12,0,1619
1103914,2022-07-17,Conceição da Aparecida/MG,0,12,0,1619
1109511,2022-07-18,Conceição da Aparecida/MG,0,12,0,1619
1115108,2022-07-19,Conceição da Aparecida/MG,0,12,0,1619
1120705,2022-07-20,Conceição da Aparecida/MG,0,12,0,1619
1126302,2022-07-21,Conceição da Aparecida/MG,0,12,0,1619
1131899,2022-07-22,Conceição da Aparecida/MG,0,12,0,1619
1137496,2022-07-23,Conceição da Aparecida/MG,0,12,0,1619
1143093,2022-07-24,Conceição da Aparecida/MG,0,12,0,1619
1148690,2022-07-25,Conceição da Aparecida/MG,0,12,0,1619
1154287,2022-07-26,Conceição da Aparecida/MG,0,12,0,1619
1159884,2022-07-27,Conceição da Aparecida/MG,0,12,0,1619
1165481,2022-07-28,Conceição da Aparecida/MG,0,12,0,1619
1171078,2022-07-29,Conceição da Aparecida/MG,0,12,0,1619
1176675,2022-07-30,Conceição da Aparecida/MG,0,12,0,1619
1182272,2022-07-31,Conceição da Aparecida/MG,0,12,0,1619
1187869,2022-08-01,Conceição da Aparecida/MG,0,12,0,1619
1193466,2022-08-02,Conceição da Aparecida/MG,0,12,0,1619
1199063,2022-08-03,Conceição da Aparecida/MG,0,12,0,1619
1204660,2022-08-04,Conceição da Aparecida/MG,0,12,0,1619
1210257,2022-08-05,Conceição da Aparecida/MG,0,12,0,1619
1215854,2022-08-06,Conceição da Aparecida/MG,0,12,0,1619
1221451,2022-08-07,Conceição da Aparecida/MG,0,12,0,1619
1227048,2022-08-08,Conceição da Aparecida/MG,0,12,0,1619
1232645,2022-08-09,Conceição da Aparecida/MG,0,12,0,1619
1238242,2022-08-10,Conceição da Aparecida/MG,0,12,0,1619
1243839,2022-08-11,Conceição da Aparecida/MG,0,12,0,1619
1249436,2022-08-12,Conceição da Aparecida/MG,0,12,0,1619
1255033,2022-08-13,Conceição da Aparecida/MG,0,12,0,1619
1260630,2022-08-14,Conceição da Aparecida/MG,0,12,0,1619
1266227,2022-08-15,Conceição da Aparecida/MG,0,12,0,1619
1271824,2022-08-16,Conceição da Aparecida/MG,0,12,0,1619
1277421,2022-08-17,Conceição da Aparecida/MG,0,12,0,1619
1283018,2022-08-18,Conceição da Aparecida/MG,0,12,0,1619
1288615,2022-08-19,Conceição da Aparecida/MG,0,12,0,1619
1294212,2022-08-20,Conceição da Aparecida/MG,0,12,0,1619
1299809,2022-08-21,Conceição da Aparecida/MG,0,12,0,1619
1305406,2022-08-22,Conceição da Aparecida/MG,0,12,0,1619
1311003,2022-08-23,Conceição da Aparecida/MG,0,12,0,1619
1316600,2022-08-24,Conceição da Aparecida/MG,0,12,0,1619
1322197,2022-08-25,Conceição da Aparecida/MG,0,12,0,1619
1322,2022-01-01,Conceição do Rio Verde/MG,0,26,0,1282
6919,2022-01-02,Conceição do Rio Verde/MG,0,26,0,1282
12516,2022-01-03,Conceição do Rio Verde/MG,0,26,0,1282
18113,2022-01-04,Conceição do Rio Verde/MG,0,26,2,1284
23710,2022-01-05,Conceição do Rio Verde/MG,0,26,17,1301
29307,2022-01-06,Conceição do Rio Verde/MG,0,26,0,1301
34904,2022-01-07,Conceição do Rio Verde/MG,0,26,29,1330
40501,2022-01-08,Conceição do Rio Verde/MG,0,26,8,1338
46098,2022-01-09,Conceição do Rio Verde/MG,0,26,0,1338
51695,2022-01-10,Conceição do Rio Verde/MG,0,26,0,1338
57292,2022-01-11,Conceição do Rio Verde/MG,0,26,30,1368
62889,2022-01-12,Conceição do Rio Verde/MG,0,26,17,1385
68486,2022-01-13,Conceição do Rio Verde/MG,0,26,0,1385
74083,2022-01-14,Conceição do Rio Verde/MG,0,26,47,1432
79680,2022-01-15,Conceição do Rio Verde/MG,0,26,12,1444
85277,2022-01-16,Conceição do Rio Verde/MG,0,26,0,1444
90874,2022-01-17,Conceição do Rio Verde/MG,0,26,0,1444
96471,2022-01-18,Conceição do Rio Verde/MG,0,26,0,1444
102068,2022-01-19,Conceição do Rio Verde/MG,0,26,58,1502
107665,2022-01-20,Conceição do Rio Verde/MG,0,26,12,1514
113262,2022-01-21,Conceição do Rio Verde/MG,0,26,35,1549
118859,2022-01-22,Conceição do Rio Verde/MG,0,26,7,1556
124456,2022-01-23,Conceição do Rio Verde/MG,0,26,0,1556
130053,2022-01-24,Conceição do Rio Verde/MG,0,26,0,1556
135650,2022-01-25,Conceição do Rio Verde/MG,0,26,44,1600
141247,2022-01-26,Conceição do Rio Verde/MG,0,26,28,1628
146844,2022-01-27,Conceição do Rio Verde/MG,0,26,16,1644
152441,2022-01-28,Conceição do Rio Verde/MG,0,26,0,1644
158038,2022-01-29,Conceição do Rio Verde/MG,0,26,15,1659
163635,2022-01-30,Conceição do Rio Verde/MG,0,26,0,1659
169232,2022-01-31,Conceição do Rio Verde/MG,0,26,0,1659
174829,2022-02-01,Conceição do Rio Verde/MG,0,26,35,1694
180426,2022-02-02,Conceição do Rio Verde/MG,1,27,21,1715
186023,2022-02-03,Conceição do Rio Verde/MG,0,27,16,1731
191620,2022-02-04,Conceição do Rio Verde/MG,0,27,19,1750
197217,2022-02-05,Conceição do Rio Verde/MG,0,27,30,1780
202814,2022-02-06,Conceição do Rio Verde/MG,0,27,0,1780
208411,2022-02-07,Conceição do Rio Verde/MG,0,27,0,1780
214008,2022-02-08,Conceição do Rio Verde/MG,0,27,20,1800
219605,2022-02-09,Conceição do Rio Verde/MG,0,27,18,1818
225202,2022-02-10,Conceição do Rio Verde/MG,0,27,4,1822
230799,2022-02-11,Conceição do Rio Verde/MG,1,28,13,1835
236396,2022-02-12,Conceição do Rio Verde/MG,0,28,18,1853
241993,2022-02-13,Conceição do Rio Verde/MG,0,28,0,1853
247590,2022-02-14,Conceição do Rio Verde/MG,0,28,0,1853
253187,2022-02-15,Conceição do Rio Verde/MG,0,28,12,1865
258784,2022-02-16,Conceição do Rio Verde/MG,0,28,15,1880
264381,2022-02-17,Conceição do Rio Verde/MG,1,29,14,1894
269978,2022-02-18,Conceição do Rio Verde/MG,0,29,5,1899
275575,2022-02-19,Conceição do Rio Verde/MG,0,29,7,1906
281172,2022-02-20,Conceição do Rio Verde/MG,0,29,0,1906
286769,2022-02-21,Conceição do Rio Verde/MG,0,29,19,1925
292366,2022-02-22,Conceição do Rio Verde/MG,0,29,0,1925
297963,2022-02-23,Conceição do Rio Verde/MG,0,29,16,1941
303560,2022-02-24,Conceição do Rio Verde/MG,0,29,15,1956
309157,2022-02-25,Conceição do Rio Verde/MG,0,29,7,1963
314754,2022-02-26,Conceição do Rio Verde/MG,0,29,7,1970
320351,2022-02-27,Conceição do Rio Verde/MG,0,29,0,1970
325948,2022-02-28,Conceição do Rio Verde/MG,0,29,0,1970
331545,2022-03-01,Conceição do Rio Verde/MG,0,29,0,1970
337142,2022-03-02,Conceição do Rio Verde/MG,0,29,0,1970
342739,2022-03-03,Conceição do Rio Verde/MG,0,29,17,1987
348336,2022-03-04,Conceição do Rio Verde/MG,0,29,3,1990
353933,2022-03-05,Conceição do Rio Verde/MG,0,29,4,1994
359530,2022-03-06,Conceição do Rio Verde/MG,0,29,0,1994
365127,2022-03-07,Conceição do Rio Verde/MG,0,29,0,1994
370724,2022-03-08,Conceição do Rio Verde/MG,0,29,0,1994
376321,2022-03-09,Conceição do Rio Verde/MG,0,29,12,2006
381918,2022-03-10,Conceição do Rio Verde/MG,0,29,1,2007
387515,2022-03-11,Conceição do Rio Verde/MG,0,29,0,2007
393112,2022-03-12,Conceição do Rio Verde/MG,0,29,3,2010
398709,2022-03-13,Conceição do Rio Verde/MG,0,29,0,2010
404306,2022-03-14,Conceição do Rio Verde/MG,0,29,1,2011
409903,2022-03-15,Conceição do Rio Verde/MG,0,29,0,2011
415500,2022-03-16,Conceição do Rio Verde/MG,0,29,2,2013
421097,2022-03-17,Conceição do Rio Verde/MG,0,29,4,2017
426694,2022-03-18,Conceição do Rio Verde/MG,0,29,3,2020
432291,2022-03-19,Conceição do Rio Verde/MG,0,29,0,2020
437888,2022-03-20,Conceição do Rio Verde/MG,0,29,0,2020
443485,2022-03-21,Conceição do Rio Verde/MG,0,29,0,2020
449082,2022-03-22,Conceição do Rio Verde/MG,1,30,3,2023
454679,2022-03-23,Conceição do Rio Verde/MG,0,30,2,2025
460276,2022-03-24,Conceição do Rio Verde/MG,0,30,1,2026
465873,2022-03-25,Conceição do Rio Verde/MG,0,30,0,2026
471470,2022-03-26,Conceição do Rio Verde/MG,0,30,0,2026
477067,2022-03-27,Conceição do Rio Verde/MG,0,30,0,2026
482664,2022-03-28,Conceição do Rio Verde/MG,0,30,0,2026
488261,2022-03-29,Conceição do Rio Verde/MG,0,30,0,2026
493858,2022-03-30,Conceição do Rio Verde/MG,0,30,2,2028
499455,2022-03-31,Conceição do Rio Verde/MG,0,30,1,2029
505052,2022-04-01,Conceição do Rio Verde/MG,0,30,3,2032
510649,2022-04-02,Conceição do Rio Verde/MG,0,30,0,2032
516246,2022-04-03,Conceição do Rio Verde/MG,0,30,0,2032
521843,2022-04-04,Conceição do Rio Verde/MG,0,30,1,2033
527440,2022-04-05,Conceição do Rio Verde/MG,0,30,1,2034
533037,2022-04-06,Conceição do Rio Verde/MG,0,30,1,2035
538634,2022-04-07,Conceição do Rio Verde/MG,0,30,0,2035
544231,2022-04-08,Conceição do Rio Verde/MG,0,30,3,2038
549828,2022-04-09,Conceição do Rio Verde/MG,0,30,0,2038
555425,2022-04-10,Conceição do Rio Verde/MG,0,30,0,2038
561022,2022-04-11,Conceição do Rio Verde/MG,0,30,0,2038
566619,2022-04-12,Conceição do Rio Verde/MG,0,30,6,2044
572216,2022-04-13,Conceição do Rio Verde/MG,0,30,1,2045
577813,2022-04-14,Conceição do Rio Verde/MG,0,30,2,2047
583410,2022-04-15,Conceição do Rio Verde/MG,0,30,0,2047
589007,2022-04-16,Conceição do Rio Verde/MG,0,30,0,2047
594604,2022-04-17,Conceição do Rio Verde/MG,0,30,0,2047
600201,2022-04-18,Conceição do Rio Verde/MG,0,30,0,2047
605798,2022-04-19,Conceição do Rio Verde/MG,0,30,0,2047
611395,2022-04-20,Conceição do Rio Verde/MG,0,30,1,2048
616992,2022-04-21,Conceição do Rio Verde/MG,0,30,1,2049
622589,2022-04-22,Conceição do Rio Verde/MG,0,30,0,2049
628186,2022-04-23,Conceição do Rio Verde/MG,0,30,0,2049
633783,2022-04-24,Conceição do Rio Verde/MG,0,30,0,2049
639380,2022-04-25,Conceição do Rio Verde/MG,0,30,0,2049
644977,2022-04-26,Conceição do Rio Verde/MG,0,30,0,2049
650574,2022-04-27,Conceição do Rio Verde/MG,0,30,2,2051
656171,2022-04-28,Conceição do Rio Verde/MG,0,30,0,2051
661768,2022-04-29,Conceição do Rio Verde/MG,0,30,0,2051
667365,2022-04-30,Conceição do Rio Verde/MG,0,30,0,2051
672962,2022-05-01,Conceição do Rio Verde/MG,0,30,0,2051
678559,2022-05-02,Conceição do Rio Verde/MG,0,30,0,2051
684156,2022-05-03,Conceição do Rio Verde/MG,0,30,0,2051
689753,2022-05-04,Conceição do Rio Verde/MG,0,30,0,2051
695350,2022-05-05,Conceição do Rio Verde/MG,0,30,0,2051
700947,2022-05-06,Conceição do Rio Verde/MG,0,30,0,2051
706544,2022-05-07,Conceição do Rio Verde/MG,0,30,0,2051
712141,2022-05-08,Conceição do Rio Verde/MG,0,30,0,2051
717738,2022-05-09,Conceição do Rio Verde/MG,0,30,0,2051
723335,2022-05-10,Conceição do Rio Verde/MG,0,30,1,2052
728932,2022-05-11,Conceição do Rio Verde/MG,0,30,0,2052
734529,2022-05-12,Conceição do Rio Verde/MG,0,30,0,2052
740126,2022-05-13,Conceição do Rio Verde/MG,0,30,1,2053
745723,2022-05-14,Conceição do Rio Verde/MG,0,30,0,2053
751320,2022-05-15,Conceição do Rio Verde/MG,0,30,0,2053
756917,2022-05-16,Conceição do Rio Verde/MG,0,30,0,2053
762514,2022-05-17,Conceição do Rio Verde/MG,0,30,1,2054
768111,2022-05-18,Conceição do Rio Verde/MG,0,30,1,2055
773708,2022-05-19,Conceição do Rio Verde/MG,0,30,0,2055
779305,2022-05-20,Conceição do Rio Verde/MG,0,30,5,2060
784902,2022-05-21,Conceição do Rio Verde/MG,0,30,0,2060
790499,2022-05-22,Conceição do Rio Verde/MG,0,30,0,2060
796096,2022-05-23,Conceição do Rio Verde/MG,0,30,3,2063
801693,2022-05-24,Conceição do Rio Verde/MG,0,30,4,2067
807290,2022-05-25,Conceição do Rio Verde/MG,0,30,1,2068
812887,2022-05-26,Conceição do Rio Verde/MG,0,30,2,2070
818484,2022-05-27,Conceição do Rio Verde/MG,0,30,3,2073
824081,2022-05-28,Conceição do Rio Verde/MG,0,30,0,2073
829678,2022-05-29,Conceição do Rio Verde/MG,0,30,0,2073
835275,2022-05-30,Conceição do Rio Verde/MG,0,30,2,2075
840872,2022-05-31,Conceição do Rio Verde/MG,0,30,6,2081
846469,2022-06-01,Conceição do Rio Verde/MG,0,30,3,2084
852066,2022-06-02,Conceição do Rio Verde/MG,0,30,9,2093
857663,2022-06-03,Conceição do Rio Verde/MG,0,30,1,2094
863260,2022-06-04,Conceição do Rio Verde/MG,0,30,0,2094
868857,2022-06-05,Conceição do Rio Verde/MG,0,30,0,2094
874454,2022-06-06,Conceição do Rio Verde/MG,0,30,2,2096
880051,2022-06-07,Conceição do Rio Verde/MG,0,30,3,2099
885648,2022-06-08,Conceição do Rio Verde/MG,0,30,2,2101
891245,2022-06-09,Conceição do Rio Verde/MG,0,30,0,2101
896842,2022-06-10,Conceição do Rio Verde/MG,0,30,11,2112
902439,2022-06-11,Conceição do Rio Verde/MG,0,30,0,2112
908036,2022-06-12,Conceição do Rio Verde/MG,0,30,0,2112
913633,2022-06-13,Conceição do Rio Verde/MG,0,30,4,2116
919230,2022-06-14,Conceição do Rio Verde/MG,0,30,9,2125
924827,2022-06-15,Conceição do Rio Verde/MG,0,30,1,2126
930424,2022-06-16,Conceição do Rio Verde/MG,0,30,0,2126
936021,2022-06-17,Conceição do Rio Verde/MG,0,30,0,2126
941618,2022-06-18,Conceição do Rio Verde/MG,0,30,0,2126
947215,2022-06-19,Conceição do Rio Verde/MG,0,30,0,2126
952812,2022-06-20,Conceição do Rio Verde/MG,0,30,1,2127
958409,2022-06-21,Conceição do Rio Verde/MG,0,30,12,2139
964006,2022-06-22,Conceição do Rio Verde/MG,0,30,8,2147
969603,2022-06-23,Conceição do Rio Verde/MG,0,30,7,2154
975200,2022-06-24,Conceição do Rio Verde/MG,0,30,10,2164
980797,2022-06-25,Conceição do Rio Verde/MG,0,30,0,2164
986394,2022-06-26,Conceição do Rio Verde/MG,0,30,0,2164
991991,2022-06-27,Conceição do Rio Verde/MG,0,30,5,2169
997588,2022-06-28,Conceição do Rio Verde/MG,0,30,2,2171
1003185,2022-06-29,Conceição do Rio Verde/MG,0,30,12,2183
1008782,2022-06-30,Conceição do Rio Verde/MG,0,30,7,2190
1014379,2022-07-01,Conceição do Rio Verde/MG,0,30,4,2194
1019976,2022-07-02,Conceição do Rio Verde/MG,0,30,0,2194
1025573,2022-07-03,Conceição do Rio Verde/MG,0,30,0,2194
1031170,2022-07-04,Conceição do Rio Verde/MG,0,30,9,2203
1036767,2022-07-05,Conceição do Rio Verde/MG,0,30,17,2220
1042364,2022-07-06,Conceição do Rio Verde/MG,0,30,7,2227
1047961,2022-07-07,Conceição do Rio Verde/MG,0,30,3,2230
1053558,2022-07-08,Conceição do Rio Verde/MG,0,30,7,2237
1059155,2022-07-09,Conceição do Rio Verde/MG,0,30,0,2237
1064752,2022-07-10,Conceição do Rio Verde/MG,0,30,0,2237
1070349,2022-07-11,Conceição do Rio Verde/MG,0,30,11,2248
1075946,2022-07-12,Conceição do Rio Verde/MG,0,30,14,2262
1081543,2022-07-13,Conceição do Rio Verde/MG,0,30,12,2274
1087140,2022-07-14,Conceição do Rio Verde/MG,0,30,6,2280
1092737,2022-07-15,Conceição do Rio Verde/MG,0,30,13,2293
1098334,2022-07-16,Conceição do Rio Verde/MG,0,30,0,2293
1103931,2022-07-17,Conceição do Rio Verde/MG,0,30,0,2293
1109528,2022-07-18,Conceição do Rio Verde/MG,0,30,2,2295
1115125,2022-07-19,Conceição do Rio Verde/MG,0,30,10,2305
1120722,2022-07-20,Conceição do Rio Verde/MG,0,30,0,2305
1126319,2022-07-21,Conceição do Rio Verde/MG,0,30,3,2308
1131916,2022-07-22,Conceição do Rio Verde/MG,0,30,2,2310
1137513,2022-07-23,Conceição do Rio Verde/MG,0,30,0,2310
1143110,2022-07-24,Conceição do Rio Verde/MG,0,30,0,2310
1148707,2022-07-25,Conceição do Rio Verde/MG,0,30,1,2311
1154304,2022-07-26,Conceição do Rio Verde/MG,0,30,3,2314
1159901,2022-07-27,Conceição do Rio Verde/MG,0,30,3,2317
1165498,2022-07-28,Conceição do Rio Verde/MG,0,30,0,2317
1171095,2022-07-29,Conceição do Rio Verde/MG,0,30,4,2321
1176692,2022-07-30,Conceição do Rio Verde/MG,0,30,0,2321
1182289,2022-07-31,Conceição do Rio Verde/MG,0,30,0,2321
1187886,2022-08-01,Conceição do Rio Verde/MG,0,30,2,2323
1193483,2022-08-02,Conceição do Rio Verde/MG,0,30,0,2323
1199080,2022-08-03,Conceição do Rio Verde/MG,0,30,0,2323
1204677,2022-08-04,Conceição do Rio Verde/MG,0,30,0,2323
1210274,2022-08-05,Conceição do Rio Verde/MG,0,30,1,2324
1215871,2022-08-06,Conceição do Rio Verde/MG,0,30,0,2324
1221468,2022-08-07,Conceição do Rio Verde/MG,0,30,0,2324
1227065,2022-08-08,Conceição do Rio Verde/MG,0,30,1,2325
1232662,2022-08-09,Conceição do Rio Verde/MG,0,30,0,2325
1238259,2022-08-10,Conceição do Rio Verde/MG,0,30,4,2329
1243856,2022-08-11,Conceição do Rio Verde/MG,0,30,0,2329
1249453,2022-08-12,Conceição do Rio Verde/MG,0,30,3,2332
1255050,2022-08-13,Conceição do Rio Verde/MG,0,30,0,2332
1260647,2022-08-14,Conceição do Rio Verde/MG,0,30,0,2332
1266244,2022-08-15,Conceição do Rio Verde/MG,0,30,0,2332
1271841,2022-08-16,Conceição do Rio Verde/MG,0,30,0,2332
1277438,2022-08-17,Conceição do Rio Verde/MG,0,30,0,2332
1283035,2022-08-18,Conceição do Rio Verde/MG,0,30,0,2332
1288632,2022-08-19,Conceição do Rio Verde/MG,0,30,0,2332
1294229,2022-08-20,Conceição do Rio Verde/MG,0,30,0,2332
1299826,2022-08-21,Conceição do Rio Verde/MG,0,30,0,2332
1305423,2022-08-22,Conceição do Rio Verde/MG,0,30,0,2332
1311020,2022-08-23,Conceição do Rio Verde/MG,0,30,4,2336
1316617,2022-08-24,Conceição do Rio Verde/MG,0,30,0,2336
1322214,2022-08-25,Conceição do Rio Verde/MG,0,30,1,2337
1569,2022-01-01,Divisa Nova/MG,0,13,0,530
7166,2022-01-02,Divisa Nova/MG,0,13,0,530
12763,2022-01-03,Divisa Nova/MG,0,13,0,530
18360,2022-01-04,Divisa Nova/MG,0,13,0,530
23957,2022-01-05,Divisa Nova/MG,0,13,0,530
29554,2022-01-06,Divisa Nova/MG,0,13,0,530
35151,2022-01-07,Divisa Nova/MG,0,13,0,530
40748,2022-01-08,Divisa Nova/MG,0,13,0,530
46345,2022-01-09,Divisa Nova/MG,0,13,0,530
51942,2022-01-10,Divisa Nova/MG,0,13,0,530
57539,2022-01-11,Divisa Nova/MG,0,13,0,530
63136,2022-01-12,Divisa Nova/MG,0,13,8,538
68733,2022-01-13,Divisa Nova/MG,0,13,5,543
74330,2022-01-14,Divisa Nova/MG,0,13,1,544
79927,2022-01-15,Divisa Nova/MG,0,13,4,548
85524,2022-01-16,Divisa Nova/MG,0,13,0,548
91121,2022-01-17,Divisa Nova/MG,0,13,0,548
96718,2022-01-18,Divisa Nova/MG,0,13,0,548
102315,2022-01-19,Divisa Nova/MG,0,13,0,548
107912,2022-01-20,Divisa Nova/MG,0,13,0,548
113509,2022-01-21,Divisa Nova/MG,0,13,0,548
119106,2022-01-22,Divisa Nova/MG,0,13,0,548
124703,2022-01-23,Divisa Nova/MG,0,13,0,548
130300,2022-01-24,Divisa Nova/MG,0,13,0,548
135897,2022-01-25,Divisa Nova/MG,0,13,57,605
141494,2022-01-26,Divisa Nova/MG,0,13,19,624
147091,2022-01-27,Divisa Nova/MG,0,13,13,637
152688,2022-01-28,Divisa Nova/MG,0,13,13,650
158285,2022-01-29,Divisa Nova/MG,0,13,0,650
163882,2022-01-30,Divisa Nova/MG,0,13,21,671
169479,2022-01-31,Divisa Nova/MG,0,13,0,671
175076,2022-02-01,Divisa Nova/MG,0,13,0,671
180673,2022-02-02,Divisa Nova/MG,0,13,0,671
186270,2022-02-03,Divisa Nova/MG,0,13,24,695
191867,2022-02-04,Divisa Nova/MG,0,13,7,702
197464,2022-02-05,Divisa Nova/MG,0,13,15,717
203061,2022-02-06,Divisa Nova/MG,0,13,0,717
208658,2022-02-07,Divisa Nova/MG,0,13,0,717
214255,2022-02-08,Divisa Nova/MG,0,13,12,729
219852,2022-02-09,Divisa Nova/MG,0,13,12,741
225449,2022-02-10,Divisa Nova/MG,0,13,15,756
231046,2022-02-11,Divisa Nova/MG,0,13,9,765
236643,2022-02-12,Divisa Nova/MG,0,13,6,771
242240,2022-02-13,Divisa Nova/MG,0,13,0,771
247837,2022-02-14,Divisa Nova/MG,0,13,0,771
253434,2022-02-15,Divisa Nova/MG,1,14,16,787
259031,2022-02-16,Divisa Nova/MG,0,14,10,797
264628,2022-02-17,Divisa Nova/MG,0,14,10,807
270225,2022-02-18,Divisa Nova/MG,0,14,8,815
275822,2022-02-19,Divisa Nova/MG,0,14,3,818
281419,2022-02-20,Divisa Nova/MG,0,14,0,818
287016,2022-02-21,Divisa Nova/MG,0,14,0,818
292613,2022-02-22,Divisa Nova/MG,0,14,8,826
298210,2022-02-23,Divisa Nova/MG,0,14,12,838
303807,2022-02-24,Divisa Nova/MG,0,14,0,838
309404,2022-02-25,Divisa Nova/MG,0,14,6,844
315001,2022-02-26,Divisa Nova/MG,0,14,1,845
320598,2022-02-27,Divisa Nova/MG,0,14,0,845
326195,2022-02-28,Divisa Nova/MG,0,14,0,845
331792,2022-03-01,Divisa Nova/MG,0,14,0,845
337389,2022-03-02,Divisa Nova/MG,0,14,0,845
342986,2022-03-03,Divisa Nova/MG,0,14,0,845
348583,2022-03-04,Divisa Nova/MG,0,14,21,866
354180,2022-03-05,Divisa Nova/MG,1,15,0,866
359777,2022-03-06,Divisa Nova/MG,0,15,0,866
365374,2022-03-07,Divisa Nova/MG,0,15,0,866
370971,2022-03-08,Divisa Nova/MG,0,15,2,868
376568,2022-03-09,Divisa Nova/MG,0,15,4,872
382165,2022-03-10,Divisa Nova/MG,0,15,0,872
387762,2022-03-11,Divisa Nova/MG,0,15,1,873
393359,2022-03-12,Divisa Nova/MG,0,15,0,873
398956,2022-03-13,Divisa Nova/MG,0,15,0,873
404553,2022-03-14,Divisa Nova/MG,0,15,0,873
410150,2022-03-15,Divisa Nova/MG,0,15,0,873
415747,2022-03-16,Divisa Nova/MG,0,15,3,876
421344,2022-03-17,Divisa Nova/MG,0,15,0,876
426941,2022-03-18,Divisa Nova/MG,0,15,1,877
432538,2022-03-19,Divisa Nova/MG,0,15,0,877
438135,2022-03-20,Divisa Nova/MG,0,15,0,877
443732,2022-03-21,Divisa Nova/MG,0,15,0,877
449329,2022-03-22,Divisa Nova/MG,0,15,4,881
454926,2022-03-23,Divisa Nova/MG,0,15,0,881
460523,2022-03-24,Divisa Nova/MG,0,15,0,881
466120,2022-03-25,Divisa Nova/MG,0,15,0,881
471717,2022-03-26,Divisa Nova/MG,0,15,0,881
477314,2022-03-27,Divisa Nova/MG,0,15,0,881
482911,2022-03-28,Divisa Nova/MG,0,15,0,881
488508,2022-03-29,Divisa Nova/MG,0,15,0,881
494105,2022-03-30,Divisa Nova/MG,0,15,0,881
499702,2022-03-31,Divisa Nova/MG,0,15,0,881
505299,2022-04-01,Divisa Nova/MG,0,15,0,881
510896,2022-04-02,Divisa Nova/MG,0,15,0,881
516493,2022-04-03,Divisa Nova/MG,0,15,0,881
522090,2022-04-04,Divisa Nova/MG,0,15,0,881
527687,2022-04-05,Divisa Nova/MG,0,15,0,881
533284,2022-04-06,Divisa Nova/MG,0,15,1,882
538881,2022-04-07,Divisa Nova/MG,0,15,0,882
544478,2022-04-08,Divisa Nova/MG,0,15,0,882
550075,2022-04-09,Divisa Nova/MG,0,15,0,882
555672,2022-04-10,Divisa Nova/MG,0,15,0,882
561269,2022-04-11,Divisa Nova/MG,0,15,0,882
566866,2022-04-12,Divisa Nova/MG,0,15,0,882
572463,2022-04-13,Divisa Nova/MG,0,15,0,882
578060,2022-04-14,Divisa Nova/MG,0,15,0,882
583657,2022-04-15,Divisa Nova/MG,0,15,0,882
589254,2022-04-16,Divisa Nova/MG,0,15,0,882
594851,2022-04-17,Divisa Nova/MG,0,15,0,882
600448,2022-04-18,Divisa Nova/MG,0,15,0,882
606045,2022-04-19,Divisa Nova/MG,0,15,0,882
611642,2022-04-20,Divisa Nova/MG,0,15,0,882
617239,2022-04-21,Divisa Nova/MG,0,15,0,882
622836,2022-04-22,Divisa Nova/MG,0,15,0,882
628433,2022-04-23,Divisa Nova/MG,0,15,0,882
634030,2022-04-24,Divisa Nova/MG,0,15,0,882
639627,2022-04-25,Divisa Nova/MG,0,15,0,882
645224,2022-04-26,Divisa Nova/MG,0,15,0,882
650821,2022-04-27,Divisa Nova/MG,0,15,0,882
656418,2022-04-28,Divisa Nova/MG,0,15,0,882
662015,2022-04-29,Divisa Nova/MG,0,15,0,882
667612,2022-04-30,Divisa Nova/MG,0,15,1,883
673209,2022-05-01,Divisa Nova/MG,0,15,0,883
678806,2022-05-02,Divisa Nova/MG,0,15,0,883
684403,2022-05-03,Divisa Nova/MG,0,15,0,883
690000,2022-05-04,Divisa Nova/MG,0,15,0,883
695597,2022-05-05,Divisa Nova/MG,0,15,0,883
701194,2022-05-06,Divisa Nova/MG,0,15,0,883
706791,2022-05-07,Divisa Nova/MG,0,15,0,883
712388,2022-05-08,Divisa Nova/MG,0,15,0,883
717985,2022-05-09,Divisa Nova/MG,0,15,0,883
723582,2022-05-10,Divisa Nova/MG,0,15,0,883
729179,2022-05-11,Divisa Nova/MG,0,15,0,883
734776,2022-05-12,Divisa Nova/MG,0,15,0,883
740373,2022-05-13,Divisa Nova/MG,0,15,1,884
745970,2022-05-14,Divisa Nova/MG,0,15,0,884
751567,2022-05-15,Divisa Nova/MG,0,15,0,884
757164,2022-05-16,Divisa Nova/MG,0,15,0,884
762761,2022-05-17,Divisa Nova/MG,0,15,0,884
768358,2022-05-18,Divisa Nova/MG,0,15,2,886
773955,2022-05-19,Divisa Nova/MG,0,15,0,886
779552,2022-05-20,Divisa Nova/MG,0,15,0,886
785149,2022-05-21,Divisa Nova/MG,0,15,0,886
790746,2022-05-22,Divisa Nova/MG,0,15,0,886
796343,2022-05-23,Divisa Nova/MG,0,15,1,887
801940,2022-05-24,Divisa Nova/MG,0,15,1,888
807537,2022-05-25,Divisa Nova/MG,0,15,1,889
813134,2022-05-26,Divisa Nova/MG,0,15,3,892
818731,2022-05-27,Divisa Nova/MG,0,15,0,892
824328,2022-05-28,Divisa Nova/MG,0,15,0,892
829925,2022-05-29,Divisa Nova/MG,0,15,0,892
835522,2022-05-30,Divisa Nova/MG,0,15,0,892
841119,2022-05-31,Divisa Nova/MG,0,15,0,892
846716,2022-06-01,Divisa Nova/MG,0,15,20,912
852313,2022-06-02,Divisa Nova/MG,0,15,0,912
857910,2022-06-03,Divisa Nova/MG,0,15,0,912
863507,2022-06-04,Divisa Nova/MG,0,15,0,912
869104,2022-06-05,Divisa Nova/MG,0,15,0,912
874701,2022-06-06,Divisa Nova/MG,0,15,0,912
880298,2022-06-07,Divisa Nova/MG,0,15,50,962
885895,2022-06-08,Divisa Nova/MG,0,15,7,969
891492,2022-06-09,Divisa Nova/MG,0,15,0,969
897089,2022-06-10,Divisa Nova/MG,0,15,13,982
902686,2022-06-11,Divisa Nova/MG,0,15,0,982
908283,2022-06-12,Divisa Nova/MG,0,15,0,982
913880,2022-06-13,Divisa Nova/MG,0,15,7,989
919477,2022-06-14,Divisa Nova/MG,0,15,5,994
925074,2022-06-15,Divisa Nova/MG,0,15,6,1000
930671,2022-06-16,Divisa Nova/MG,0,15,0,1000
936268,2022-06-17,Divisa Nova/MG,0,15,0,1000
941865,2022-06-18,Divisa Nova/MG,0,15,0,1000
947462,2022-06-19,Divisa Nova/MG,0,15,0,1000
953059,2022-06-20,Divisa Nova/MG,0,15,0,1000
958656,2022-06-21,Divisa Nova/MG,0,15,18,1018
964253,2022-06-22,Divisa Nova/MG,0,15,0,1018
969850,2022-06-23,Divisa Nova/MG,0,15,21,1039
975447,2022-06-24,Divisa Nova/MG,0,15,8,1047
981044,2022-06-25,Divisa Nova/MG,0,15,0,1047
986641,2022-06-26,Divisa Nova/MG,0,15,0,1047
992238,2022-06-27,Divisa Nova/MG,0,15,3,1050
997835,2022-06-28,Divisa Nova/MG,0,15,5,1055
1003432,2022-06-29,Divisa Nova/MG,0,15,8,1063
1009029,2022-06-30,Divisa Nova/MG,0,15,0,1063
1014626,2022-07-01,Divisa Nova/MG,0,15,4,1067
1020223,2022-07-02,Divisa Nova/MG,0,15,0,1067
1025820,2022-07-03,Divisa Nova/MG,0,15,0,1067
1031417,2022-07-04,Divisa Nova/MG,0,15,13,1080
1037014,2022-07-05,Divisa Nova/MG,0,15,0,1080
1042611,2022-07-06,Divisa Nova/MG,0,15,20,1100
1048208,2022-07-07,Divisa Nova/MG,0,15,0,1100
1053805,2022-07-08,Divisa Nova/MG,0,15,7,1107
1059402,2022-07-09,Divisa Nova/MG,0,15,0,1107
1064999,2022-07-10,Divisa Nova/MG,0,15,0,1107
1070596,2022-07-11,Divisa Nova/MG,0,15,2,1109
1076193,2022-07-12,Divisa Nova/MG,0,15,7,1116
1081790,2022-07-13,Divisa Nova/MG,0,15,7,1123
1087387,2022-07-14,Divisa Nova/MG,0,15,2,1125
1092984,2022-07-15,Divisa Nova/MG,0,15,3,1128
1098581,2022-07-16,Divisa Nova/MG,0,15,0,1128
1104178,2022-07-17,Divisa Nova/MG,0,15,0,1128
1109775,2022-07-18,Divisa Nova/MG,0,15,1,1129
1115372,2022-07-19,Divisa Nova/MG,0,15,3,1132
1120969,2022-07-20,Divisa Nova/MG,0,15,3,1135
1126566,2022-07-21,Divisa Nova/MG,0,15,0,1135
1132163,2022-07-22,Divisa Nova/MG,0,15,0,1135
1137760,2022-07-23,Divisa Nova/MG,0,15,0,1135
1143357,2022-07-24,Divisa Nova/MG,0,15,0,1135
1148954,2022-07-25,Divisa Nova/MG,0,15,0,1135
1154551,2022-07-26,Divisa Nova/MG,0,15,3,1138
1160148,2022-07-27,Divisa Nova/MG,0,15,2,1140
1165745,2022-07-28,Divisa Nova/MG,0,15,2,1142
1171342,2022-07-29,Divisa Nova/MG,0,15,0,1142
1176939,2022-07-30,Divisa Nova/MG,0,15,0,1142
1182536,2022-07-31,Divisa Nova/MG,0,15,0,1142
1188133,2022-08-01,Divisa Nova/MG,0,15,0,1142
1193730,2022-08-02,Divisa Nova/MG,0,15,2,1144
1199327,2022-08-03,Divisa Nova/MG,0,15,6,1150
1204924,2022-08-04,Divisa Nova/MG,0,15,2,1152
1210521,2022-08-05,Divisa Nova/MG,0,15,4,1156
1216118,2022-08-06,Divisa Nova/MG,0,15,0,1156
1221715,2022-08-07,Divisa Nova/MG,0,15,0,1156
1227312,2022-08-08,Divisa Nova/MG,0,15,1,1157
1232909,2022-08-09,Divisa Nova/MG,0,15,0,1157
1238506,2022-08-10,Divisa Nova/MG,0,15,0,1157
1244103,2022-08-11,Divisa Nova/MG,0,15,0,1157
1249700,2022-08-12,Divisa Nova/MG,0,15,1,1158
1255297,2022-08-13,Divisa Nova/MG,0,15,0,1158
1260894,2022-08-14,Divisa Nova/MG,0,15,0,1158
1266491,2022-08-15,Divisa Nova/MG,0,15,0,1158
1272088,2022-08-16,Divisa Nova/MG,0,15,0,1158
1277685,2022-08-17,Divisa Nova/MG,0,15,0,1158
1283282,2022-08-18,Divisa Nova/MG,0,15,0,1158
1288879,2022-08-19,Divisa Nova/MG,0,15,0,1158
1294476,2022-08-20,Divisa Nova/MG,0,15,0,1158
1300073,2022-08-21,Divisa Nova/MG,0,15,0,1158
1305670,2022-08-22,Divisa Nova/MG,0,15,0,1158
1311267,2022-08-23,Divisa Nova/MG,0,15,0,1158
1316864,2022-08-24,Divisa Nova/MG,0,15,1,1159
1322461,2022-08-25,Divisa Nova/MG,0,15,1,1160
1645,2022-01-01,Elói Mendes/MG,0,62,10,3223
7242,2022-01-02,Elói Mendes/MG,0,62,0,3223
12839,2022-01-03,Elói Mendes/MG,0,62,0,3223
18436,2022-01-04,Elói Mendes/MG,0,62,4,3227
24033,2022-01-05,Elói Mendes/MG,0,62,0,3227
29630,2022-01-06,Elói Mendes/MG,0,62,28,3255
35227,2022-01-07,Elói Mendes/MG,0,62,0,3255
40824,2022-01-08,Elói Mendes/MG,0,62,47,3302
46421,2022-01-09,Elói Mendes/MG,0,62,28,3330
52018,2022-01-10,Elói Mendes/MG,0,62,0,3330
57615,2022-01-11,Elói Mendes/MG,0,62,0,3330
63212,2022-01-12,Elói Mendes/MG,0,62,77,3407
68809,2022-01-13,Elói Mendes/MG,0,62,38,3445
74406,2022-01-14,Elói Mendes/MG,0,62,17,3462
80003,2022-01-15,Elói Mendes/MG,0,62,87,3549
85600,2022-01-16,Elói Mendes/MG,0,62,0,3549
91197,2022-01-17,Elói Mendes/MG,0,62,75,3624
96794,2022-01-18,Elói Mendes/MG,0,62,8,3632
102391,2022-01-19,Elói Mendes/MG,0,62,44,3676
107988,2022-01-20,Elói Mendes/MG,0,62,57,3733
113585,2022-01-21,Elói Mendes/MG,0,62,0,3733
119182,2022-01-22,Elói Mendes/MG,0,62,106,3839
124779,2022-01-23,Elói Mendes/MG,0,62,70,3909
130376,2022-01-24,Elói Mendes/MG,0,62,26,3935
135973,2022-01-25,Elói Mendes/MG,0,62,5,3940
141570,2022-01-26,Elói Mendes/MG,0,62,53,3993
147167,2022-01-27,Elói Mendes/MG,0,62,81,4074
152764,2022-01-28,Elói Mendes/MG,0,62,70,4144
158361,2022-01-29,Elói Mendes/MG,1,63,46,4190
163958,2022-01-30,Elói Mendes/MG,0,63,51,4241
169555,2022-01-31,Elói Mendes/MG,0,63,39,4280
175152,2022-02-01,Elói Mendes/MG,0,63,-1,4279
180749,2022-02-02,Elói Mendes/MG,0,63,46,4325
186346,2022-02-03,Elói Mendes/MG,0,63,90,4415
191943,2022-02-04,Elói Mendes/MG,0,63,50,4465
197540,2022-02-05,Elói Mendes/MG,0,63,58,4523
203137,2022-02-06,Elói Mendes/MG,0,63,38,4561
208734,2022-02-07,Elói Mendes/MG,0,63,30,4591
214331,2022-02-08,Elói Mendes/MG,0,63,21,4612
219928,2022-02-09,Elói Mendes/MG,0,63,44,4656
225525,2022-02-10,Elói Mendes/MG,1,64,25,4681
231122,2022-02-11,Elói Mendes/MG,0,64,25,4706
236719,2022-02-12,Elói Mendes/MG,0,64,32,4738
242316,2022-02-13,Elói Mendes/MG,0,64,33,4771
247913,2022-02-14,Elói Mendes/MG,0,64,23,4794
253510,2022-02-15,Elói Mendes/MG,0,64,11,4805
259107,2022-02-16,Elói Mendes/MG,0,64,35,4840
264704,2022-02-17,Elói Mendes/MG,0,64,30,4870
270301,2022-02-18,Elói Mendes/MG,0,64,37,4907
275898,2022-02-19,Elói Mendes/MG,0,64,24,4931
281495,2022-02-20,Elói Mendes/MG,0,64,28,4959
287092,2022-02-21,Elói Mendes/MG,0,64,18,4977
292689,2022-02-22,Elói Mendes/MG,0,64,8,4985
298286,2022-02-23,Elói Mendes/MG,0,64,14,4999
303883,2022-02-24,Elói Mendes/MG,0,64,11,5010
309480,2022-02-25,Elói Mendes/MG,0,64,17,5027
315077,2022-02-26,Elói Mendes/MG,0,64,0,5027
320674,2022-02-27,Elói Mendes/MG,0,64,9,5036
326271,2022-02-28,Elói Mendes/MG,0,64,9,5045
331868,2022-03-01,Elói Mendes/MG,0,64,1,5046
337465,2022-03-02,Elói Mendes/MG,0,64,0,5046
343062,2022-03-03,Elói Mendes/MG,0,64,27,5073
348659,2022-03-04,Elói Mendes/MG,0,64,0,5073
354256,2022-03-05,Elói Mendes/MG,0,64,13,5086
359853,2022-03-06,Elói Mendes/MG,0,64,4,5090
365450,2022-03-07,Elói Mendes/MG,0,64,7,5097
371047,2022-03-08,Elói Mendes/MG,0,64,2,5099
376644,2022-03-09,Elói Mendes/MG,0,64,9,5108
382241,2022-03-10,Elói Mendes/MG,0,64,2,5110
387838,2022-03-11,Elói Mendes/MG,0,64,4,5114
393435,2022-03-12,Elói Mendes/MG,0,64,4,5118
399032,2022-03-13,Elói Mendes/MG,0,64,0,5118
404629,2022-03-14,Elói Mendes/MG,0,64,2,5120
410226,2022-03-15,Elói Mendes/MG,0,64,8,5128
415823,2022-03-16,Elói Mendes/MG,0,64,2,5130
421420,2022-03-17,Elói Mendes/MG,0,64,1,5131
427017,2022-03-18,Elói Mendes/MG,0,64,3,5134
432614,2022-03-19,Elói Mendes/MG,0,64,3,5137
438211,2022-03-20,Elói Mendes/MG,0,64,4,5141
443808,2022-03-21,Elói Mendes/MG,0,64,4,5145
449405,2022-03-22,Elói Mendes/MG,0,64,4,5149
455002,2022-03-23,Elói Mendes/MG,0,64,5,5154
460599,2022-03-24,Elói Mendes/MG,0,64,1,5155
466196,2022-03-25,Elói Mendes/MG,0,64,0,5155
471793,2022-03-26,Elói Mendes/MG,0,64,3,5158
477390,2022-03-27,Elói Mendes/MG,0,64,1,5159
482987,2022-03-28,Elói Mendes/MG,0,64,0,5159
488584,2022-03-29,Elói Mendes/MG,0,64,0,5159
494181,2022-03-30,Elói Mendes/MG,0,64,0,5159
499778,2022-03-31,Elói Mendes/MG,0,64,0,5159
505375,2022-04-01,Elói Mendes/MG,0,64,11,5170
510972,2022-04-02,Elói Mendes/MG,0,64,0,5170
516569,2022-04-03,Elói Mendes/MG,0,64,0,5170
522166,2022-04-04,Elói Mendes/MG,0,64,0,5170
527763,2022-04-05,Elói Mendes/MG,0,64,5,5175
533360,2022-04-06,Elói Mendes/MG,0,64,6,5181
538957,2022-04-07,Elói Mendes/MG,0,64,0,5181
544554,2022-04-08,Elói Mendes/MG,0,64,0,5181
550151,2022-04-09,Elói Mendes/MG,0,64,2,5183
555748,2022-04-10,Elói Mendes/MG,0,64,0,5183
561345,2022-04-11,Elói Mendes/MG,0,64,0,5183
566942,2022-04-12,Elói Mendes/MG,0,64,2,5185
572539,2022-04-13,Elói Mendes/MG,0,64,4,5189
578136,2022-04-14,Elói Mendes/MG,0,64,6,5195
583733,2022-04-15,Elói Mendes/MG,0,64,0,5195
589330,2022-04-16,Elói Mendes/MG,0,64,0,5195
594927,2022-04-17,Elói Mendes/MG,0,64,0,5195
600524,2022-04-18,Elói Mendes/MG,0,64,0,5195
606121,2022-04-19,Elói Mendes/MG,0,64,4,5199
611718,2022-04-20,Elói Mendes/MG,0,64,1,5200
617315,2022-04-21,Elói Mendes/MG,0,64,1,5201
622912,2022-04-22,Elói Mendes/MG,0,64,0,5201
628509,2022-04-23,Elói Mendes/MG,0,64,0,5201
634106,2022-04-24,Elói Mendes/MG,0,64,0,5201
639703,2022-04-25,Elói Mendes/MG,0,64,0,5201
645300,2022-04-26,Elói Mendes/MG,0,64,1,5202
650897,2022-04-27,Elói Mendes/MG,0,64,3,5205
656494,2022-04-28,Elói Mendes/MG,0,64,4,5209
662091,2022-04-29,Elói Mendes/MG,0,64,4,5213
667688,2022-04-30,Elói Mendes/MG,0,64,0,5213
673285,2022-05-01,Elói Mendes/MG,0,64,4,5217
678882,2022-05-02,Elói Mendes/MG,0,64,0,5217
684479,2022-05-03,Elói Mendes/MG,0,64,0,5217
690076,2022-05-04,Elói Mendes/MG,0,64,0,5217
695673,2022-05-05,Elói Mendes/MG,0,64,3,5220
701270,2022-05-06,Elói Mendes/MG,0,64,0,5220
706867,2022-05-07,Elói Mendes/MG,0,64,0,5220
712464,2022-05-08,Elói Mendes/MG,0,64,0,5220
718061,2022-05-09,Elói Mendes/MG,0,64,0,5220
723658,2022-05-10,Elói Mendes/MG,0,64,0,5220
729255,2022-05-11,Elói Mendes/MG,0,64,0,5220
734852,2022-05-12,Elói Mendes/MG,0,64,1,5221
740449,2022-05-13,Elói Mendes/MG,0,64,3,5224
746046,2022-05-14,Elói Mendes/MG,0,64,0,5224
751643,2022-05-15,Elói Mendes/MG,0,64,0,5224
757240,2022-05-16,Elói Mendes/MG,0,64,0,5224
762837,2022-05-17,Elói Mendes/MG,0,64,0,5224
768434,2022-05-18,Elói Mendes/MG,0,64,1,5225
774031,2022-05-19,Elói Mendes/MG,0,64,0,5225
779628,2022-05-20,Elói Mendes/MG,0,64,0,5225
785225,2022-05-21,Elói Mendes/MG,0,64,0,5225
790822,2022-05-22,Elói Mendes/MG,0,64,0,5225
796419,2022-05-23,Elói Mendes/MG,0,64,0,5225
802016,2022-05-24,Elói Mendes/MG,0,64,3,5228
807613,2022-05-25,Elói Mendes/MG,0,64,0,5228
813210,2022-05-26,Elói Mendes/MG,0,64,3,5231
818807,2022-05-27,Elói Mendes/MG,0,64,4,5235
824404,2022-05-28,Elói Mendes/MG,0,64,0,5235
830001,2022-05-29,Elói Mendes/MG,0,64,0,5235
835598,2022-05-30,Elói Mendes/MG,0,64,2,5237
841195,2022-05-31,Elói Mendes/MG,0,64,3,5240
846792,2022-06-01,Elói Mendes/MG,0,64,5,5245
852389,2022-06-02,Elói Mendes/MG,0,64,14,5259
857986,2022-06-03,Elói Mendes/MG,0,64,0,5259
863583,2022-06-04,Elói Mendes/MG,0,64,0,5259
869180,2022-06-05,Elói Mendes/MG,0,64,0,5259
874777,2022-06-06,Elói Mendes/MG,0,64,21,5280
880374,2022-06-07,Elói Mendes/MG,0,64,12,5292
885971,2022-06-08,Elói Mendes/MG,0,64,0,5292
891568,2022-06-09,Elói Mendes/MG,0,64,20,5312
897165,2022-06-10,Elói Mendes/MG,0,64,3,5315
902762,2022-06-11,Elói Mendes/MG,0,64,0,5315
908359,2022-06-12,Elói Mendes/MG,0,64,0,5315
913956,2022-06-13,Elói Mendes/MG,0,64,0,5315
919553,2022-06-14,Elói Mendes/MG,0,64,32,5347
925150,2022-06-15,Elói Mendes/MG,0,64,5,5352
930747,2022-06-16,Elói Mendes/MG,0,64,0,5352
936344,2022-06-17,Elói Mendes/MG,0,64,0,5352
941941,2022-06-18,Elói Mendes/MG,0,64,0,5352
947538,2022-06-19,Elói Mendes/MG,0,64,0,5352
953135,2022-06-20,Elói Mendes/MG,0,64,34,5386
958732,2022-06-21,Elói Mendes/MG,0,64,3,5389
964329,2022-06-22,Elói Mendes/MG,0,64,3,5392
969926,2022-06-23,Elói Mendes/MG,0,64,6,5398
975523,2022-06-24,Elói Mendes/MG,0,64,7,5405
981120,2022-06-25,Elói Mendes/MG,0,64,0,5405
986717,2022-06-26,Elói Mendes/MG,0,64,0,5405
992314,2022-06-27,Elói Mendes/MG,0,64,29,5434
997911,2022-06-28,Elói Mendes/MG,0,64,4,5438
1003508,2022-06-29,Elói Mendes/MG,0,64,8,5446
1009105,2022-06-30,Elói Mendes/MG,0,64,24,5470
1014702,2022-07-01,Elói Mendes/MG,0,64,16,5486
1020299,2022-07-02,Elói Mendes/MG,0,64,0,5486
1025896,2022-07-03,Elói Mendes/MG,0,64,0,5486
1031493,2022-07-04,Elói Mendes/MG,0,64,27,5513
1037090,2022-07-05,Elói Mendes/MG,0,64,0,5513
1042687,2022-07-06,Elói Mendes/MG,0,64,11,5524
1048284,2022-07-07,Elói Mendes/MG,0,64,0,5524
1053881,2022-07-08,Elói Mendes/MG,0,64,30,5554
1059478,2022-07-09,Elói Mendes/MG,0,64,0,5554
1065075,2022-07-10,Elói Mendes/MG,0,64,0,5554
1070672,2022-07-11,Elói Mendes/MG,0,64,10,5564
1076269,2022-07-12,Elói Mendes/MG,0,64,14,5578
1081866,2022-07-13,Elói Mendes/MG,0,64,15,5593
1087463,2022-07-14,Elói Mendes/MG,0,64,8,5601
1093060,2022-07-15,Elói Mendes/MG,0,64,9,5610
1098657,2022-07-16,Elói Mendes/MG,0,64,0,5610
1104254,2022-07-17,Elói Mendes/MG,0,64,0,5610
1109851,2022-07-18,Elói Mendes/MG,0,64,10,5620
1115448,2022-07-19,Elói Mendes/MG,0,64,12,5632
1121045,2022-07-20,Elói Mendes/MG,0,64,25,5657
1126642,2022-07-21,Elói Mendes/MG,0,64,14,5671
1132239,2022-07-22,Elói Mendes/MG,0,64,13,5684
1137836,2022-07-23,Elói Mendes/MG,0,64,0,5684
1143433,2022-07-24,Elói Mendes/MG,0,64,0,5684
1149030,2022-07-25,Elói Mendes/MG,0,64,9,5693
1154627,2022-07-26,Elói Mendes/MG,0,64,14,5707
1160224,2022-07-27,Elói Mendes/MG,0,64,5,5712
1165821,2022-07-28,Elói Mendes/MG,0,64,3,5715
1171418,2022-07-29,Elói Mendes/MG,0,64,18,5733
1177015,2022-07-30,Elói Mendes/MG,0,64,0,5733
1182612,2022-07-31,Elói Mendes/MG,0,64,0,5733
1188209,2022-08-01,Elói Mendes/MG,0,64,8,5741
1193806,2022-08-02,Elói Mendes/MG,0,64,2,5743
1199403,2022-08-03,Elói Mendes/MG,0,64,7,5750
1205000,2022-08-04,Elói Mendes/MG,0,64,1,5751
1210597,2022-08-05,Elói Mendes/MG,0,64,2,5753
1216194,2022-08-06,Elói Mendes/MG,0,64,0,5753
1221791,2022-08-07,Elói Mendes/MG,0,64,0,5753
1227388,2022-08-08,Elói Mendes/MG,0,64,0,5753
1232985,2022-08-09,Elói Mendes/MG,0,64,10,5763
1238582,2022-08-10,Elói Mendes/MG,0,64,7,5770
1244179,2022-08-11,Elói Mendes/MG,0,64,0,5770
1249776,2022-08-12,Elói Mendes/MG,0,64,6,5776
1255373,2022-08-13,Elói Mendes/MG,0,64,0,5776
1260970,2022-08-14,Elói Mendes/MG,0,64,0,5776
1266567,2022-08-15,Elói Mendes/MG,0,64,0,5776
1272164,2022-08-16,Elói Mendes/MG,0,64,4,5780
1277761,2022-08-17,Elói Mendes/MG,0,64,6,5786
1283358,2022-08-18,Elói Mendes/MG,0,64,0,5786
1288955,2022-08-19,Elói Mendes/MG,0,64,3,5789
1294552,2022-08-20,Elói Mendes/MG,0,64,0,5789
1300149,2022-08-21,Elói Mendes/MG,0,64,0,5789
1305746,2022-08-22,Elói Mendes/MG,0,64,1,5790
1311343,2022-08-23,Elói Mendes/MG,0,64,2,5792
1316940,2022-08-24,Elói Mendes/MG,0,64,1,5793
1322537,2022-08-25,Elói Mendes/MG,0,64,1,5794
1723,2022-01-01,Extrema/MG,0,133,-251,8848
7320,2022-01-02,Extrema/MG,0,133,0,8848
12917,2022-01-03,Extrema/MG,0,133,0,8848
18514,2022-01-04,Extrema/MG,0,133,0,8848
24111,2022-01-05,Extrema/MG,0,133,681,9529
29708,2022-01-06,Extrema/MG,0,133,0,9529
35305,2022-01-07,Extrema/MG,0,133,0,9529
40902,2022-01-08,Extrema/MG,0,133,0,9529
46499,2022-01-09,Extrema/MG,0,133,0,9529
52096,2022-01-10,Extrema/MG,0,133,0,9529
57693,2022-01-11,Extrema/MG,0,133,0,9529
63290,2022-01-12,Extrema/MG,0,133,1777,11306
68887,2022-01-13,Extrema/MG,0,133,200,11506
74484,2022-01-14,Extrema/MG,0,133,244,11750
80081,2022-01-15,Extrema/MG,1,134,358,12108
85678,2022-01-16,Extrema/MG,0,134,0,12108
91275,2022-01-17,Extrema/MG,0,134,0,12108
96872,2022-01-18,Extrema/MG,0,134,688,12796
102469,2022-01-19,Extrema/MG,0,134,65,12861
108066,2022-01-20,Extrema/MG,1,135,49,12910
113663,2022-01-21,Extrema/MG,1,136,129,13039
119260,2022-01-22,Extrema/MG,0,136,204,13243
124857,2022-01-23,Extrema/MG,0,136,0,13243
130454,2022-01-24,Extrema/MG,0,136,0,13243
136051,2022-01-25,Extrema/MG,0,136,413,13656
141648,2022-01-26,Extrema/MG,0,136,198,13854
147245,2022-01-27,Extrema/MG,0,136,333,14187
152842,2022-01-28,Extrema/MG,0,136,330,14517
158439,2022-01-29,Extrema/MG,1,137,0,14517
164036,2022-01-30,Extrema/MG,0,137,0,14517
169633,2022-01-31,Extrema/MG,0,137,0,14517
175230,2022-02-01,Extrema/MG,0,137,330,14847
180827,2022-02-02,Extrema/MG,0,137,26,14873
186424,2022-02-03,Extrema/MG,0,137,157,15030
192021,2022-02-04,Extrema/MG,1,138,8,15038
197618,2022-02-05,Extrema/MG,0,138,173,15211
203215,2022-02-06,Extrema/MG,0,138,0,15211
208812,2022-02-07,Extrema/MG,0,138,0,15211
214409,2022-02-08,Extrema/MG,0,138,174,15385
220006,2022-02-09,Extrema/MG,1,139,28,15413
225603,2022-02-10,Extrema/MG,0,139,62,15475
231200,2022-02-11,Extrema/MG,0,139,0,15475
236797,2022-02-12,Extrema/MG,0,139,85,15560
242394,2022-02-13,Extrema/MG,0,139,0,15560
247991,2022-02-14,Extrema/MG,0,139,0,15560
253588,2022-02-15,Extrema/MG,0,139,44,15604
259185,2022-02-16,Extrema/MG,0,139,11,15615
264782,2022-02-17,Extrema/MG,0,139,37,15652
270379,2022-02-18,Extrema/MG,0,139,58,15710
275976,2022-02-19,Extrema/MG,0,139,39,15749
281573,2022-02-20,Extrema/MG,0,139,0,15749
287170,2022-02-21,Extrema/MG,0,139,0,15749
292767,2022-02-22,Extrema/MG,0,139,50,15799
298364,2022-02-23,Extrema/MG,0,139,15,15814
303961,2022-02-24,Extrema/MG,0,139,25,15839
309558,2022-02-25,Extrema/MG,0,139,25,15864
315155,2022-02-26,Extrema/MG,0,139,11,15875
320752,2022-02-27,Extrema/MG,0,139,0,15875
326349,2022-02-28,Extrema/MG,0,139,0,15875
331946,2022-03-01,Extrema/MG,0,139,0,15875
337543,2022-03-02,Extrema/MG,0,139,0,15875
343140,2022-03-03,Extrema/MG,0,139,25,15900
348737,2022-03-04,Extrema/MG,0,139,2,15902
354334,2022-03-05,Extrema/MG,0,139,0,15902
359931,2022-03-06,Extrema/MG,0,139,8,15910
365528,2022-03-07,Extrema/MG,0,139,0,15910
371125,2022-03-08,Extrema/MG,0,139,8,15918
376722,2022-03-09,Extrema/MG,0,139,2,15920
382319,2022-03-10,Extrema/MG,1,140,1,15921
387916,2022-03-11,Extrema/MG,0,140,0,15921
393513,2022-03-12,Extrema/MG,0,140,0,15921
399110,2022-03-13,Extrema/MG,1,141,0,15921
404707,2022-03-14,Extrema/MG,0,141,0,15921
410304,2022-03-15,Extrema/MG,0,141,303,16224
415901,2022-03-16,Extrema/MG,0,141,0,16224
421498,2022-03-17,Extrema/MG,0,141,1,16225
427095,2022-03-18,Extrema/MG,0,141,0,16225
432692,2022-03-19,Extrema/MG,0,141,0,16225
438289,2022-03-20,Extrema/MG,0,141,0,16225
443886,2022-03-21,Extrema/MG,0,141,0,16225
449483,2022-03-22,Extrema/MG,0,141,1,16226
455080,2022-03-23,Extrema/MG,1,142,10,16236
460677,2022-03-24,Extrema/MG,0,142,0,16236
466274,2022-03-25,Extrema/MG,0,142,0,16236
471871,2022-03-26,Extrema/MG,0,142,0,16236
477468,2022-03-27,Extrema/MG,0,142,0,16236
483065,2022-03-28,Extrema/MG,0,142,0,16236
488662,2022-03-29,Extrema/MG,0,142,0,16236
494259,2022-03-30,Extrema/MG,0,142,0,16236
499856,2022-03-31,Extrema/MG,0,142,0,16236
505453,2022-04-01,Extrema/MG,0,142,0,16236
511050,2022-04-02,Extrema/MG,0,142,0,16236
516647,2022-04-03,Extrema/MG,0,142,0,16236
522244,2022-04-04,Extrema/MG,0,142,0,16236
527841,2022-04-05,Extrema/MG,0,142,0,16236
533438,2022-04-06,Extrema/MG,0,142,0,16236
539035,2022-04-07,Extrema/MG,0,142,0,16236
544632,2022-04-08,Extrema/MG,0,142,0,16236
550229,2022-04-09,Extrema/MG,0,142,0,16236
555826,2022-04-10,Extrema/MG,0,142,0,16236
561423,2022-04-11,Extrema/MG,0,142,0,16236
567020,2022-04-12,Extrema/MG,0,142,0,16236
572617,2022-04-13,Extrema/MG,0,142,0,16236
578214,2022-04-14,Extrema/MG,0,142,0,16236
583811,2022-04-15,Extrema/MG,0,142,0,16236
589408,2022-04-16,Extrema/MG,0,142,0,16236
595005,2022-04-17,Extrema/MG,0,142,0,16236
600602,2022-04-18,Extrema/MG,0,142,0,16236
606199,2022-04-19,Extrema/MG,0,142,0,16236
611796,2022-04-20,Extrema/MG,0,142,0,16236
617393,2022-04-21,Extrema/MG,0,142,0,16236
622990,2022-04-22,Extrema/MG,0,142,0,16236
628587,2022-04-23,Extrema/MG,0,142,0,16236
634184,2022-04-24,Extrema/MG,0,142,0,16236
639781,2022-04-25,Extrema/MG,0,142,0,16236
645378,2022-04-26,Extrema/MG,0,142,0,16236
650975,2022-04-27,Extrema/MG,0,142,2,16238
656572,2022-04-28,Extrema/MG,0,142,0,16238
662169,2022-04-29,Extrema/MG,0,142,0,16238
667766,2022-04-30,Extrema/MG,0,142,0,16238
673363,2022-05-01,Extrema/MG,0,142,0,16238
678960,2022-05-02,Extrema/MG,0,142,0,16238
684557,2022-05-03,Extrema/MG,0,142,2,16240
690154,2022-05-04,Extrema/MG,0,142,0,16240
695751,2022-05-05,Extrema/MG,0,142,0,16240
701348,2022-05-06,Extrema/MG,0,142,0,16240
706945,2022-05-07,Extrema/MG,0,142,0,16240
712542,2022-05-08,Extrema/MG,0,142,0,16240
718139,2022-05-09,Extrema/MG,0,142,0,16240
723736,2022-05-10,Extrema/MG,0,142,0,16240
729333,2022-05-11,Extrema/MG,0,142,3,16243
734930,2022-05-12,Extrema/MG,0,142,0,16243
740527,2022-05-13,Extrema/MG,0,142,0,16243
746124,2022-05-14,Extrema/MG,0,142,0,16243
751721,2022-05-15,Extrema/MG,0,142,0,16243
757318,2022-05-16,Extrema/MG,0,142,0,16243
762915,2022-05-17,Extrema/MG,0,142,0,16243
768512,2022-05-18,Extrema/MG,0,142,19,16262
774109,2022-05-19,Extrema/MG,0,142,15,16277
779706,2022-05-20,Extrema/MG,0,142,0,16277
785303,2022-05-21,Extrema/MG,0,142,0,16277
790900,2022-05-22,Extrema/MG,0,142,0,16277
796497,2022-05-23,Extrema/MG,0,142,25,16302
802094,2022-05-24,Extrema/MG,0,142,12,16314
807691,2022-05-25,Extrema/MG,0,142,19,16333
813288,2022-05-26,Extrema/MG,0,142,29,16362
818885,2022-05-27,Extrema/MG,0,142,0,16362
824482,2022-05-28,Extrema/MG,0,142,0,16362
830079,2022-05-29,Extrema/MG,0,142,0,16362
835676,2022-05-30,Extrema/MG,0,142,23,16385
841273,2022-05-31,Extrema/MG,0,142,41,16426
846870,2022-06-01,Extrema/MG,0,142,64,16490
852467,2022-06-02,Extrema/MG,0,142,78,16568
858064,2022-06-03,Extrema/MG,0,142,44,16612
863661,2022-06-04,Extrema/MG,0,142,0,16612
869258,2022-06-05,Extrema/MG,0,142,0,16612
874855,2022-06-06,Extrema/MG,0,142,53,16665
880452,2022-06-07,Extrema/MG,0,142,56,16721
886049,2022-06-08,Extrema/MG,0,142,51,16772
891646,2022-06-09,Extrema/MG,0,142,50,16822
897243,2022-06-10,Extrema/MG,0,142,80,16902
902840,2022-06-11,Extrema/MG,0,142,0,16902
908437,2022-06-12,Extrema/MG,0,142,0,16902
914034,2022-06-13,Extrema/MG,0,142,65,16967
919631,2022-06-14,Extrema/MG,0,142,26,16993
925228,2022-06-15,Extrema/MG,0,142,79,17072
930825,2022-06-16,Extrema/MG,0,142,0,17072
936422,2022-06-17,Extrema/MG,0,142,0,17072
942019,2022-06-18,Extrema/MG,0,142,0,17072
947616,2022-06-19,Extrema/MG,0,142,0,17072
953213,2022-06-20,Extrema/MG,0,142,62,17134
958810,2022-06-21,Extrema/MG,0,142,135,17269
964407,2022-06-22,Extrema/MG,0,142,147,17416
970004,2022-06-23,Extrema/MG,0,142,63,17479
975601,2022-06-24,Extrema/MG,0,142,76,17555
981198,2022-06-25,Extrema/MG,0,142,0,17555
986795,2022-06-26,Extrema/MG,0,142,0,17555
992392,2022-06-27,Extrema/MG,0,142,43,17598
997989,2022-06-28,Extrema/MG,0,142,52,17650
1003586,2022-06-29,Extrema/MG,0,142,103,17753
1009183,2022-06-30,Extrema/MG,0,142,35,17788
1014780,2022-07-01,Extrema/MG,0,142,0,17788
1020377,2022-07-02,Extrema/MG,0,142,0,17788
1025974,2022-07-03,Extrema/MG,0,142,0,17788
1031571,2022-07-04,Extrema/MG,0,142,50,17838
1037168,2022-07-05,Extrema/MG,0,142,79,17917
1042765,2022-07-06,Extrema/MG,0,142,22,17939
1048362,2022-07-07,Extrema/MG,0,142,0,17939
1053959,2022-07-08,Extrema/MG,0,142,60,17999
1059556,2022-07-09,Extrema/MG,0,142,0,17999
1065153,2022-07-10,Extrema/MG,0,142,0,17999
1070750,2022-07-11,Extrema/MG,0,142,32,18031
1076347,2022-07-12,Extrema/MG,1,143,44,18075
1081944,2022-07-13,Extrema/MG,0,143,34,18109
1087541,2022-07-14,Extrema/MG,0,143,0,18109
1093138,2022-07-15,Extrema/MG,0,143,53,18162
1098735,2022-07-16,Extrema/MG,0,143,0,18162
1104332,2022-07-17,Extrema/MG,0,143,0,18162
1109929,2022-07-18,Extrema/MG,0,143,11,18173
1115526,2022-07-19,Extrema/MG,0,143,43,18216
1121123,2022-07-20,Extrema/MG,1,144,8,18224
1126720,2022-07-21,Extrema/MG,0,144,0,18224
1132317,2022-07-22,Extrema/MG,0,144,11,18235
1137914,2022-07-23,Extrema/MG,0,144,0,18235
1143511,2022-07-24,Extrema/MG,0,144,0,18235
1149108,2022-07-25,Extrema/MG,0,144,0,18235
1154705,2022-07-26,Extrema/MG,0,144,32,18267
1160302,2022-07-27,Extrema/MG,0,144,16,18283
1165899,2022-07-28,Extrema/MG,0,144,6,18289
1171496,2022-07-29,Extrema/MG,0,144,3,18292
1177093,2022-07-30,Extrema/MG,0,144,0,18292
1182690,2022-07-31,Extrema/MG,0,144,0,18292
1188287,2022-08-01,Extrema/MG,0,144,6,18298
1193884,2022-08-02,Extrema/MG,1,145,6,18304
1199481,2022-08-03,Extrema/MG,0,145,2,18306
1205078,2022-08-04,Extrema/MG,0,145,0,18306
1210675,2022-08-05,Extrema/MG,0,145,1,18307
1216272,2022-08-06,Extrema/MG,0,145,0,18307
1221869,2022-08-07,Extrema/MG,0,145,0,18307
1227466,2022-08-08,Extrema/MG,0,145,2,18309
1233063,2022-08-09,Extrema/MG,0,145,0,18309
1238660,2022-08-10,Extrema/MG,0,145,4,18313
1244257,2022-08-11,Extrema/MG,0,145,0,18313
1249854,2022-08-12,Extrema/MG,0,145,0,18313
1255451,2022-08-13,Extrema/MG,0,145,0,18313
1261048,2022-08-14,Extrema/MG,0,145,0,18313
1266645,2022-08-15,Extrema/MG,0,145,0,18313
1272242,2022-08-16,Extrema/MG,0,145,3,18316
1277839,2022-08-17,Extrema/MG,0,145,0,18316
1283436,2022-08-18,Extrema/MG,0,145,2,18318
1289033,2022-08-19,Extrema/MG,0,145,1,18319
1294630,2022-08-20,Extrema/MG,0,145,0,18319
1300227,2022-08-21,Extrema/MG,0,145,0,18319
1305824,2022-08-22,Extrema/MG,0,145,3,18322
1311421,2022-08-23,Extrema/MG,0,145,2,18324
1317018,2022-08-24,Extrema/MG,0,145,0,18324
1322615,2022-08-25,Extrema/MG,0,145,0,18324
1729,2022-01-01,Fama/MG,0,1,0,143
7326,2022-01-02,Fama/MG,0,1,0,143
12923,2022-01-03,Fama/MG,0,1,0,143
18520,2022-01-04,Fama/MG,0,1,0,143
24117,2022-01-05,Fama/MG,0,1,0,143
29714,2022-01-06,Fama/MG,0,1,0,143
35311,2022-01-07,Fama/MG,0,1,2,145
40908,2022-01-08,Fama/MG,0,1,0,145
46505,2022-01-09,Fama/MG,0,1,0,145
52102,2022-01-10,Fama/MG,0,1,0,145
57699,2022-01-11,Fama/MG,0,1,0,145
63296,2022-01-12,Fama/MG,0,1,20,165
68893,2022-01-13,Fama/MG,0,1,0,165
74490,2022-01-14,Fama/MG,0,1,0,165
80087,2022-01-15,Fama/MG,0,1,0,165
85684,2022-01-16,Fama/MG,0,1,0,165
91281,2022-01-17,Fama/MG,0,1,0,165
96878,2022-01-18,Fama/MG,0,1,0,165
102475,2022-01-19,Fama/MG,0,1,19,184
108072,2022-01-20,Fama/MG,0,1,0,184
113669,2022-01-21,Fama/MG,0,1,0,184
119266,2022-01-22,Fama/MG,0,1,0,184
124863,2022-01-23,Fama/MG,0,1,0,184
130460,2022-01-24,Fama/MG,0,1,0,184
136057,2022-01-25,Fama/MG,0,1,0,184
141654,2022-01-26,Fama/MG,0,1,0,184
147251,2022-01-27,Fama/MG,0,1,0,184
152848,2022-01-28,Fama/MG,0,1,0,184
158445,2022-01-29,Fama/MG,0,1,0,184
164042,2022-01-30,Fama/MG,0,1,0,184
169639,2022-01-31,Fama/MG,0,1,0,184
175236,2022-02-01,Fama/MG,0,1,141,325
180833,2022-02-02,Fama/MG,0,1,1,326
186430,2022-02-03,Fama/MG,0,1,1,327
192027,2022-02-04,Fama/MG,0,1,0,327
197624,2022-02-05,Fama/MG,0,1,12,339
203221,2022-02-06,Fama/MG,0,1,0,339
208818,2022-02-07,Fama/MG,0,1,0,339
214415,2022-02-08,Fama/MG,0,1,0,339
220012,2022-02-09,Fama/MG,0,1,4,343
225609,2022-02-10,Fama/MG,0,1,3,346
231206,2022-02-11,Fama/MG,0,1,0,346
236803,2022-02-12,Fama/MG,0,1,13,359
242400,2022-02-13,Fama/MG,0,1,0,359
247997,2022-02-14,Fama/MG,0,1,0,359
253594,2022-02-15,Fama/MG,0,1,6,365
259191,2022-02-16,Fama/MG,0,1,0,365
264788,2022-02-17,Fama/MG,0,1,6,371
270385,2022-02-18,Fama/MG,0,1,4,375
275982,2022-02-19,Fama/MG,0,1,0,375
281579,2022-02-20,Fama/MG,0,1,0,375
287176,2022-02-21,Fama/MG,0,1,0,375
292773,2022-02-22,Fama/MG,0,1,0,375
298370,2022-02-23,Fama/MG,0,1,0,375
303967,2022-02-24,Fama/MG,0,1,5,380
309564,2022-02-25,Fama/MG,0,1,0,380
315161,2022-02-26,Fama/MG,0,1,0,380
320758,2022-02-27,Fama/MG,0,1,12,392
326355,2022-02-28,Fama/MG,0,1,0,392
331952,2022-03-01,Fama/MG,0,1,0,392
337549,2022-03-02,Fama/MG,0,1,0,392
343146,2022-03-03,Fama/MG,0,1,0,392
348743,2022-03-04,Fama/MG,0,1,4,396
354340,2022-03-05,Fama/MG,0,1,0,396
359937,2022-03-06,Fama/MG,0,1,0,396
365534,2022-03-07,Fama/MG,0,1,0,396
371131,2022-03-08,Fama/MG,0,1,0,396
376728,2022-03-09,Fama/MG,0,1,17,413
382325,2022-03-10,Fama/MG,0,1,0,413
387922,2022-03-11,Fama/MG,0,1,0,413
393519,2022-03-12,Fama/MG,0,1,8,421
399116,2022-03-13,Fama/MG,0,1,0,421
404713,2022-03-14,Fama/MG,0,1,0,421
410310,2022-03-15,Fama/MG,0,1,0,421
415907,2022-03-16,Fama/MG,0,1,7,428
421504,2022-03-17,Fama/MG,0,1,0,428
427101,2022-03-18,Fama/MG,0,1,0,428
432698,2022-03-19,Fama/MG,0,1,0,428
438295,2022-03-20,Fama/MG,0,1,0,428
443892,2022-03-21,Fama/MG,0,1,0,428
449489,2022-03-22,Fama/MG,0,1,26,454
455086,2022-03-23,Fama/MG,0,1,0,454
460683,2022-03-24,Fama/MG,0,1,1,455
466280,2022-03-25,Fama/MG,0,1,0,455
471877,2022-03-26,Fama/MG,0,1,0,455
477474,2022-03-27,Fama/MG,0,1,0,455
483071,2022-03-28,Fama/MG,0,1,0,455
488668,2022-03-29,Fama/MG,0,1,2,457
494265,2022-03-30,Fama/MG,0,1,0,457
499862,2022-03-31,Fama/MG,0,1,0,457
505459,2022-04-01,Fama/MG,0,1,0,457
511056,2022-04-02,Fama/MG,0,1,0,457
516653,2022-04-03,Fama/MG,0,1,0,457
522250,2022-04-04,Fama/MG,0,1,0,457
527847,2022-04-05,Fama/MG,0,1,0,457
533444,2022-04-06,Fama/MG,0,1,0,457
539041,2022-04-07,Fama/MG,0,1,0,457
544638,2022-04-08,Fama/MG,0,1,0,457
550235,2022-04-09,Fama/MG,0,1,0,457
555832,2022-04-10,Fama/MG,0,1,0,457
561429,2022-04-11,Fama/MG,0,1,0,457
567026,2022-04-12,Fama/MG,0,1,0,457
572623,2022-04-13,Fama/MG,0,1,0,457
578220,2022-04-14,Fama/MG,0,1,0,457
583817,2022-04-15,Fama/MG,0,1,0,457
589414,2022-04-16,Fama/MG,0,1,0,457
595011,2022-04-17,Fama/MG,0,1,0,457
600608,2022-04-18,Fama/MG,0,1,0,457
606205,2022-04-19,Fama/MG,0,1,0,457
611802,2022-04-20,Fama/MG,0,1,0,457
617399,2022-04-21,Fama/MG,0,1,0,457
622996,2022-04-22,Fama/MG,0,1,0,457
628593,2022-04-23,Fama/MG,0,1,0,457
634190,2022-04-24,Fama/MG,0,1,0,457
639787,2022-04-25,Fama/MG,0,1,0,457
645384,2022-04-26,Fama/MG,0,1,0,457
650981,2022-04-27,Fama/MG,0,1,0,457
656578,2022-04-28,Fama/MG,0,1,0,457
662175,2022-04-29,Fama/MG,0,1,0,457
667772,2022-04-30,Fama/MG,0,1,72,529
673369,2022-05-01,Fama/MG,0,1,0,529
678966,2022-05-02,Fama/MG,0,1,0,529
684563,2022-05-03,Fama/MG,0,1,0,529
690160,2022-05-04,Fama/MG,0,1,0,529
695757,2022-05-05,Fama/MG,0,1,0,529
701354,2022-05-06,Fama/MG,0,1,0,529
706951,2022-05-07,Fama/MG,0,1,0,529
712548,2022-05-08,Fama/MG,0,1,0,529
718145,2022-05-09,Fama/MG,0,1,0,529
723742,2022-05-10,Fama/MG,0,1,0,529
729339,2022-05-11,Fama/MG,0,1,0,529
734936,2022-05-12,Fama/MG,0,1,0,529
740533,2022-05-13,Fama/MG,0,1,0,529
746130,2022-05-14,Fama/MG,0,1,0,529
751727,2022-05-15,Fama/MG,0,1,0,529
757324,2022-05-16,Fama/MG,0,1,0,529
762921,2022-05-17,Fama/MG,0,1,0,529
768518,2022-05-18,Fama/MG,0,1,0,529
774115,2022-05-19,Fama/MG,0,1,0,529
779712,2022-05-20,Fama/MG,0,1,0,529
785309,2022-05-21,Fama/MG,0,1,0,529
790906,2022-05-22,Fama/MG,0,1,0,529
796503,2022-05-23,Fama/MG,0,1,0,529
802100,2022-05-24,Fama/MG,0,1,0,529
807697,2022-05-25,Fama/MG,0,1,0,529
813294,2022-05-26,Fama/MG,0,1,0,529
818891,2022-05-27,Fama/MG,0,1,0,529
824488,2022-05-28,Fama/MG,0,1,0,529
830085,2022-05-29,Fama/MG,0,1,0,529
835682,2022-05-30,Fama/MG,0,1,0,529
841279,2022-05-31,Fama/MG,0,1,0,529
846876,2022-06-01,Fama/MG,0,1,0,529
852473,2022-06-02,Fama/MG,0,1,0,529
858070,2022-06-03,Fama/MG,0,1,0,529
863667,2022-06-04,Fama/MG,0,1,0,529
869264,2022-06-05,Fama/MG,0,1,0,529
874861,2022-06-06,Fama/MG,0,1,0,529
880458,2022-06-07,Fama/MG,0,1,0,529
886055,2022-06-08,Fama/MG,0,1,0,529
891652,2022-06-09,Fama/MG,0,1,80,609
897249,2022-06-10,Fama/MG,0,1,0,609
902846,2022-06-11,Fama/MG,0,1,0,609
908443,2022-06-12,Fama/MG,0,1,0,609
914040,2022-06-13,Fama/MG,0,1,0,609
919637,2022-06-14,Fama/MG,0,1,0,609
925234,2022-06-15,Fama/MG,0,1,0,609
930831,2022-06-16,Fama/MG,0,1,0,609
936428,2022-06-17,Fama/MG,0,1,0,609
942025,2022-06-18,Fama/MG,0,1,0,609
947622,2022-06-19,Fama/MG,0,1,0,609
953219,2022-06-20,Fama/MG,0,1,0,609
958816,2022-06-21,Fama/MG,0,1,0,609
964413,2022-06-22,Fama/MG,0,1,0,609
970010,2022-06-23,Fama/MG,0,1,66,675
975607,2022-06-24,Fama/MG,0,1,0,675
981204,2022-06-25,Fama/MG,0,1,0,675
986801,2022-06-26,Fama/MG,0,1,0,675
992398,2022-06-27,Fama/MG,0,1,0,675
997995,2022-06-28,Fama/MG,0,1,0,675
1003592,2022-06-29,Fama/MG,0,1,0,675
1009189,2022-06-30,Fama/MG,0,1,0,675
1014786,2022-07-01,Fama/MG,0,1,0,675
1020383,2022-07-02,Fama/MG,0,1,0,675
1025980,2022-07-03,Fama/MG,0,1,0,675
1031577,2022-07-04,Fama/MG,0,1,21,696
1037174,2022-07-05,Fama/MG,0,1,0,696
1042771,2022-07-06,Fama/MG,0,1,0,696
1048368,2022-07-07,Fama/MG,0,1,0,696
1053965,2022-07-08,Fama/MG,0,1,0,696
1059562,2022-07-09,Fama/MG,0,1,0,696
1065159,2022-07-10,Fama/MG,0,1,0,696
1070756,2022-07-11,Fama/MG,0,1,0,696
1076353,2022-07-12,Fama/MG,0,1,0,696
1081950,2022-07-13,Fama/MG,0,1,5,701
1087547,2022-07-14,Fama/MG,0,1,0,701
1093144,2022-07-15,Fama/MG,0,1,1,702
1098741,2022-07-16,Fama/MG,0,1,0,702
1104338,2022-07-17,Fama/MG,0,1,0,702
1109935,2022-07-18,Fama/MG,0,1,0,702
1115532,2022-07-19,Fama/MG,0,1,0,702
1121129,2022-07-20,Fama/MG,0,1,0,702
1126726,2022-07-21,Fama/MG,0,1,0,702
1132323,2022-07-22,Fama/MG,0,1,0,702
1137920,2022-07-23,Fama/MG,0,1,0,702
1143517,2022-07-24,Fama/MG,0,1,0,702
1149114,2022-07-25,Fama/MG,0,1,11,713
1154711,2022-07-26,Fama/MG,0,1,0,713
1160308,2022-07-27,Fama/MG,0,1,0,713
1165905,2022-07-28,Fama/MG,0,1,0,713
1171502,2022-07-29,Fama/MG,0,1,0,713
1177099,2022-07-30,Fama/MG,0,1,0,713
1182696,2022-07-31,Fama/MG,0,1,0,713
1188293,2022-08-01,Fama/MG,0,1,0,713
1193890,2022-08-02,Fama/MG,0,1,0,713
1199487,2022-08-03,Fama/MG,0,1,0,713
1205084,2022-08-04,Fama/MG,0,1,0,713
1210681,2022-08-05,Fama/MG,0,1,28,741
1216278,2022-08-06,Fama/MG,0,1,0,741
1221875,2022-08-07,Fama/MG,0,1,0,741
1227472,2022-08-08,Fama/MG,0,1,0,741
1233069,2022-08-09,Fama/MG,0,1,0,741
1238666,2022-08-10,Fama/MG,0,1,0,741
1244263,2022-08-11,Fama/MG,0,1,0,741
1249860,2022-08-12,Fama/MG,0,1,0,741
1255457,2022-08-13,Fama/MG,0,1,0,741
1261054,2022-08-14,Fama/MG,0,1,0,741
1266651,2022-08-15,Fama/MG,0,1,0,741
1272248,2022-08-16,Fama/MG,0,1,0,741
1277845,2022-08-17,Fama/MG,0,1,0,741
1283442,2022-08-18,Fama/MG,0,1,0,741
1289039,2022-08-19,Fama/MG,0,1,0,741
1294636,2022-08-20,Fama/MG,0,1,0,741
1300233,2022-08-21,Fama/MG,0,1,0,741
1305830,2022-08-22,Fama/MG,0,1,0,741
1311427,2022-08-23,Fama/MG,0,1,0,741
1317024,2022-08-24,Fama/MG,0,1,0,741
1322621,2022-08-25,Fama/MG,0,1,3,744
2024,2022-01-01,Guaxupé/MG,0,159,0,6695
7621,2022-01-02,Guaxupé/MG,0,159,0,6695
13218,2022-01-03,Guaxupé/MG,0,159,0,6695
18815,2022-01-04,Guaxupé/MG,0,159,0,6695
24412,2022-01-05,Guaxupé/MG,0,159,273,6968
30009,2022-01-06,Guaxupé/MG,0,159,0,6968
35606,2022-01-07,Guaxupé/MG,0,159,178,7146
41203,2022-01-08,Guaxupé/MG,0,159,119,7265
46800,2022-01-09,Guaxupé/MG,0,159,115,7380
52397,2022-01-10,Guaxupé/MG,0,159,119,7499
57994,2022-01-11,Guaxupé/MG,0,159,0,7499
63591,2022-01-12,Guaxupé/MG,0,159,123,7622
69188,2022-01-13,Guaxupé/MG,0,159,117,7739
74785,2022-01-14,Guaxupé/MG,0,159,112,7851
80382,2022-01-15,Guaxupé/MG,0,159,281,8132
85979,2022-01-16,Guaxupé/MG,0,159,0,8132
91576,2022-01-17,Guaxupé/MG,1,160,361,8493
97173,2022-01-18,Guaxupé/MG,0,160,130,8623
102770,2022-01-19,Guaxupé/MG,1,161,148,8771
108367,2022-01-20,Guaxupé/MG,0,161,179,8950
113964,2022-01-21,Guaxupé/MG,0,161,169,9119
119561,2022-01-22,Guaxupé/MG,0,161,162,9281
125158,2022-01-23,Guaxupé/MG,0,161,0,9281
130755,2022-01-24,Guaxupé/MG,0,161,335,9616
136352,2022-01-25,Guaxupé/MG,0,161,42,9658
141949,2022-01-26,Guaxupé/MG,0,161,128,9786
147546,2022-01-27,Guaxupé/MG,2,163,183,9969
153143,2022-01-28,Guaxupé/MG,0,163,168,10137
158740,2022-01-29,Guaxupé/MG,0,163,130,10267
164337,2022-01-30,Guaxupé/MG,1,164,185,10452
169934,2022-01-31,Guaxupé/MG,0,164,37,10489
175531,2022-02-01,Guaxupé/MG,0,164,0,10489
181128,2022-02-02,Guaxupé/MG,1,165,203,10692
186725,2022-02-03,Guaxupé/MG,1,166,150,10842
192322,2022-02-04,Guaxupé/MG,0,166,114,10956
197919,2022-02-05,Guaxupé/MG,0,166,103,11059
203516,2022-02-06,Guaxupé/MG,0,166,121,11180
209113,2022-02-07,Guaxupé/MG,0,166,50,11230
214710,2022-02-08,Guaxupé/MG,0,166,28,11258
220307,2022-02-09,Guaxupé/MG,0,166,79,11337
225904,2022-02-10,Guaxupé/MG,1,167,103,11440
231501,2022-02-11,Guaxupé/MG,0,167,93,11533
237098,2022-02-12,Guaxupé/MG,0,167,36,11569
242695,2022-02-13,Guaxupé/MG,0,167,94,11663
248292,2022-02-14,Guaxupé/MG,0,167,0,11663
253889,2022-02-15,Guaxupé/MG,0,167,55,11718
259486,2022-02-16,Guaxupé/MG,0,167,76,11794
265083,2022-02-17,Guaxupé/MG,-1,166,66,11860
270680,2022-02-18,Guaxupé/MG,0,166,59,11919
276277,2022-02-19,Guaxupé/MG,2,168,37,11956
281874,2022-02-20,Guaxupé/MG,1,169,52,12008
287471,2022-02-21,Guaxupé/MG,0,169,24,12032
293068,2022-02-22,Guaxupé/MG,0,169,21,12053
298665,2022-02-23,Guaxupé/MG,0,169,47,12100
304262,2022-02-24,Guaxupé/MG,0,169,19,12119
309859,2022-02-25,Guaxupé/MG,0,169,34,12153
315456,2022-02-26,Guaxupé/MG,0,169,33,12186
321053,2022-02-27,Guaxupé/MG,0,169,25,12211
326650,2022-02-28,Guaxupé/MG,0,169,0,12211
332247,2022-03-01,Guaxupé/MG,0,169,29,12240
337844,2022-03-02,Guaxupé/MG,0,169,0,12240
343441,2022-03-03,Guaxupé/MG,0,169,0,12240
349038,2022-03-04,Guaxupé/MG,0,169,32,12272
354635,2022-03-05,Guaxupé/MG,0,169,0,12272
360232,2022-03-06,Guaxupé/MG,0,169,26,12298
365829,2022-03-07,Guaxupé/MG,0,169,0,12298
371426,2022-03-08,Guaxupé/MG,0,169,10027,22325
377023,2022-03-09,Guaxupé/MG,0,169,-9985,12340
382620,2022-03-10,Guaxupé/MG,0,169,13,12353
388217,2022-03-11,Guaxupé/MG,3,172,17,12370
393814,2022-03-12,Guaxupé/MG,1,173,13,12383
399411,2022-03-13,Guaxupé/MG,0,173,7,12390
405008,2022-03-14,Guaxupé/MG,0,173,3,12393
410605,2022-03-15,Guaxupé/MG,0,173,0,12393
416202,2022-03-16,Guaxupé/MG,0,173,18,12411
421799,2022-03-17,Guaxupé/MG,1,174,6,12417
427396,2022-03-18,Guaxupé/MG,0,174,8,12425
432993,2022-03-19,Guaxupé/MG,0,174,4,12429
438590,2022-03-20,Guaxupé/MG,0,174,0,12429
444187,2022-03-21,Guaxupé/MG,0,174,15,12444
449784,2022-03-22,Guaxupé/MG,0,174,0,12444
455381,2022-03-23,Guaxupé/MG,0,174,0,12444
460978,2022-03-24,Guaxupé/MG,0,174,12,12456
466575,2022-03-25,Guaxupé/MG,0,174,0,12456
472172,2022-03-26,Guaxupé/MG,0,174,14,12470
477769,2022-03-27,Guaxupé/MG,0,174,2,12472
483366,2022-03-28,Guaxupé/MG,0,174,0,12472
488963,2022-03-29,Guaxupé/MG,0,174,0,12472
494560,2022-03-30,Guaxupé/MG,0,174,12,12484
500157,2022-03-31,Guaxupé/MG,0,174,2,12486
505754,2022-04-01,Guaxupé/MG,0,174,1,12487
511351,2022-04-02,Guaxupé/MG,0,174,0,12487
516948,2022-04-03,Guaxupé/MG,0,174,0,12487
522545,2022-04-04,Guaxupé/MG,0,174,8,12495
528142,2022-04-05,Guaxupé/MG,0,174,0,12495
533739,2022-04-06,Guaxupé/MG,0,174,1,12496
539336,2022-04-07,Guaxupé/MG,0,174,4,12500
544933,2022-04-08,Guaxupé/MG,0,174,2,12502
550530,2022-04-09,Guaxupé/MG,0,174,2,12504
556127,2022-04-10,Guaxupé/MG,0,174,4,12508
561724,2022-04-11,Guaxupé/MG,0,174,0,12508
567321,2022-04-12,Guaxupé/MG,0,174,0,12508
572918,2022-04-13,Guaxupé/MG,0,174,0,12508
578515,2022-04-14,Guaxupé/MG,0,174,7,12515
584112,2022-04-15,Guaxupé/MG,0,174,3,12518
589709,2022-04-16,Guaxupé/MG,1,175,0,12518
595306,2022-04-17,Guaxupé/MG,0,175,4,12522
600903,2022-04-18,Guaxupé/MG,0,175,0,12522
606500,2022-04-19,Guaxupé/MG,0,175,0,12522
612097,2022-04-20,Guaxupé/MG,0,175,7,12529
617694,2022-04-21,Guaxupé/MG,0,175,2,12531
623291,2022-04-22,Guaxupé/MG,0,175,4,12535
628888,2022-04-23,Guaxupé/MG,0,175,0,12535
634485,2022-04-24,Guaxupé/MG,0,175,0,12535
640082,2022-04-25,Guaxupé/MG,0,175,0,12535
645679,2022-04-26,Guaxupé/MG,0,175,0,12535
651276,2022-04-27,Guaxupé/MG,0,175,0,12535
656873,2022-04-28,Guaxupé/MG,0,175,8,12543
662470,2022-04-29,Guaxupé/MG,0,175,13,12556
668067,2022-04-30,Guaxupé/MG,0,175,5,12561
673664,2022-05-01,Guaxupé/MG,0,175,9,12570
679261,2022-05-02,Guaxupé/MG,0,175,0,12570
684858,2022-05-03,Guaxupé/MG,0,175,0,12570
690455,2022-05-04,Guaxupé/MG,0,175,0,12570
696052,2022-05-05,Guaxupé/MG,0,175,0,12570
701649,2022-05-06,Guaxupé/MG,0,175,0,12570
707246,2022-05-07,Guaxupé/MG,0,175,0,12570
712843,2022-05-08,Guaxupé/MG,0,175,0,12570
718440,2022-05-09,Guaxupé/MG,0,175,0,12570
724037,2022-05-10,Guaxupé/MG,0,175,0,12570
729634,2022-05-11,Guaxupé/MG,0,175,114,12684
735231,2022-05-12,Guaxupé/MG,0,175,-9,12675
740828,2022-05-13,Guaxupé/MG,0,175,26,12701
746425,2022-05-14,Guaxupé/MG,0,175,0,12701
752022,2022-05-15,Guaxupé/MG,0,175,0,12701
757619,2022-05-16,Guaxupé/MG,0,175,62,12763
763216,2022-05-17,Guaxupé/MG,0,175,0,12763
768813,2022-05-18,Guaxupé/MG,0,175,38,12801
774410,2022-05-19,Guaxupé/MG,0,175,45,12846
780007,2022-05-20,Guaxupé/MG,0,175,0,12846
785604,2022-05-21,Guaxupé/MG,0,175,0,12846
791201,2022-05-22,Guaxupé/MG,0,175,0,12846
796798,2022-05-23,Guaxupé/MG,0,175,113,12959
802395,2022-05-24,Guaxupé/MG,0,175,0,12959
807992,2022-05-25,Guaxupé/MG,0,175,90,13049
813589,2022-05-26,Guaxupé/MG,0,175,95,13144
819186,2022-05-27,Guaxupé/MG,0,175,47,13191
824783,2022-05-28,Guaxupé/MG,0,175,0,13191
830380,2022-05-29,Guaxupé/MG,0,175,0,13191
835977,2022-05-30,Guaxupé/MG,0,175,202,13393
841574,2022-05-31,Guaxupé/MG,0,175,0,13393
847171,2022-06-01,Guaxupé/MG,0,175,207,13600
852768,2022-06-02,Guaxupé/MG,0,175,84,13684
858365,2022-06-03,Guaxupé/MG,0,175,56,13740
863962,2022-06-04,Guaxupé/MG,0,175,0,13740
869559,2022-06-05,Guaxupé/MG,0,175,0,13740
875156,2022-06-06,Guaxupé/MG,0,175,244,13984
880753,2022-06-07,Guaxupé/MG,0,175,0,13984
886350,2022-06-08,Guaxupé/MG,2,177,195,14179
891947,2022-06-09,Guaxupé/MG,0,177,139,14318
897544,2022-06-10,Guaxupé/MG,1,178,88,14406
903141,2022-06-11,Guaxupé/MG,0,178,0,14406
908738,2022-06-12,Guaxupé/MG,0,178,0,14406
914335,2022-06-13,Guaxupé/MG,0,178,140,14546
919932,2022-06-14,Guaxupé/MG,0,178,0,14546
925529,2022-06-15,Guaxupé/MG,0,178,106,14652
931126,2022-06-16,Guaxupé/MG,0,178,0,14652
936723,2022-06-17,Guaxupé/MG,0,178,0,14652
942320,2022-06-18,Guaxupé/MG,0,178,0,14652
947917,2022-06-19,Guaxupé/MG,0,178,0,14652
953514,2022-06-20,Guaxupé/MG,0,178,97,14749
959111,2022-06-21,Guaxupé/MG,0,178,0,14749
964708,2022-06-22,Guaxupé/MG,0,178,0,14749
970305,2022-06-23,Guaxupé/MG,0,178,199,14948
975902,2022-06-24,Guaxupé/MG,0,178,45,14993
981499,2022-06-25,Guaxupé/MG,0,178,0,14993
987096,2022-06-26,Guaxupé/MG,0,178,0,14993
992693,2022-06-27,Guaxupé/MG,1,179,95,15088
998290,2022-06-28,Guaxupé/MG,0,179,0,15088
1003887,2022-06-29,Guaxupé/MG,0,179,37,15125
1009484,2022-06-30,Guaxupé/MG,0,179,39,15164
1015081,2022-07-01,Guaxupé/MG,0,179,48,15212
1020678,2022-07-02,Guaxupé/MG,0,179,0,15212
1026275,2022-07-03,Guaxupé/MG,0,179,0,15212
1031872,2022-07-04,Guaxupé/MG,1,180,122,15334
1037469,2022-07-05,Guaxupé/MG,1,181,0,15334
1043066,2022-07-06,Guaxupé/MG,1,182,90,15424
1048663,2022-07-07,Guaxupé/MG,0,182,28,15452
1054260,2022-07-08,Guaxupé/MG,0,182,39,15491
1059857,2022-07-09,Guaxupé/MG,0,182,0,15491
1065454,2022-07-10,Guaxupé/MG,0,182,0,15491
1071051,2022-07-11,Guaxupé/MG,0,182,102,15593
1076648,2022-07-12,Guaxupé/MG,1,183,0,15593
1082245,2022-07-13,Guaxupé/MG,0,183,57,15650
1087842,2022-07-14,Guaxupé/MG,1,184,11,15661
1093439,2022-07-15,Guaxupé/MG,0,184,40,15701
1099036,2022-07-16,Guaxupé/MG,0,184,0,15701
1104633,2022-07-17,Guaxupé/MG,0,184,0,15701
1110230,2022-07-18,Guaxupé/MG,0,184,65,15766
1115827,2022-07-19,Guaxupé/MG,0,184,0,15766
1121424,2022-07-20,Guaxupé/MG,0,184,42,15808
1127021,2022-07-21,Guaxupé/MG,0,184,24,15832
1132618,2022-07-22,Guaxupé/MG,0,184,0,15832
1138215,2022-07-23,Guaxupé/MG,0,184,0,15832
1143812,2022-07-24,Guaxupé/MG,0,184,0,15832
1149409,2022-07-25,Guaxupé/MG,1,185,98,15930
1155006,2022-07-26,Guaxupé/MG,0,185,0,15930
1160603,2022-07-27,Guaxupé/MG,0,185,57,15987
1166200,2022-07-28,Guaxupé/MG,0,185,13,16000
1171797,2022-07-29,Guaxupé/MG,0,185,31,16031
1177394,2022-07-30,Guaxupé/MG,0,185,0,16031
1182991,2022-07-31,Guaxupé/MG,0,185,0,16031
1188588,2022-08-01,Guaxupé/MG,0,185,30,16061
1194185,2022-08-02,Guaxupé/MG,0,185,0,16061
1199782,2022-08-03,Guaxupé/MG,0,185,27,16088
1205379,2022-08-04,Guaxupé/MG,0,185,6,16094
1210976,2022-08-05,Guaxupé/MG,0,185,5,16099
1216573,2022-08-06,Guaxupé/MG,0,185,0,16099
1222170,2022-08-07,Guaxupé/MG,0,185,0,16099
1227767,2022-08-08,Guaxupé/MG,0,185,25,16124
1233364,2022-08-09,Guaxupé/MG,0,185,0,16124
1238961,2022-08-10,Guaxupé/MG,0,185,23,16147
1244558,2022-08-11,Guaxupé/MG,0,185,16,16163
1250155,2022-08-12,Guaxupé/MG,0,185,22,16185
1255752,2022-08-13,Guaxupé/MG,0,185,0,16185
1261349,2022-08-14,Guaxupé/MG,0,185,0,16185
1266946,2022-08-15,Guaxupé/MG,0,185,0,16185
1272543,2022-08-16,Guaxupé/MG,0,185,22,16207
1278140,2022-08-17,Guaxupé/MG,0,185,7,16214
1283737,2022-08-18,Guaxupé/MG,0,185,14,16228
1289334,2022-08-19,Guaxupé/MG,0,185,14,16242
1294931,2022-08-20,Guaxupé/MG,0,185,0,16242
1300528,2022-08-21,Guaxupé/MG,0,185,0,16242
1306125,2022-08-22,Guaxupé/MG,0,185,19,16261
1311722,2022-08-23,Guaxupé/MG,0,185,0,16261
1317319,2022-08-24,Guaxupé/MG,0,185,25,16286
1322916,2022-08-25,Guaxupé/MG,0,185,12,16298
2162,2022-01-01,Ilicínea/MG,0,29,1,805
7759,2022-01-02,Ilicínea/MG,0,29,0,805
13356,2022-01-03,Ilicínea/MG,0,29,1,806
18953,2022-01-04,Ilicínea/MG,0,29,1,807
24550,2022-01-05,Ilicínea/MG,0,29,7,814
30147,2022-01-06,Ilicínea/MG,0,29,1,815
35744,2022-01-07,Ilicínea/MG,0,29,15,830
41341,2022-01-08,Ilicínea/MG,0,29,28,858
46938,2022-01-09,Ilicínea/MG,0,29,0,858
52535,2022-01-10,Ilicínea/MG,0,29,35,893
58132,2022-01-11,Ilicínea/MG,0,29,2,895
63729,2022-01-12,Ilicínea/MG,0,29,30,925
69326,2022-01-13,Ilicínea/MG,0,29,26,951
74923,2022-01-14,Ilicínea/MG,0,29,25,976
80520,2022-01-15,Ilicínea/MG,0,29,27,1003
86117,2022-01-16,Ilicínea/MG,0,29,0,1003
91714,2022-01-17,Ilicínea/MG,0,29,42,1045
97311,2022-01-18,Ilicínea/MG,0,29,0,1045
102908,2022-01-19,Ilicínea/MG,0,29,5,1050
108505,2022-01-20,Ilicínea/MG,0,29,11,1061
114102,2022-01-21,Ilicínea/MG,0,29,30,1091
119699,2022-01-22,Ilicínea/MG,1,30,19,1110
125296,2022-01-23,Ilicínea/MG,0,30,0,1110
130893,2022-01-24,Ilicínea/MG,0,30,44,1154
136490,2022-01-25,Ilicínea/MG,0,30,0,1154
142087,2022-01-26,Ilicínea/MG,0,30,26,1180
147684,2022-01-27,Ilicínea/MG,0,30,0,1180
153281,2022-01-28,Ilicínea/MG,0,30,25,1205
158878,2022-01-29,Ilicínea/MG,0,30,12,1217
164475,2022-01-30,Ilicínea/MG,0,30,27,1244
170072,2022-01-31,Ilicínea/MG,0,30,23,1267
175669,2022-02-01,Ilicínea/MG,0,30,0,1267
181266,2022-02-02,Ilicínea/MG,0,30,0,1267
186863,2022-02-03,Ilicínea/MG,0,30,65,1332
192460,2022-02-04,Ilicínea/MG,0,30,0,1332
198057,2022-02-05,Ilicínea/MG,0,30,44,1376
203654,2022-02-06,Ilicínea/MG,0,30,33,1409
209251,2022-02-07,Ilicínea/MG,0,30,17,1426
214848,2022-02-08,Ilicínea/MG,0,30,13,1439
220445,2022-02-09,Ilicínea/MG,0,30,41,1480
226042,2022-02-10,Ilicínea/MG,0,30,0,1480
231639,2022-02-11,Ilicínea/MG,0,30,0,1480
237236,2022-02-12,Ilicínea/MG,0,30,111,1591
242833,2022-02-13,Ilicínea/MG,0,30,46,1637
248430,2022-02-14,Ilicínea/MG,0,30,34,1671
254027,2022-02-15,Ilicínea/MG,0,30,16,1687
259624,2022-02-16,Ilicínea/MG,0,30,22,1709
265221,2022-02-17,Ilicínea/MG,0,30,43,1752
270818,2022-02-18,Ilicínea/MG,0,30,31,1783
276415,2022-02-19,Ilicínea/MG,1,31,17,1800
282012,2022-02-20,Ilicínea/MG,0,31,0,1800
287609,2022-02-21,Ilicínea/MG,0,31,31,1831
293206,2022-02-22,Ilicínea/MG,0,31,10,1841
298803,2022-02-23,Ilicínea/MG,0,31,0,1841
304400,2022-02-24,Ilicínea/MG,0,31,19,1860
309997,2022-02-25,Ilicínea/MG,0,31,0,1860
315594,2022-02-26,Ilicínea/MG,1,32,20,1880
321191,2022-02-27,Ilicínea/MG,0,32,8,1888
326788,2022-02-28,Ilicínea/MG,0,32,4,1892
332385,2022-03-01,Ilicínea/MG,0,32,3,1895
337982,2022-03-02,Ilicínea/MG,0,32,0,1895
343579,2022-03-03,Ilicínea/MG,0,32,0,1895
349176,2022-03-04,Ilicínea/MG,0,32,14,1909
354773,2022-03-05,Ilicínea/MG,0,32,9,1918
360370,2022-03-06,Ilicínea/MG,0,32,0,1918
365967,2022-03-07,Ilicínea/MG,0,32,0,1918
371564,2022-03-08,Ilicínea/MG,0,32,22,1940
377161,2022-03-09,Ilicínea/MG,0,32,2,1942
382758,2022-03-10,Ilicínea/MG,0,32,0,1942
388355,2022-03-11,Ilicínea/MG,0,32,5,1947
393952,2022-03-12,Ilicínea/MG,0,32,3,1950
399549,2022-03-13,Ilicínea/MG,0,32,21,1971
405146,2022-03-14,Ilicínea/MG,0,32,0,1971
410743,2022-03-15,Ilicínea/MG,0,32,0,1971
416340,2022-03-16,Ilicínea/MG,0,32,0,1971
421937,2022-03-17,Ilicínea/MG,0,32,0,1971
427534,2022-03-18,Ilicínea/MG,0,32,0,1971
433131,2022-03-19,Ilicínea/MG,0,32,0,1971
438728,2022-03-20,Ilicínea/MG,0,32,0,1971
444325,2022-03-21,Ilicínea/MG,0,32,1,1972
449922,2022-03-22,Ilicínea/MG,0,32,0,1972
455519,2022-03-23,Ilicínea/MG,0,32,4,1976
461116,2022-03-24,Ilicínea/MG,0,32,1,1977
466713,2022-03-25,Ilicínea/MG,0,32,2,1979
472310,2022-03-26,Ilicínea/MG,0,32,0,1979
477907,2022-03-27,Ilicínea/MG,0,32,0,1979
483504,2022-03-28,Ilicínea/MG,0,32,0,1979
489101,2022-03-29,Ilicínea/MG,0,32,2,1981
494698,2022-03-30,Ilicínea/MG,0,32,0,1981
500295,2022-03-31,Ilicínea/MG,0,32,1,1982
505892,2022-04-01,Ilicínea/MG,0,32,0,1982
511489,2022-04-02,Ilicínea/MG,0,32,0,1982
517086,2022-04-03,Ilicínea/MG,0,32,0,1982
522683,2022-04-04,Ilicínea/MG,0,32,0,1982
528280,2022-04-05,Ilicínea/MG,0,32,0,1982
533877,2022-04-06,Ilicínea/MG,0,32,0,1982
539474,2022-04-07,Ilicínea/MG,0,32,0,1982
545071,2022-04-08,Ilicínea/MG,0,32,0,1982
550668,2022-04-09,Ilicínea/MG,0,32,0,1982
556265,2022-04-10,Ilicínea/MG,0,32,0,1982
561862,2022-04-11,Ilicínea/MG,0,32,0,1982
567459,2022-04-12,Ilicínea/MG,0,32,0,1982
573056,2022-04-13,Ilicínea/MG,0,32,0,1982
578653,2022-04-14,Ilicínea/MG,0,32,0,1982
584250,2022-04-15,Ilicínea/MG,0,32,0,1982
589847,2022-04-16,Ilicínea/MG,0,32,0,1982
595444,2022-04-17,Ilicínea/MG,0,32,0,1982
601041,2022-04-18,Ilicínea/MG,0,32,0,1982
606638,2022-04-19,Ilicínea/MG,0,32,0,1982
612235,2022-04-20,Ilicínea/MG,0,32,0,1982
617832,2022-04-21,Ilicínea/MG,0,32,4,1986
623429,2022-04-22,Ilicínea/MG,0,32,0,1986
629026,2022-04-23,Ilicínea/MG,0,32,0,1986
634623,2022-04-24,Ilicínea/MG,0,32,0,1986
640220,2022-04-25,Ilicínea/MG,0,32,0,1986
645817,2022-04-26,Ilicínea/MG,0,32,0,1986
651414,2022-04-27,Ilicínea/MG,0,32,0,1986
657011,2022-04-28,Ilicínea/MG,0,32,0,1986
662608,2022-04-29,Ilicínea/MG,0,32,0,1986
668205,2022-04-30,Ilicínea/MG,0,32,1,1987
673802,2022-05-01,Ilicínea/MG,0,32,0,1987
679399,2022-05-02,Ilicínea/MG,0,32,0,1987
684996,2022-05-03,Ilicínea/MG,0,32,2,1989
690593,2022-05-04,Ilicínea/MG,0,32,0,1989
696190,2022-05-05,Ilicínea/MG,0,32,0,1989
701787,2022-05-06,Ilicínea/MG,0,32,-1,1988
707384,2022-05-07,Ilicínea/MG,0,32,0,1988
712981,2022-05-08,Ilicínea/MG,0,32,0,1988
718578,2022-05-09,Ilicínea/MG,0,32,5,1993
724175,2022-05-10,Ilicínea/MG,0,32,0,1993
729772,2022-05-11,Ilicínea/MG,0,32,0,1993
735369,2022-05-12,Ilicínea/MG,0,32,3,1996
740966,2022-05-13,Ilicínea/MG,0,32,6,2002
746563,2022-05-14,Ilicínea/MG,0,32,0,2002
752160,2022-05-15,Ilicínea/MG,0,32,0,2002
757757,2022-05-16,Ilicínea/MG,0,32,9,2011
763354,2022-05-17,Ilicínea/MG,0,32,0,2011
768951,2022-05-18,Ilicínea/MG,0,32,0,2011
774548,2022-05-19,Ilicínea/MG,0,32,0,2011
780145,2022-05-20,Ilicínea/MG,0,32,0,2011
785742,2022-05-21,Ilicínea/MG,0,32,0,2011
791339,2022-05-22,Ilicínea/MG,0,32,0,2011
796936,2022-05-23,Ilicínea/MG,0,32,31,2042
802533,2022-05-24,Ilicínea/MG,0,32,0,2042
808130,2022-05-25,Ilicínea/MG,0,32,0,2042
813727,2022-05-26,Ilicínea/MG,0,32,0,2042
819324,2022-05-27,Ilicínea/MG,0,32,10,2052
824921,2022-05-28,Ilicínea/MG,0,32,0,2052
830518,2022-05-29,Ilicínea/MG,0,32,0,2052
836115,2022-05-30,Ilicínea/MG,0,32,0,2052
841712,2022-05-31,Ilicínea/MG,0,32,9,2061
847309,2022-06-01,Ilicínea/MG,0,32,22,2083
852906,2022-06-02,Ilicínea/MG,0,32,0,2083
858503,2022-06-03,Ilicínea/MG,0,32,0,2083
864100,2022-06-04,Ilicínea/MG,0,32,0,2083
869697,2022-06-05,Ilicínea/MG,0,32,0,2083
875294,2022-06-06,Ilicínea/MG,0,32,0,2083
880891,2022-06-07,Ilicínea/MG,0,32,0,2083
886488,2022-06-08,Ilicínea/MG,0,32,48,2131
892085,2022-06-09,Ilicínea/MG,0,32,5,2136
897682,2022-06-10,Ilicínea/MG,0,32,0,2136
903279,2022-06-11,Ilicínea/MG,0,32,0,2136
908876,2022-06-12,Ilicínea/MG,0,32,0,2136
914473,2022-06-13,Ilicínea/MG,0,32,27,2163
920070,2022-06-14,Ilicínea/MG,0,32,0,2163
925667,2022-06-15,Ilicínea/MG,0,32,13,2176
931264,2022-06-16,Ilicínea/MG,0,32,0,2176
936861,2022-06-17,Ilicínea/MG,0,32,0,2176
942458,2022-06-18,Ilicínea/MG,0,32,0,2176
948055,2022-06-19,Ilicínea/MG,0,32,0,2176
953652,2022-06-20,Ilicínea/MG,0,32,31,2207
959249,2022-06-21,Ilicínea/MG,0,32,0,2207
964846,2022-06-22,Ilicínea/MG,0,32,0,2207
970443,2022-06-23,Ilicínea/MG,0,32,0,2207
976040,2022-06-24,Ilicínea/MG,0,32,0,2207
981637,2022-06-25,Ilicínea/MG,0,32,0,2207
987234,2022-06-26,Ilicínea/MG,0,32,0,2207
992831,2022-06-27,Ilicínea/MG,0,32,0,2207
998428,2022-06-28,Ilicínea/MG,0,32,0,2207
1004025,2022-06-29,Ilicínea/MG,0,32,46,2253
1009622,2022-06-30,Ilicínea/MG,0,32,0,2253
1015219,2022-07-01,Ilicínea/MG,0,32,14,2267
1020816,2022-07-02,Ilicínea/MG,0,32,0,2267
1026413,2022-07-03,Ilicínea/MG,0,32,0,2267
1032010,2022-07-04,Ilicínea/MG,0,32,0,2267
1037607,2022-07-05,Ilicínea/MG,0,32,0,2267
1043204,2022-07-06,Ilicínea/MG,0,32,19,2286
1048801,2022-07-07,Ilicínea/MG,0,32,0,2286
1054398,2022-07-08,Ilicínea/MG,0,32,0,2286
1059995,2022-07-09,Ilicínea/MG,0,32,0,2286
1065592,2022-07-10,Ilicínea/MG,0,32,0,2286
1071189,2022-07-11,Ilicínea/MG,0,32,0,2286
1076786,2022-07-12,Ilicínea/MG,0,32,66,2352
1082383,2022-07-13,Ilicínea/MG,0,32,0,2352
1087980,2022-07-14,Ilicínea/MG,0,32,0,2352
1093577,2022-07-15,Ilicínea/MG,0,32,27,2379
1099174,2022-07-16,Ilicínea/MG,0,32,0,2379
1104771,2022-07-17,Ilicínea/MG,0,32,0,2379
1110368,2022-07-18,Ilicínea/MG,0,32,0,2379
1115965,2022-07-19,Ilicínea/MG,0,32,9,2388
1121562,2022-07-20,Ilicínea/MG,0,32,11,2399
1127159,2022-07-21,Ilicínea/MG,0,32,0,2399
1132756,2022-07-22,Ilicínea/MG,0,32,5,2404
1138353,2022-07-23,Ilicínea/MG,0,32,0,2404
1143950,2022-07-24,Ilicínea/MG,0,32,0,2404
1149547,2022-07-25,Ilicínea/MG,0,32,0,2404
1155144,2022-07-26,Ilicínea/MG,0,32,1,2405
1160741,2022-07-27,Ilicínea/MG,0,32,6,2411
1166338,2022-07-28,Ilicínea/MG,0,32,0,2411
1171935,2022-07-29,Ilicínea/MG,0,32,0,2411
1177532,2022-07-30,Ilicínea/MG,0,32,0,2411
1183129,2022-07-31,Ilicínea/MG,0,32,0,2411
1188726,2022-08-01,Ilicínea/MG,0,32,0,2411
1194323,2022-08-02,Ilicínea/MG,0,32,0,2411
1199920,2022-08-03,Ilicínea/MG,0,32,0,2411
1205517,2022-08-04,Ilicínea/MG,0,32,5,2416
1211114,2022-08-05,Ilicínea/MG,0,32,10,2426
1216711,2022-08-06,Ilicínea/MG,0,32,0,2426
1222308,2022-08-07,Ilicínea/MG,0,32,0,2426
1227905,2022-08-08,Ilicínea/MG,0,32,0,2426
1233502,2022-08-09,Ilicínea/MG,0,32,0,2426
1239099,2022-08-10,Ilicínea/MG,0,32,15,2441
1244696,2022-08-11,Ilicínea/MG,0,32,4,2445
1250293,2022-08-12,Ilicínea/MG,0,32,0,2445
1255890,2022-08-13,Ilicínea/MG,0,32,0,2445
1261487,2022-08-14,Ilicínea/MG,0,32,0,2445
1267084,2022-08-15,Ilicínea/MG,0,32,0,2445
1272681,2022-08-16,Ilicínea/MG,0,32,12,2457
1278278,2022-08-17,Ilicínea/MG,0,32,0,2457
1283875,2022-08-18,Ilicínea/MG,0,32,0,2457
1289472,2022-08-19,Ilicínea/MG,0,32,0,2457
1295069,2022-08-20,Ilicínea/MG,0,32,0,2457
1300666,2022-08-21,Ilicínea/MG,0,32,0,2457
1306263,2022-08-22,Ilicínea/MG,0,32,0,2457
1311860,2022-08-23,Ilicínea/MG,0,32,0,2457
1317457,2022-08-24,Ilicínea/MG,0,32,0,2457
1323054,2022-08-25,Ilicínea/MG,0,32,0,2457
2177,2022-01-01,Inconfidentes/MG,0,12,0,564
7774,2022-01-02,Inconfidentes/MG,0,12,0,564
13371,2022-01-03,Inconfidentes/MG,0,12,0,564
18968,2022-01-04,Inconfidentes/MG,0,12,0,564
24565,2022-01-05,Inconfidentes/MG,0,12,1,565
30162,2022-01-06,Inconfidentes/MG,0,12,8,573
35759,2022-01-07,Inconfidentes/MG,0,12,20,593
41356,2022-01-08,Inconfidentes/MG,0,12,31,624
46953,2022-01-09,Inconfidentes/MG,0,12,18,642
52550,2022-01-10,Inconfidentes/MG,0,12,0,642
58147,2022-01-11,Inconfidentes/MG,0,12,0,642
63744,2022-01-12,Inconfidentes/MG,0,12,0,642
69341,2022-01-13,Inconfidentes/MG,0,12,0,642
74938,2022-01-14,Inconfidentes/MG,0,12,0,642
80535,2022-01-15,Inconfidentes/MG,0,12,0,642
86132,2022-01-16,Inconfidentes/MG,0,12,0,642
91729,2022-01-17,Inconfidentes/MG,0,12,0,642
97326,2022-01-18,Inconfidentes/MG,0,12,0,642
102923,2022-01-19,Inconfidentes/MG,0,12,0,642
108520,2022-01-20,Inconfidentes/MG,0,12,264,906
114117,2022-01-21,Inconfidentes/MG,0,12,22,928
119714,2022-01-22,Inconfidentes/MG,0,12,29,957
125311,2022-01-23,Inconfidentes/MG,0,12,22,979
130908,2022-01-24,Inconfidentes/MG,0,12,0,979
136505,2022-01-25,Inconfidentes/MG,0,12,0,979
142102,2022-01-26,Inconfidentes/MG,0,12,25,1004
147699,2022-01-27,Inconfidentes/MG,0,12,13,1017
153296,2022-01-28,Inconfidentes/MG,0,12,0,1017
158893,2022-01-29,Inconfidentes/MG,0,12,0,1017
164490,2022-01-30,Inconfidentes/MG,0,12,35,1052
170087,2022-01-31,Inconfidentes/MG,0,12,0,1052
175684,2022-02-01,Inconfidentes/MG,0,12,0,1052
181281,2022-02-02,Inconfidentes/MG,0,12,11,1063
186878,2022-02-03,Inconfidentes/MG,0,12,6,1069
192475,2022-02-04,Inconfidentes/MG,0,12,8,1077
198072,2022-02-05,Inconfidentes/MG,0,12,15,1092
203669,2022-02-06,Inconfidentes/MG,0,12,12,1104
209266,2022-02-07,Inconfidentes/MG,0,12,0,1104
214863,2022-02-08,Inconfidentes/MG,0,12,0,1104
220460,2022-02-09,Inconfidentes/MG,0,12,0,1104
226057,2022-02-10,Inconfidentes/MG,0,12,15,1119
231654,2022-02-11,Inconfidentes/MG,0,12,0,1119
237251,2022-02-12,Inconfidentes/MG,0,12,19,1138
242848,2022-02-13,Inconfidentes/MG,0,12,15,1153
248445,2022-02-14,Inconfidentes/MG,0,12,0,1153
254042,2022-02-15,Inconfidentes/MG,0,12,0,1153
259639,2022-02-16,Inconfidentes/MG,0,12,43,1196
265236,2022-02-17,Inconfidentes/MG,0,12,13,1209
270833,2022-02-18,Inconfidentes/MG,0,12,14,1223
276430,2022-02-19,Inconfidentes/MG,0,12,14,1237
282027,2022-02-20,Inconfidentes/MG,0,12,15,1252
287624,2022-02-21,Inconfidentes/MG,0,12,0,1252
293221,2022-02-22,Inconfidentes/MG,0,12,0,1252
298818,2022-02-23,Inconfidentes/MG,0,12,31,1283
304415,2022-02-24,Inconfidentes/MG,0,12,5,1288
310012,2022-02-25,Inconfidentes/MG,0,12,12,1300
315609,2022-02-26,Inconfidentes/MG,0,12,10,1310
321206,2022-02-27,Inconfidentes/MG,0,12,7,1317
326803,2022-02-28,Inconfidentes/MG,0,12,0,1317
332400,2022-03-01,Inconfidentes/MG,0,12,0,1317
337997,2022-03-02,Inconfidentes/MG,0,12,0,1317
343594,2022-03-03,Inconfidentes/MG,0,12,0,1317
349191,2022-03-04,Inconfidentes/MG,0,12,13,1330
354788,2022-03-05,Inconfidentes/MG,0,12,0,1330
360385,2022-03-06,Inconfidentes/MG,0,12,5,1335
365982,2022-03-07,Inconfidentes/MG,0,12,0,1335
371579,2022-03-08,Inconfidentes/MG,0,12,0,1335
377176,2022-03-09,Inconfidentes/MG,0,12,0,1335
382773,2022-03-10,Inconfidentes/MG,0,12,3,1338
388370,2022-03-11,Inconfidentes/MG,0,12,0,1338
393967,2022-03-12,Inconfidentes/MG,0,12,2,1340
399564,2022-03-13,Inconfidentes/MG,0,12,1,1341
405161,2022-03-14,Inconfidentes/MG,0,12,0,1341
410758,2022-03-15,Inconfidentes/MG,0,12,0,1341
416355,2022-03-16,Inconfidentes/MG,0,12,0,1341
421952,2022-03-17,Inconfidentes/MG,0,12,0,1341
427549,2022-03-18,Inconfidentes/MG,0,12,0,1341
433146,2022-03-19,Inconfidentes/MG,0,12,1,1342
438743,2022-03-20,Inconfidentes/MG,0,12,0,1342
444340,2022-03-21,Inconfidentes/MG,0,12,0,1342
449937,2022-03-22,Inconfidentes/MG,0,12,0,1342
455534,2022-03-23,Inconfidentes/MG,0,12,0,1342
461131,2022-03-24,Inconfidentes/MG,0,12,0,1342
466728,2022-03-25,Inconfidentes/MG,0,12,3,1345
472325,2022-03-26,Inconfidentes/MG,0,12,0,1345
477922,2022-03-27,Inconfidentes/MG,0,12,0,1345
483519,2022-03-28,Inconfidentes/MG,0,12,0,1345
489116,2022-03-29,Inconfidentes/MG,0,12,0,1345
494713,2022-03-30,Inconfidentes/MG,0,12,5,1350
500310,2022-03-31,Inconfidentes/MG,0,12,0,1350
505907,2022-04-01,Inconfidentes/MG,0,12,1,1351
511504,2022-04-02,Inconfidentes/MG,0,12,0,1351
517101,2022-04-03,Inconfidentes/MG,0,12,0,1351
522698,2022-04-04,Inconfidentes/MG,0,12,0,1351
528295,2022-04-05,Inconfidentes/MG,0,12,0,1351
533892,2022-04-06,Inconfidentes/MG,0,12,0,1351
539489,2022-04-07,Inconfidentes/MG,0,12,0,1351
545086,2022-04-08,Inconfidentes/MG,0,12,0,1351
550683,2022-04-09,Inconfidentes/MG,0,12,0,1351
556280,2022-04-10,Inconfidentes/MG,0,12,1,1352
561877,2022-04-11,Inconfidentes/MG,0,12,0,1352
567474,2022-04-12,Inconfidentes/MG,0,12,0,1352
573071,2022-04-13,Inconfidentes/MG,0,12,0,1352
578668,2022-04-14,Inconfidentes/MG,0,12,0,1352
584265,2022-04-15,Inconfidentes/MG,0,12,0,1352
589862,2022-04-16,Inconfidentes/MG,0,12,0,1352
595459,2022-04-17,Inconfidentes/MG,0,12,0,1352
601056,2022-04-18,Inconfidentes/MG,0,12,0,1352
606653,2022-04-19,Inconfidentes/MG,0,12,0,1352
612250,2022-04-20,Inconfidentes/MG,0,12,0,1352
617847,2022-04-21,Inconfidentes/MG,0,12,0,1352
623444,2022-04-22,Inconfidentes/MG,0,12,0,1352
629041,2022-04-23,Inconfidentes/MG,0,12,0,1352
634638,2022-04-24,Inconfidentes/MG,0,12,0,1352
640235,2022-04-25,Inconfidentes/MG,0,12,0,1352
645832,2022-04-26,Inconfidentes/MG,0,12,0,1352
651429,2022-04-27,Inconfidentes/MG,0,12,0,1352
657026,2022-04-28,Inconfidentes/MG,0,12,0,1352
662623,2022-04-29,Inconfidentes/MG,0,12,0,1352
668220,2022-04-30,Inconfidentes/MG,0,12,0,1352
673817,2022-05-01,Inconfidentes/MG,0,12,0,1352
679414,2022-05-02,Inconfidentes/MG,0,12,0,1352
685011,2022-05-03,Inconfidentes/MG,0,12,0,1352
690608,2022-05-04,Inconfidentes/MG,0,12,0,1352
696205,2022-05-05,Inconfidentes/MG,0,12,0,1352
701802,2022-05-06,Inconfidentes/MG,0,12,0,1352
707399,2022-05-07,Inconfidentes/MG,0,12,0,1352
712996,2022-05-08,Inconfidentes/MG,0,12,0,1352
718593,2022-05-09,Inconfidentes/MG,0,12,2,1354
724190,2022-05-10,Inconfidentes/MG,0,12,0,1354
729787,2022-05-11,Inconfidentes/MG,0,12,0,1354
735384,2022-05-12,Inconfidentes/MG,0,12,0,1354
740981,2022-05-13,Inconfidentes/MG,0,12,0,1354
746578,2022-05-14,Inconfidentes/MG,0,12,0,1354
752175,2022-05-15,Inconfidentes/MG,0,12,0,1354
757772,2022-05-16,Inconfidentes/MG,0,12,1,1355
763369,2022-05-17,Inconfidentes/MG,0,12,0,1355
768966,2022-05-18,Inconfidentes/MG,0,12,0,1355
774563,2022-05-19,Inconfidentes/MG,0,12,0,1355
780160,2022-05-20,Inconfidentes/MG,0,12,2,1357
785757,2022-05-21,Inconfidentes/MG,0,12,0,1357
791354,2022-05-22,Inconfidentes/MG,0,12,0,1357
796951,2022-05-23,Inconfidentes/MG,0,12,2,1359
802548,2022-05-24,Inconfidentes/MG,0,12,0,1359
808145,2022-05-25,Inconfidentes/MG,0,12,0,1359
813742,2022-05-26,Inconfidentes/MG,0,12,20,1379
819339,2022-05-27,Inconfidentes/MG,0,12,0,1379
824936,2022-05-28,Inconfidentes/MG,0,12,0,1379
830533,2022-05-29,Inconfidentes/MG,0,12,0,1379
836130,2022-05-30,Inconfidentes/MG,0,12,34,1413
841727,2022-05-31,Inconfidentes/MG,0,12,0,1413
847324,2022-06-01,Inconfidentes/MG,0,12,23,1436
852921,2022-06-02,Inconfidentes/MG,0,12,3,1439
858518,2022-06-03,Inconfidentes/MG,0,12,13,1452
864115,2022-06-04,Inconfidentes/MG,0,12,0,1452
869712,2022-06-05,Inconfidentes/MG,0,12,0,1452
875309,2022-06-06,Inconfidentes/MG,0,12,20,1472
880906,2022-06-07,Inconfidentes/MG,0,12,0,1472
886503,2022-06-08,Inconfidentes/MG,0,12,26,1498
892100,2022-06-09,Inconfidentes/MG,0,12,13,1511
897697,2022-06-10,Inconfidentes/MG,0,12,0,1511
903294,2022-06-11,Inconfidentes/MG,0,12,0,1511
908891,2022-06-12,Inconfidentes/MG,0,12,0,1511
914488,2022-06-13,Inconfidentes/MG,0,12,37,1548
920085,2022-06-14,Inconfidentes/MG,0,12,0,1548
925682,2022-06-15,Inconfidentes/MG,0,12,0,1548
931279,2022-06-16,Inconfidentes/MG,0,12,0,1548
936876,2022-06-17,Inconfidentes/MG,0,12,0,1548
942473,2022-06-18,Inconfidentes/MG,0,12,0,1548
948070,2022-06-19,Inconfidentes/MG,0,12,0,1548
953667,2022-06-20,Inconfidentes/MG,0,12,67,1615
959264,2022-06-21,Inconfidentes/MG,0,12,0,1615
964861,2022-06-22,Inconfidentes/MG,0,12,16,1631
970458,2022-06-23,Inconfidentes/MG,0,12,0,1631
976055,2022-06-24,Inconfidentes/MG,0,12,32,1663
981652,2022-06-25,Inconfidentes/MG,0,12,0,1663
987249,2022-06-26,Inconfidentes/MG,0,12,0,1663
992846,2022-06-27,Inconfidentes/MG,0,12,14,1677
998443,2022-06-28,Inconfidentes/MG,0,12,13,1690
1004040,2022-06-29,Inconfidentes/MG,0,12,12,1702
1009637,2022-06-30,Inconfidentes/MG,0,12,15,1717
1015234,2022-07-01,Inconfidentes/MG,0,12,12,1729
1020831,2022-07-02,Inconfidentes/MG,0,12,0,1729
1026428,2022-07-03,Inconfidentes/MG,0,12,0,1729
1032025,2022-07-04,Inconfidentes/MG,0,12,17,1746
1037622,2022-07-05,Inconfidentes/MG,0,12,13,1759
1043219,2022-07-06,Inconfidentes/MG,0,12,18,1777
1048816,2022-07-07,Inconfidentes/MG,0,12,17,1794
1054413,2022-07-08,Inconfidentes/MG,0,12,6,1800
1060010,2022-07-09,Inconfidentes/MG,0,12,0,1800
1065607,2022-07-10,Inconfidentes/MG,0,12,0,1800
1071204,2022-07-11,Inconfidentes/MG,0,12,8,1808
1076801,2022-07-12,Inconfidentes/MG,0,12,11,1819
1082398,2022-07-13,Inconfidentes/MG,0,12,12,1831
1087995,2022-07-14,Inconfidentes/MG,0,12,1,1832
1093592,2022-07-15,Inconfidentes/MG,0,12,0,1832
1099189,2022-07-16,Inconfidentes/MG,0,12,0,1832
1104786,2022-07-17,Inconfidentes/MG,0,12,0,1832
1110383,2022-07-18,Inconfidentes/MG,0,12,16,1848
1115980,2022-07-19,Inconfidentes/MG,0,12,0,1848
1121577,2022-07-20,Inconfidentes/MG,0,12,0,1848
1127174,2022-07-21,Inconfidentes/MG,0,12,0,1848
1132771,2022-07-22,Inconfidentes/MG,0,12,0,1848
1138368,2022-07-23,Inconfidentes/MG,0,12,0,1848
1143965,2022-07-24,Inconfidentes/MG,0,12,0,1848
1149562,2022-07-25,Inconfidentes/MG,0,12,0,1848
1155159,2022-07-26,Inconfidentes/MG,0,12,0,1848
1160756,2022-07-27,Inconfidentes/MG,0,12,0,1848
1166353,2022-07-28,Inconfidentes/MG,0,12,24,1872
1171950,2022-07-29,Inconfidentes/MG,0,12,0,1872
1177547,2022-07-30,Inconfidentes/MG,0,12,0,1872
1183144,2022-07-31,Inconfidentes/MG,0,12,0,1872
1188741,2022-08-01,Inconfidentes/MG,0,12,1,1873
1194338,2022-08-02,Inconfidentes/MG,0,12,3,1876
1199935,2022-08-03,Inconfidentes/MG,0,12,0,1876
1205532,2022-08-04,Inconfidentes/MG,0,12,0,1876
1211129,2022-08-05,Inconfidentes/MG,0,12,0,1876
1216726,2022-08-06,Inconfidentes/MG,0,12,0,1876
1222323,2022-08-07,Inconfidentes/MG,0,12,0,1876
1227920,2022-08-08,Inconfidentes/MG,0,12,0,1876
1233517,2022-08-09,Inconfidentes/MG,0,12,0,1876
1239114,2022-08-10,Inconfidentes/MG,0,12,0,1876
1244711,2022-08-11,Inconfidentes/MG,0,12,0,1876
1250308,2022-08-12,Inconfidentes/MG,0,12,2,1878
1255905,2022-08-13,Inconfidentes/MG,0,12,0,1878
1261502,2022-08-14,Inconfidentes/MG,0,12,0,1878
1267099,2022-08-15,Inconfidentes/MG,0,12,0,1878
1272696,2022-08-16,Inconfidentes/MG,0,12,0,1878
1278293,2022-08-17,Inconfidentes/MG,0,12,1,1879
1283890,2022-08-18,Inconfidentes/MG,0,12,1,1880
1289487,2022-08-19,Inconfidentes/MG,0,12,0,1880
1295084,2022-08-20,Inconfidentes/MG,0,12,0,1880
1300681,2022-08-21,Inconfidentes/MG,0,12,0,1880
1306278,2022-08-22,Inconfidentes/MG,0,12,0,1880
1311875,2022-08-23,Inconfidentes/MG,0,12,1,1881
1317472,2022-08-24,Inconfidentes/MG,0,12,0,1881
1323069,2022-08-25,Inconfidentes/MG,0,12,0,1881
2315,2022-01-01,Itajubá/MG,0,423,0,10521
7912,2022-01-02,Itajubá/MG,0,423,0,10521
13509,2022-01-03,Itajubá/MG,0,423,169,10690
19106,2022-01-04,Itajubá/MG,0,423,6,10696
24703,2022-01-05,Itajubá/MG,0,423,99,10795
30300,2022-01-06,Itajubá/MG,0,423,0,10795
35897,2022-01-07,Itajubá/MG,0,423,0,10795
41494,2022-01-08,Itajubá/MG,0,423,285,11080
47091,2022-01-09,Itajubá/MG,0,423,131,11211
52688,2022-01-10,Itajubá/MG,0,423,139,11350
58285,2022-01-11,Itajubá/MG,0,423,18,11368
63882,2022-01-12,Itajubá/MG,1,424,221,11589
69479,2022-01-13,Itajubá/MG,1,425,146,11735
75076,2022-01-14,Itajubá/MG,0,425,0,11735
80673,2022-01-15,Itajubá/MG,2,427,259,11994
86270,2022-01-16,Itajubá/MG,0,427,0,11994
91867,2022-01-17,Itajubá/MG,0,427,394,12388
97464,2022-01-18,Itajubá/MG,0,427,129,12517
103061,2022-01-19,Itajubá/MG,1,428,151,12668
108658,2022-01-20,Itajubá/MG,1,429,225,12893
114255,2022-01-21,Itajubá/MG,0,429,180,13073
119852,2022-01-22,Itajubá/MG,0,429,165,13238
125449,2022-01-23,Itajubá/MG,0,429,0,13238
131046,2022-01-24,Itajubá/MG,0,429,349,13587
136643,2022-01-25,Itajubá/MG,0,429,246,13833
142240,2022-01-26,Itajubá/MG,4,433,290,14123
147837,2022-01-27,Itajubá/MG,0,433,273,14396
153434,2022-01-28,Itajubá/MG,0,433,282,14678
159031,2022-01-29,Itajubá/MG,4,437,180,14858
164628,2022-01-30,Itajubá/MG,0,437,163,15021
170225,2022-01-31,Itajubá/MG,0,437,97,15118
175822,2022-02-01,Itajubá/MG,0,437,105,15223
181419,2022-02-02,Itajubá/MG,2,439,57,15280
187016,2022-02-03,Itajubá/MG,0,439,91,15371
192613,2022-02-04,Itajubá/MG,1,440,82,15453
198210,2022-02-05,Itajubá/MG,3,443,89,15542
203807,2022-02-06,Itajubá/MG,2,445,100,15642
209404,2022-02-07,Itajubá/MG,0,445,93,15735
215001,2022-02-08,Itajubá/MG,0,445,0,15735
220598,2022-02-09,Itajubá/MG,0,445,182,15917
226195,2022-02-10,Itajubá/MG,0,445,102,16019
231792,2022-02-11,Itajubá/MG,3,448,0,16019
237389,2022-02-12,Itajubá/MG,3,451,227,16246
242986,2022-02-13,Itajubá/MG,0,451,106,16352
248583,2022-02-14,Itajubá/MG,0,451,68,16420
254180,2022-02-15,Itajubá/MG,0,451,0,16420
259777,2022-02-16,Itajubá/MG,1,452,158,16578
265374,2022-02-17,Itajubá/MG,2,454,69,16647
270971,2022-02-18,Itajubá/MG,0,454,71,16718
276568,2022-02-19,Itajubá/MG,1,455,91,16809
282165,2022-02-20,Itajubá/MG,3,458,61,16870
287762,2022-02-21,Itajubá/MG,0,458,32,16902
293359,2022-02-22,Itajubá/MG,0,458,26,16928
298956,2022-02-23,Itajubá/MG,0,458,81,17009
304553,2022-02-24,Itajubá/MG,0,458,0,17009
310150,2022-02-25,Itajubá/MG,1,459,127,17136
315747,2022-02-26,Itajubá/MG,0,459,52,17188
321344,2022-02-27,Itajubá/MG,1,460,127,17315
326941,2022-02-28,Itajubá/MG,0,460,51,17366
332538,2022-03-01,Itajubá/MG,0,460,54,17420
338135,2022-03-02,Itajubá/MG,0,460,0,17420
343732,2022-03-03,Itajubá/MG,1,461,68,17488
349329,2022-03-04,Itajubá/MG,0,461,55,17543
354926,2022-03-05,Itajubá/MG,1,462,43,17586
360523,2022-03-06,Itajubá/MG,0,462,41,17627
366120,2022-03-07,Itajubá/MG,0,462,11,17638
371717,2022-03-08,Itajubá/MG,0,462,14,17652
377314,2022-03-09,Itajubá/MG,0,462,20,17672
382911,2022-03-10,Itajubá/MG,1,463,40,17712
388508,2022-03-11,Itajubá/MG,-1,462,15,17727
394105,2022-03-12,Itajubá/MG,1,463,7,17734
399702,2022-03-13,Itajubá/MG,0,463,0,17734
405299,2022-03-14,Itajubá/MG,0,463,15,17749
410896,2022-03-15,Itajubá/MG,0,463,0,17749
416493,2022-03-16,Itajubá/MG,0,463,12,17761
422090,2022-03-17,Itajubá/MG,0,463,16,17777
427687,2022-03-18,Itajubá/MG,0,463,11,17788
433284,2022-03-19,Itajubá/MG,0,463,6,17794
438881,2022-03-20,Itajubá/MG,0,463,16,17810
444478,2022-03-21,Itajubá/MG,0,463,12,17822
450075,2022-03-22,Itajubá/MG,0,463,0,17822
455672,2022-03-23,Itajubá/MG,0,463,43,17865
461269,2022-03-24,Itajubá/MG,0,463,14,17879
466866,2022-03-25,Itajubá/MG,0,463,0,17879
472463,2022-03-26,Itajubá/MG,0,463,16,17895
478060,2022-03-27,Itajubá/MG,0,463,1,17896
483657,2022-03-28,Itajubá/MG,0,463,2,17898
489254,2022-03-29,Itajubá/MG,0,463,0,17898
494851,2022-03-30,Itajubá/MG,1,464,19,17917
500448,2022-03-31,Itajubá/MG,0,464,36,17953
506045,2022-04-01,Itajubá/MG,1,465,20,17973
511642,2022-04-02,Itajubá/MG,0,465,0,17973
517239,2022-04-03,Itajubá/MG,0,465,0,17973
522836,2022-04-04,Itajubá/MG,0,465,5,17978
528433,2022-04-05,Itajubá/MG,0,465,0,17978
534030,2022-04-06,Itajubá/MG,0,465,3,17981
539627,2022-04-07,Itajubá/MG,0,465,68,18049
545224,2022-04-08,Itajubá/MG,0,465,22,18071
550821,2022-04-09,Itajubá/MG,0,465,6,18077
556418,2022-04-10,Itajubá/MG,0,465,4,18081
562015,2022-04-11,Itajubá/MG,0,465,3,18084
567612,2022-04-12,Itajubá/MG,0,465,0,18084
573209,2022-04-13,Itajubá/MG,0,465,0,18084
578806,2022-04-14,Itajubá/MG,0,465,0,18084
584403,2022-04-15,Itajubá/MG,0,465,23,18107
590000,2022-04-16,Itajubá/MG,0,465,0,18107
595597,2022-04-17,Itajubá/MG,0,465,41,18148
601194,2022-04-18,Itajubá/MG,0,465,0,18148
606791,2022-04-19,Itajubá/MG,0,465,0,18148
612388,2022-04-20,Itajubá/MG,0,465,106,18254
617985,2022-04-21,Itajubá/MG,0,465,8,18262
623582,2022-04-22,Itajubá/MG,-1,464,8,18270
629179,2022-04-23,Itajubá/MG,0,464,18,18288
634776,2022-04-24,Itajubá/MG,0,464,6,18294
640373,2022-04-25,Itajubá/MG,0,464,9,18303
645970,2022-04-26,Itajubá/MG,0,464,0,18303
651567,2022-04-27,Itajubá/MG,0,464,18,18321
657164,2022-04-28,Itajubá/MG,0,464,36,18357
662761,2022-04-29,Itajubá/MG,1,465,0,18357
668358,2022-04-30,Itajubá/MG,0,465,31,18388
673955,2022-05-01,Itajubá/MG,0,465,28,18416
679552,2022-05-02,Itajubá/MG,0,465,0,18416
685149,2022-05-03,Itajubá/MG,0,465,0,18416
690746,2022-05-04,Itajubá/MG,0,465,35,18451
696343,2022-05-05,Itajubá/MG,0,465,47,18498
701940,2022-05-06,Itajubá/MG,0,465,23,18521
707537,2022-05-07,Itajubá/MG,0,465,0,18521
713134,2022-05-08,Itajubá/MG,0,465,0,18521
718731,2022-05-09,Itajubá/MG,0,465,70,18591
724328,2022-05-10,Itajubá/MG,0,465,0,18591
729925,2022-05-11,Itajubá/MG,0,465,61,18652
735522,2022-05-12,Itajubá/MG,0,465,0,18652
741119,2022-05-13,Itajubá/MG,0,465,39,18691
746716,2022-05-14,Itajubá/MG,0,465,0,18691
752313,2022-05-15,Itajubá/MG,0,465,0,18691
757910,2022-05-16,Itajubá/MG,0,465,81,18772
763507,2022-05-17,Itajubá/MG,0,465,94,18866
769104,2022-05-18,Itajubá/MG,0,465,33,18899
774701,2022-05-19,Itajubá/MG,0,465,0,18899
780298,2022-05-20,Itajubá/MG,0,465,70,18969
785895,2022-05-21,Itajubá/MG,0,465,0,18969
791492,2022-05-22,Itajubá/MG,0,465,0,18969
797089,2022-05-23,Itajubá/MG,0,465,0,18969
802686,2022-05-24,Itajubá/MG,0,465,0,18969
808283,2022-05-25,Itajubá/MG,0,465,73,19042
813880,2022-05-26,Itajubá/MG,2,467,88,19130
819477,2022-05-27,Itajubá/MG,0,467,87,19217
825074,2022-05-28,Itajubá/MG,0,467,0,19217
830671,2022-05-29,Itajubá/MG,0,467,0,19217
836268,2022-05-30,Itajubá/MG,0,467,126,19343
841865,2022-05-31,Itajubá/MG,0,467,7,19350
847462,2022-06-01,Itajubá/MG,1,468,0,19350
853059,2022-06-02,Itajubá/MG,0,468,55,19405
858656,2022-06-03,Itajubá/MG,0,468,145,19550
864253,2022-06-04,Itajubá/MG,0,468,0,19550
869850,2022-06-05,Itajubá/MG,0,468,0,19550
875447,2022-06-06,Itajubá/MG,0,468,199,19749
881044,2022-06-07,Itajubá/MG,0,468,14,19763
886641,2022-06-08,Itajubá/MG,1,469,8,19771
892238,2022-06-09,Itajubá/MG,0,469,65,19836
897835,2022-06-10,Itajubá/MG,0,469,0,19836
903432,2022-06-11,Itajubá/MG,0,469,0,19836
909029,2022-06-12,Itajubá/MG,0,469,0,19836
914626,2022-06-13,Itajubá/MG,0,469,206,20042
920223,2022-06-14,Itajubá/MG,0,469,146,20188
925820,2022-06-15,Itajubá/MG,1,470,0,20188
931417,2022-06-16,Itajubá/MG,0,470,0,20188
937014,2022-06-17,Itajubá/MG,0,470,0,20188
942611,2022-06-18,Itajubá/MG,0,470,0,20188
948208,2022-06-19,Itajubá/MG,0,470,0,20188
953805,2022-06-20,Itajubá/MG,2,472,288,20476
959402,2022-06-21,Itajubá/MG,0,472,41,20517
964999,2022-06-22,Itajubá/MG,0,472,0,20517
970596,2022-06-23,Itajubá/MG,0,472,0,20517
976193,2022-06-24,Itajubá/MG,0,472,182,20699
981790,2022-06-25,Itajubá/MG,0,472,0,20699
987387,2022-06-26,Itajubá/MG,0,472,0,20699
992984,2022-06-27,Itajubá/MG,0,472,269,20968
998581,2022-06-28,Itajubá/MG,0,472,0,20968
1004178,2022-06-29,Itajubá/MG,0,472,0,20968
1009775,2022-06-30,Itajubá/MG,0,472,150,21118
1015372,2022-07-01,Itajubá/MG,0,472,79,21197
1020969,2022-07-02,Itajubá/MG,0,472,0,21197
1026566,2022-07-03,Itajubá/MG,0,472,0,21197
1032163,2022-07-04,Itajubá/MG,0,472,106,21303
1037760,2022-07-05,Itajubá/MG,0,472,206,21509
1043357,2022-07-06,Itajubá/MG,1,473,40,21549
1048954,2022-07-07,Itajubá/MG,0,473,35,21584
1054551,2022-07-08,Itajubá/MG,0,473,77,21661
1060148,2022-07-09,Itajubá/MG,0,473,0,21661
1065745,2022-07-10,Itajubá/MG,0,473,0,21661
1071342,2022-07-11,Itajubá/MG,0,473,111,21772
1076939,2022-07-12,Itajubá/MG,0,473,0,21772
1082536,2022-07-13,Itajubá/MG,0,473,53,21825
1088133,2022-07-14,Itajubá/MG,0,473,27,21852
1093730,2022-07-15,Itajubá/MG,0,473,0,21852
1099327,2022-07-16,Itajubá/MG,0,473,0,21852
1104924,2022-07-17,Itajubá/MG,0,473,0,21852
1110521,2022-07-18,Itajubá/MG,0,473,219,22071
1116118,2022-07-19,Itajubá/MG,0,473,40,22111
1121715,2022-07-20,Itajubá/MG,0,473,34,22145
1127312,2022-07-21,Itajubá/MG,0,473,18,22163
1132909,2022-07-22,Itajubá/MG,0,473,0,22163
1138506,2022-07-23,Itajubá/MG,0,473,0,22163
1144103,2022-07-24,Itajubá/MG,0,473,0,22163
1149700,2022-07-25,Itajubá/MG,0,473,96,22259
1155297,2022-07-26,Itajubá/MG,0,473,0,22259
1160894,2022-07-27,Itajubá/MG,0,473,31,22290
1166491,2022-07-28,Itajubá/MG,0,473,0,22290
1172088,2022-07-29,Itajubá/MG,0,473,103,22393
1177685,2022-07-30,Itajubá/MG,0,473,0,22393
1183282,2022-07-31,Itajubá/MG,0,473,0,22393
1188879,2022-08-01,Itajubá/MG,0,473,81,22474
1194476,2022-08-02,Itajubá/MG,0,473,6,22480
1200073,2022-08-03,Itajubá/MG,0,473,22,22502
1205670,2022-08-04,Itajubá/MG,1,474,29,22531
1211267,2022-08-05,Itajubá/MG,1,475,0,22531
1216864,2022-08-06,Itajubá/MG,0,475,0,22531
1222461,2022-08-07,Itajubá/MG,0,475,0,22531
1228058,2022-08-08,Itajubá/MG,0,475,94,22625
1233655,2022-08-09,Itajubá/MG,1,476,0,22625
1239252,2022-08-10,Itajubá/MG,1,477,23,22648
1244849,2022-08-11,Itajubá/MG,0,477,19,22667
1250446,2022-08-12,Itajubá/MG,0,477,7,22674
1256043,2022-08-13,Itajubá/MG,0,477,0,22674
1261640,2022-08-14,Itajubá/MG,0,477,0,22674
1267237,2022-08-15,Itajubá/MG,0,477,0,22674
1272834,2022-08-16,Itajubá/MG,0,477,32,22706
1278431,2022-08-17,Itajubá/MG,0,477,5,22711
1284028,2022-08-18,Itajubá/MG,0,477,5,22716
1289625,2022-08-19,Itajubá/MG,1,478,30,22746
1295222,2022-08-20,Itajubá/MG,0,478,0,22746
1300819,2022-08-21,Itajubá/MG,0,478,0,22746
1306416,2022-08-22,Itajubá/MG,0,478,10,22756
1312013,2022-08-23,Itajubá/MG,0,478,0,22756
1317610,2022-08-24,Itajubá/MG,0,478,60,22816
1323207,2022-08-25,Itajubá/MG,0,478,3,22819
2334,2022-01-01,Itanhandu/MG,0,58,0,2646
7931,2022-01-02,Itanhandu/MG,0,58,0,2646
13528,2022-01-03,Itanhandu/MG,0,58,0,2646
19125,2022-01-04,Itanhandu/MG,0,58,0,2646
24722,2022-01-05,Itanhandu/MG,0,58,10,2656
30319,2022-01-06,Itanhandu/MG,0,58,0,2656
35916,2022-01-07,Itanhandu/MG,0,58,15,2671
41513,2022-01-08,Itanhandu/MG,0,58,0,2671
47110,2022-01-09,Itanhandu/MG,0,58,37,2708
52707,2022-01-10,Itanhandu/MG,0,58,0,2708
58304,2022-01-11,Itanhandu/MG,0,58,0,2708
63901,2022-01-12,Itanhandu/MG,0,58,37,2745
69498,2022-01-13,Itanhandu/MG,0,58,19,2764
75095,2022-01-14,Itanhandu/MG,0,58,36,2800
80692,2022-01-15,Itanhandu/MG,0,58,27,2827
86289,2022-01-16,Itanhandu/MG,0,58,0,2827
91886,2022-01-17,Itanhandu/MG,1,59,21,2848
97483,2022-01-18,Itanhandu/MG,0,59,0,2848
103080,2022-01-19,Itanhandu/MG,0,59,62,2910
108677,2022-01-20,Itanhandu/MG,0,59,76,2986
114274,2022-01-21,Itanhandu/MG,1,60,47,3033
119871,2022-01-22,Itanhandu/MG,0,60,62,3095
125468,2022-01-23,Itanhandu/MG,0,60,56,3151
131065,2022-01-24,Itanhandu/MG,0,60,35,3186
136662,2022-01-25,Itanhandu/MG,0,60,0,3186
142259,2022-01-26,Itanhandu/MG,0,60,68,3254
147856,2022-01-27,Itanhandu/MG,0,60,59,3313
153453,2022-01-28,Itanhandu/MG,0,60,26,3339
159050,2022-01-29,Itanhandu/MG,0,60,64,3403
164647,2022-01-30,Itanhandu/MG,1,61,0,3403
170244,2022-01-31,Itanhandu/MG,0,61,89,3492
175841,2022-02-01,Itanhandu/MG,0,61,0,3492
181438,2022-02-02,Itanhandu/MG,0,61,55,3547
187035,2022-02-03,Itanhandu/MG,0,61,0,3547
192632,2022-02-04,Itanhandu/MG,0,61,77,3624
198229,2022-02-05,Itanhandu/MG,0,61,42,3666
203826,2022-02-06,Itanhandu/MG,0,61,48,3714
209423,2022-02-07,Itanhandu/MG,0,61,0,3714
215020,2022-02-08,Itanhandu/MG,0,61,33,3747
220617,2022-02-09,Itanhandu/MG,0,61,25,3772
226214,2022-02-10,Itanhandu/MG,0,61,27,3799
231811,2022-02-11,Itanhandu/MG,0,61,32,3831
237408,2022-02-12,Itanhandu/MG,0,61,0,3831
243005,2022-02-13,Itanhandu/MG,0,61,34,3865
248602,2022-02-14,Itanhandu/MG,0,61,0,3865
254199,2022-02-15,Itanhandu/MG,0,61,37,3902
259796,2022-02-16,Itanhandu/MG,0,61,22,3924
265393,2022-02-17,Itanhandu/MG,1,62,12,3936
270990,2022-02-18,Itanhandu/MG,0,62,21,3957
276587,2022-02-19,Itanhandu/MG,0,62,28,3985
282184,2022-02-20,Itanhandu/MG,0,62,21,4006
287781,2022-02-21,Itanhandu/MG,0,62,0,4006
293378,2022-02-22,Itanhandu/MG,0,62,0,4006
298975,2022-02-23,Itanhandu/MG,0,62,24,4030
304572,2022-02-24,Itanhandu/MG,0,62,13,4043
310169,2022-02-25,Itanhandu/MG,0,62,23,4066
315766,2022-02-26,Itanhandu/MG,0,62,15,4081
321363,2022-02-27,Itanhandu/MG,1,63,12,4093
326960,2022-02-28,Itanhandu/MG,0,63,0,4093
332557,2022-03-01,Itanhandu/MG,0,63,0,4093
338154,2022-03-02,Itanhandu/MG,0,63,0,4093
343751,2022-03-03,Itanhandu/MG,0,63,9,4102
349348,2022-03-04,Itanhandu/MG,0,63,0,4102
354945,2022-03-05,Itanhandu/MG,0,63,8,4110
360542,2022-03-06,Itanhandu/MG,0,63,0,4110
366139,2022-03-07,Itanhandu/MG,0,63,10,4120
371736,2022-03-08,Itanhandu/MG,0,63,0,4120
377333,2022-03-09,Itanhandu/MG,0,63,11,4131
382930,2022-03-10,Itanhandu/MG,0,63,10,4141
388527,2022-03-11,Itanhandu/MG,0,63,4,4145
394124,2022-03-12,Itanhandu/MG,0,63,3,4148
399721,2022-03-13,Itanhandu/MG,0,63,4,4152
405318,2022-03-14,Itanhandu/MG,0,63,0,4152
410915,2022-03-15,Itanhandu/MG,0,63,0,4152
416512,2022-03-16,Itanhandu/MG,0,63,6,4158
422109,2022-03-17,Itanhandu/MG,0,63,4,4162
427706,2022-03-18,Itanhandu/MG,0,63,6,4168
433303,2022-03-19,Itanhandu/MG,0,63,3,4171
438900,2022-03-20,Itanhandu/MG,0,63,4,4175
444497,2022-03-21,Itanhandu/MG,0,63,-1,4174
450094,2022-03-22,Itanhandu/MG,0,63,0,4174
455691,2022-03-23,Itanhandu/MG,0,63,3,4177
461288,2022-03-24,Itanhandu/MG,0,63,0,4177
466885,2022-03-25,Itanhandu/MG,0,63,0,4177
472482,2022-03-26,Itanhandu/MG,0,63,1,4178
478079,2022-03-27,Itanhandu/MG,0,63,1,4179
483676,2022-03-28,Itanhandu/MG,0,63,0,4179
489273,2022-03-29,Itanhandu/MG,0,63,0,4179
494870,2022-03-30,Itanhandu/MG,0,63,0,4179
500467,2022-03-31,Itanhandu/MG,0,63,0,4179
506064,2022-04-01,Itanhandu/MG,0,63,0,4179
511661,2022-04-02,Itanhandu/MG,0,63,0,4179
517258,2022-04-03,Itanhandu/MG,0,63,0,4179
522855,2022-04-04,Itanhandu/MG,0,63,0,4179
528452,2022-04-05,Itanhandu/MG,0,63,0,4179
534049,2022-04-06,Itanhandu/MG,0,63,0,4179
539646,2022-04-07,Itanhandu/MG,0,63,0,4179
545243,2022-04-08,Itanhandu/MG,0,63,1,4180
550840,2022-04-09,Itanhandu/MG,0,63,0,4180
556437,2022-04-10,Itanhandu/MG,0,63,0,4180
562034,2022-04-11,Itanhandu/MG,0,63,0,4180
567631,2022-04-12,Itanhandu/MG,0,63,0,4180
573228,2022-04-13,Itanhandu/MG,0,63,0,4180
578825,2022-04-14,Itanhandu/MG,0,63,0,4180
584422,2022-04-15,Itanhandu/MG,0,63,2,4182
590019,2022-04-16,Itanhandu/MG,0,63,0,4182
595616,2022-04-17,Itanhandu/MG,0,63,0,4182
601213,2022-04-18,Itanhandu/MG,0,63,0,4182
606810,2022-04-19,Itanhandu/MG,0,63,0,4182
612407,2022-04-20,Itanhandu/MG,0,63,0,4182
618004,2022-04-21,Itanhandu/MG,0,63,2,4184
623601,2022-04-22,Itanhandu/MG,0,63,0,4184
629198,2022-04-23,Itanhandu/MG,0,63,0,4184
634795,2022-04-24,Itanhandu/MG,0,63,0,4184
640392,2022-04-25,Itanhandu/MG,0,63,0,4184
645989,2022-04-26,Itanhandu/MG,0,63,0,4184
651586,2022-04-27,Itanhandu/MG,0,63,0,4184
657183,2022-04-28,Itanhandu/MG,0,63,2,4186
662780,2022-04-29,Itanhandu/MG,0,63,0,4186
668377,2022-04-30,Itanhandu/MG,0,63,0,4186
673974,2022-05-01,Itanhandu/MG,0,63,1,4187
679571,2022-05-02,Itanhandu/MG,0,63,0,4187
685168,2022-05-03,Itanhandu/MG,0,63,0,4187
690765,2022-05-04,Itanhandu/MG,0,63,0,4187
696362,2022-05-05,Itanhandu/MG,0,63,1,4188
701959,2022-05-06,Itanhandu/MG,0,63,0,4188
707556,2022-05-07,Itanhandu/MG,0,63,0,4188
713153,2022-05-08,Itanhandu/MG,0,63,0,4188
718750,2022-05-09,Itanhandu/MG,0,63,0,4188
724347,2022-05-10,Itanhandu/MG,0,63,0,4188
729944,2022-05-11,Itanhandu/MG,0,63,0,4188
735541,2022-05-12,Itanhandu/MG,0,63,0,4188
741138,2022-05-13,Itanhandu/MG,0,63,0,4188
746735,2022-05-14,Itanhandu/MG,0,63,0,4188
752332,2022-05-15,Itanhandu/MG,0,63,0,4188
757929,2022-05-16,Itanhandu/MG,0,63,9,4197
763526,2022-05-17,Itanhandu/MG,0,63,0,4197
769123,2022-05-18,Itanhandu/MG,0,63,0,4197
774720,2022-05-19,Itanhandu/MG,0,63,0,4197
780317,2022-05-20,Itanhandu/MG,0,63,2,4199
785914,2022-05-21,Itanhandu/MG,0,63,0,4199
791511,2022-05-22,Itanhandu/MG,0,63,0,4199
797108,2022-05-23,Itanhandu/MG,0,63,4,4203
802705,2022-05-24,Itanhandu/MG,0,63,0,4203
808302,2022-05-25,Itanhandu/MG,0,63,0,4203
813899,2022-05-26,Itanhandu/MG,0,63,0,4203
819496,2022-05-27,Itanhandu/MG,0,63,8,4211
825093,2022-05-28,Itanhandu/MG,0,63,0,4211
830690,2022-05-29,Itanhandu/MG,0,63,0,4211
836287,2022-05-30,Itanhandu/MG,0,63,7,4218
841884,2022-05-31,Itanhandu/MG,0,63,0,4218
847481,2022-06-01,Itanhandu/MG,0,63,4,4222
853078,2022-06-02,Itanhandu/MG,0,63,3,4225
858675,2022-06-03,Itanhandu/MG,0,63,3,4228
864272,2022-06-04,Itanhandu/MG,0,63,0,4228
869869,2022-06-05,Itanhandu/MG,0,63,0,4228
875466,2022-06-06,Itanhandu/MG,0,63,12,4240
881063,2022-06-07,Itanhandu/MG,0,63,0,4240
886660,2022-06-08,Itanhandu/MG,0,63,13,4253
892257,2022-06-09,Itanhandu/MG,0,63,5,4258
897854,2022-06-10,Itanhandu/MG,0,63,2,4260
903451,2022-06-11,Itanhandu/MG,0,63,0,4260
909048,2022-06-12,Itanhandu/MG,0,63,0,4260
914645,2022-06-13,Itanhandu/MG,0,63,17,4277
920242,2022-06-14,Itanhandu/MG,0,63,0,4277
925839,2022-06-15,Itanhandu/MG,0,63,8,4285
931436,2022-06-16,Itanhandu/MG,0,63,0,4285
937033,2022-06-17,Itanhandu/MG,0,63,0,4285
942630,2022-06-18,Itanhandu/MG,0,63,0,4285
948227,2022-06-19,Itanhandu/MG,0,63,0,4285
953824,2022-06-20,Itanhandu/MG,0,63,3,4288
959421,2022-06-21,Itanhandu/MG,0,63,1,4289
965018,2022-06-22,Itanhandu/MG,0,63,14,4303
970615,2022-06-23,Itanhandu/MG,0,63,7,4310
976212,2022-06-24,Itanhandu/MG,0,63,15,4325
981809,2022-06-25,Itanhandu/MG,0,63,0,4325
987406,2022-06-26,Itanhandu/MG,0,63,0,4325
993003,2022-06-27,Itanhandu/MG,0,63,38,4363
998600,2022-06-28,Itanhandu/MG,0,63,0,4363
1004197,2022-06-29,Itanhandu/MG,0,63,23,4386
1009794,2022-06-30,Itanhandu/MG,0,63,20,4406
1015391,2022-07-01,Itanhandu/MG,0,63,28,4434
1020988,2022-07-02,Itanhandu/MG,0,63,0,4434
1026585,2022-07-03,Itanhandu/MG,0,63,0,4434
1032182,2022-07-04,Itanhandu/MG,0,63,29,4463
1037779,2022-07-05,Itanhandu/MG,0,63,0,4463
1043376,2022-07-06,Itanhandu/MG,0,63,22,4485
1048973,2022-07-07,Itanhandu/MG,0,63,12,4497
1054570,2022-07-08,Itanhandu/MG,0,63,18,4515
1060167,2022-07-09,Itanhandu/MG,0,63,0,4515
1065764,2022-07-10,Itanhandu/MG,0,63,0,4515
1071361,2022-07-11,Itanhandu/MG,0,63,40,4555
1076958,2022-07-12,Itanhandu/MG,0,63,0,4555
1082555,2022-07-13,Itanhandu/MG,0,63,15,4570
1088152,2022-07-14,Itanhandu/MG,0,63,23,4593
1093749,2022-07-15,Itanhandu/MG,0,63,8,4601
1099346,2022-07-16,Itanhandu/MG,0,63,0,4601
1104943,2022-07-17,Itanhandu/MG,0,63,0,4601
1110540,2022-07-18,Itanhandu/MG,0,63,35,4636
1116137,2022-07-19,Itanhandu/MG,0,63,0,4636
1121734,2022-07-20,Itanhandu/MG,0,63,7,4643
1127331,2022-07-21,Itanhandu/MG,0,63,2,4645
1132928,2022-07-22,Itanhandu/MG,0,63,4,4649
1138525,2022-07-23,Itanhandu/MG,0,63,0,4649
1144122,2022-07-24,Itanhandu/MG,0,63,0,4649
1149719,2022-07-25,Itanhandu/MG,0,63,12,4661
1155316,2022-07-26,Itanhandu/MG,0,63,0,4661
1160913,2022-07-27,Itanhandu/MG,0,63,3,4664
1166510,2022-07-28,Itanhandu/MG,0,63,1,4665
1172107,2022-07-29,Itanhandu/MG,0,63,0,4665
1177704,2022-07-30,Itanhandu/MG,0,63,0,4665
1183301,2022-07-31,Itanhandu/MG,0,63,0,4665
1188898,2022-08-01,Itanhandu/MG,0,63,9,4674
1194495,2022-08-02,Itanhandu/MG,0,63,0,4674
1200092,2022-08-03,Itanhandu/MG,0,63,0,4674
1205689,2022-08-04,Itanhandu/MG,0,63,5,4679
1211286,2022-08-05,Itanhandu/MG,0,63,1,4680
1216883,2022-08-06,Itanhandu/MG,0,63,0,4680
1222480,2022-08-07,Itanhandu/MG,0,63,0,4680
1228077,2022-08-08,Itanhandu/MG,0,63,1,4681
1233674,2022-08-09,Itanhandu/MG,0,63,0,4681
1239271,2022-08-10,Itanhandu/MG,0,63,0,4681
1244868,2022-08-11,Itanhandu/MG,0,63,0,4681
1250465,2022-08-12,Itanhandu/MG,0,63,1,4682
1256062,2022-08-13,Itanhandu/MG,0,63,0,4682
1261659,2022-08-14,Itanhandu/MG,0,63,0,4682
1267256,2022-08-15,Itanhandu/MG,0,63,0,4682
1272853,2022-08-16,Itanhandu/MG,0,63,5,4687
1278450,2022-08-17,Itanhandu/MG,1,64,0,4687
1284047,2022-08-18,Itanhandu/MG,0,64,1,4688
1289644,2022-08-19,Itanhandu/MG,0,64,0,4688
1295241,2022-08-20,Itanhandu/MG,0,64,0,4688
1300838,2022-08-21,Itanhandu/MG,0,64,0,4688
1306435,2022-08-22,Itanhandu/MG,0,64,1,4689
1312032,2022-08-23,Itanhandu/MG,0,64,0,4689
1317629,2022-08-24,Itanhandu/MG,0,64,0,4689
1323226,2022-08-25,Itanhandu/MG,0,64,0,4689
2474,2022-01-01,Jacutinga/MG,0,51,0,2634
8071,2022-01-02,Jacutinga/MG,0,51,0,2634
13668,2022-01-03,Jacutinga/MG,0,51,0,2634
19265,2022-01-04,Jacutinga/MG,0,51,0,2634
24862,2022-01-05,Jacutinga/MG,0,51,0,2634
30459,2022-01-06,Jacutinga/MG,0,51,0,2634
36056,2022-01-07,Jacutinga/MG,0,51,52,2686
41653,2022-01-08,Jacutinga/MG,0,51,0,2686
47250,2022-01-09,Jacutinga/MG,0,51,0,2686
52847,2022-01-10,Jacutinga/MG,0,51,0,2686
58444,2022-01-11,Jacutinga/MG,0,51,0,2686
64041,2022-01-12,Jacutinga/MG,0,51,0,2686
69638,2022-01-13,Jacutinga/MG,0,51,0,2686
75235,2022-01-14,Jacutinga/MG,0,51,142,2828
80832,2022-01-15,Jacutinga/MG,0,51,0,2828
86429,2022-01-16,Jacutinga/MG,0,51,0,2828
92026,2022-01-17,Jacutinga/MG,0,51,0,2828
97623,2022-01-18,Jacutinga/MG,0,51,0,2828
103220,2022-01-19,Jacutinga/MG,0,51,0,2828
108817,2022-01-20,Jacutinga/MG,0,51,0,2828
114414,2022-01-21,Jacutinga/MG,0,51,0,2828
120011,2022-01-22,Jacutinga/MG,0,51,94,2922
125608,2022-01-23,Jacutinga/MG,0,51,0,2922
131205,2022-01-24,Jacutinga/MG,0,51,0,2922
136802,2022-01-25,Jacutinga/MG,0,51,0,2922
142399,2022-01-26,Jacutinga/MG,2,53,0,2922
147996,2022-01-27,Jacutinga/MG,0,53,250,3172
153593,2022-01-28,Jacutinga/MG,0,53,0,3172
159190,2022-01-29,Jacutinga/MG,1,54,0,3172
164787,2022-01-30,Jacutinga/MG,0,54,0,3172
170384,2022-01-31,Jacutinga/MG,0,54,0,3172
175981,2022-02-01,Jacutinga/MG,0,54,0,3172
181578,2022-02-02,Jacutinga/MG,1,55,0,3172
187175,2022-02-03,Jacutinga/MG,0,55,0,3172
192772,2022-02-04,Jacutinga/MG,0,55,453,3625
198369,2022-02-05,Jacutinga/MG,0,55,0,3625
203966,2022-02-06,Jacutinga/MG,0,55,40,3665
209563,2022-02-07,Jacutinga/MG,0,55,0,3665
215160,2022-02-08,Jacutinga/MG,0,55,0,3665
220757,2022-02-09,Jacutinga/MG,0,55,56,3721
226354,2022-02-10,Jacutinga/MG,0,55,0,3721
231951,2022-02-11,Jacutinga/MG,0,55,0,3721
237548,2022-02-12,Jacutinga/MG,0,55,0,3721
243145,2022-02-13,Jacutinga/MG,0,55,0,3721
248742,2022-02-14,Jacutinga/MG,0,55,0,3721
254339,2022-02-15,Jacutinga/MG,0,55,0,3721
259936,2022-02-16,Jacutinga/MG,0,55,0,3721
265533,2022-02-17,Jacutinga/MG,0,55,0,3721
271130,2022-02-18,Jacutinga/MG,0,55,0,3721
276727,2022-02-19,Jacutinga/MG,1,56,0,3721
282324,2022-02-20,Jacutinga/MG,0,56,0,3721
287921,2022-02-21,Jacutinga/MG,0,56,0,3721
293518,2022-02-22,Jacutinga/MG,0,56,0,3721
299115,2022-02-23,Jacutinga/MG,0,56,0,3721
304712,2022-02-24,Jacutinga/MG,0,56,0,3721
310309,2022-02-25,Jacutinga/MG,2,58,0,3721
315906,2022-02-26,Jacutinga/MG,0,58,174,3895
321503,2022-02-27,Jacutinga/MG,0,58,0,3895
327100,2022-02-28,Jacutinga/MG,0,58,0,3895
332697,2022-03-01,Jacutinga/MG,0,58,0,3895
338294,2022-03-02,Jacutinga/MG,0,58,0,3895
343891,2022-03-03,Jacutinga/MG,0,58,0,3895
349488,2022-03-04,Jacutinga/MG,0,58,0,3895
355085,2022-03-05,Jacutinga/MG,0,58,0,3895
360682,2022-03-06,Jacutinga/MG,0,58,0,3895
366279,2022-03-07,Jacutinga/MG,0,58,0,3895
371876,2022-03-08,Jacutinga/MG,1,59,0,3895
377473,2022-03-09,Jacutinga/MG,0,59,0,3895
383070,2022-03-10,Jacutinga/MG,0,59,0,3895
388667,2022-03-11,Jacutinga/MG,0,59,0,3895
394264,2022-03-12,Jacutinga/MG,0,59,0,3895
399861,2022-03-13,Jacutinga/MG,0,59,0,3895
405458,2022-03-14,Jacutinga/MG,0,59,0,3895
411055,2022-03-15,Jacutinga/MG,0,59,0,3895
416652,2022-03-16,Jacutinga/MG,0,59,0,3895
422249,2022-03-17,Jacutinga/MG,0,59,0,3895
427846,2022-03-18,Jacutinga/MG,0,59,0,3895
433443,2022-03-19,Jacutinga/MG,0,59,0,3895
439040,2022-03-20,Jacutinga/MG,0,59,0,3895
444637,2022-03-21,Jacutinga/MG,0,59,0,3895
450234,2022-03-22,Jacutinga/MG,0,59,0,3895
455831,2022-03-23,Jacutinga/MG,0,59,0,3895
461428,2022-03-24,Jacutinga/MG,0,59,0,3895
467025,2022-03-25,Jacutinga/MG,0,59,0,3895
472622,2022-03-26,Jacutinga/MG,0,59,0,3895
478219,2022-03-27,Jacutinga/MG,0,59,0,3895
483816,2022-03-28,Jacutinga/MG,0,59,0,3895
489413,2022-03-29,Jacutinga/MG,0,59,0,3895
495010,2022-03-30,Jacutinga/MG,0,59,0,3895
500607,2022-03-31,Jacutinga/MG,0,59,0,3895
506204,2022-04-01,Jacutinga/MG,0,59,0,3895
511801,2022-04-02,Jacutinga/MG,0,59,0,3895
517398,2022-04-03,Jacutinga/MG,0,59,0,3895
522995,2022-04-04,Jacutinga/MG,0,59,0,3895
528592,2022-04-05,Jacutinga/MG,0,59,0,3895
534189,2022-04-06,Jacutinga/MG,0,59,0,3895
539786,2022-04-07,Jacutinga/MG,0,59,0,3895
545383,2022-04-08,Jacutinga/MG,0,59,0,3895
550980,2022-04-09,Jacutinga/MG,0,59,38,3933
556577,2022-04-10,Jacutinga/MG,0,59,0,3933
562174,2022-04-11,Jacutinga/MG,0,59,0,3933
567771,2022-04-12,Jacutinga/MG,0,59,0,3933
573368,2022-04-13,Jacutinga/MG,0,59,0,3933
578965,2022-04-14,Jacutinga/MG,0,59,0,3933
584562,2022-04-15,Jacutinga/MG,0,59,0,3933
590159,2022-04-16,Jacutinga/MG,0,59,0,3933
595756,2022-04-17,Jacutinga/MG,0,59,0,3933
601353,2022-04-18,Jacutinga/MG,0,59,0,3933
606950,2022-04-19,Jacutinga/MG,0,59,0,3933
612547,2022-04-20,Jacutinga/MG,0,59,0,3933
618144,2022-04-21,Jacutinga/MG,0,59,0,3933
623741,2022-04-22,Jacutinga/MG,0,59,0,3933
629338,2022-04-23,Jacutinga/MG,0,59,0,3933
634935,2022-04-24,Jacutinga/MG,0,59,0,3933
640532,2022-04-25,Jacutinga/MG,0,59,0,3933
646129,2022-04-26,Jacutinga/MG,0,59,0,3933
651726,2022-04-27,Jacutinga/MG,0,59,0,3933
657323,2022-04-28,Jacutinga/MG,0,59,0,3933
662920,2022-04-29,Jacutinga/MG,0,59,0,3933
668517,2022-04-30,Jacutinga/MG,0,59,0,3933
674114,2022-05-01,Jacutinga/MG,0,59,0,3933
679711,2022-05-02,Jacutinga/MG,0,59,0,3933
685308,2022-05-03,Jacutinga/MG,0,59,0,3933
690905,2022-05-04,Jacutinga/MG,0,59,0,3933
696502,2022-05-05,Jacutinga/MG,0,59,0,3933
702099,2022-05-06,Jacutinga/MG,0,59,0,3933
707696,2022-05-07,Jacutinga/MG,0,59,0,3933
713293,2022-05-08,Jacutinga/MG,0,59,0,3933
718890,2022-05-09,Jacutinga/MG,0,59,0,3933
724487,2022-05-10,Jacutinga/MG,0,59,0,3933
730084,2022-05-11,Jacutinga/MG,0,59,0,3933
735681,2022-05-12,Jacutinga/MG,0,59,0,3933
741278,2022-05-13,Jacutinga/MG,0,59,0,3933
746875,2022-05-14,Jacutinga/MG,0,59,0,3933
752472,2022-05-15,Jacutinga/MG,0,59,0,3933
758069,2022-05-16,Jacutinga/MG,1,60,0,3933
763666,2022-05-17,Jacutinga/MG,0,60,0,3933
769263,2022-05-18,Jacutinga/MG,0,60,0,3933
774860,2022-05-19,Jacutinga/MG,0,60,0,3933
780457,2022-05-20,Jacutinga/MG,0,60,0,3933
786054,2022-05-21,Jacutinga/MG,0,60,0,3933
791651,2022-05-22,Jacutinga/MG,0,60,0,3933
797248,2022-05-23,Jacutinga/MG,0,60,0,3933
802845,2022-05-24,Jacutinga/MG,0,60,0,3933
808442,2022-05-25,Jacutinga/MG,0,60,0,3933
814039,2022-05-26,Jacutinga/MG,0,60,0,3933
819636,2022-05-27,Jacutinga/MG,0,60,36,3969
825233,2022-05-28,Jacutinga/MG,0,60,0,3969
830830,2022-05-29,Jacutinga/MG,0,60,0,3969
836427,2022-05-30,Jacutinga/MG,0,60,0,3969
842024,2022-05-31,Jacutinga/MG,0,60,0,3969
847621,2022-06-01,Jacutinga/MG,0,60,70,4039
853218,2022-06-02,Jacutinga/MG,0,60,0,4039
858815,2022-06-03,Jacutinga/MG,0,60,0,4039
864412,2022-06-04,Jacutinga/MG,0,60,0,4039
870009,2022-06-05,Jacutinga/MG,0,60,0,4039
875606,2022-06-06,Jacutinga/MG,0,60,0,4039
881203,2022-06-07,Jacutinga/MG,0,60,0,4039
886800,2022-06-08,Jacutinga/MG,0,60,0,4039
892397,2022-06-09,Jacutinga/MG,0,60,0,4039
897994,2022-06-10,Jacutinga/MG,0,60,0,4039
903591,2022-06-11,Jacutinga/MG,0,60,0,4039
909188,2022-06-12,Jacutinga/MG,0,60,0,4039
914785,2022-06-13,Jacutinga/MG,0,60,0,4039
920382,2022-06-14,Jacutinga/MG,0,60,0,4039
925979,2022-06-15,Jacutinga/MG,0,60,0,4039
931576,2022-06-16,Jacutinga/MG,0,60,0,4039
937173,2022-06-17,Jacutinga/MG,0,60,0,4039
942770,2022-06-18,Jacutinga/MG,0,60,0,4039
948367,2022-06-19,Jacutinga/MG,0,60,0,4039
953964,2022-06-20,Jacutinga/MG,0,60,0,4039
959561,2022-06-21,Jacutinga/MG,1,61,0,4039
965158,2022-06-22,Jacutinga/MG,0,61,82,4121
970755,2022-06-23,Jacutinga/MG,0,61,0,4121
976352,2022-06-24,Jacutinga/MG,0,61,0,4121
981949,2022-06-25,Jacutinga/MG,0,61,0,4121
987546,2022-06-26,Jacutinga/MG,0,61,0,4121
993143,2022-06-27,Jacutinga/MG,0,61,0,4121
998740,2022-06-28,Jacutinga/MG,0,61,0,4121
1004337,2022-06-29,Jacutinga/MG,0,61,52,4173
1009934,2022-06-30,Jacutinga/MG,0,61,0,4173
1015531,2022-07-01,Jacutinga/MG,0,61,96,4269
1021128,2022-07-02,Jacutinga/MG,0,61,0,4269
1026725,2022-07-03,Jacutinga/MG,0,61,0,4269
1032322,2022-07-04,Jacutinga/MG,0,61,0,4269
1037919,2022-07-05,Jacutinga/MG,0,61,0,4269
1043516,2022-07-06,Jacutinga/MG,0,61,0,4269
1049113,2022-07-07,Jacutinga/MG,0,61,0,4269
1054710,2022-07-08,Jacutinga/MG,0,61,0,4269
1060307,2022-07-09,Jacutinga/MG,0,61,0,4269
1065904,2022-07-10,Jacutinga/MG,0,61,0,4269
1071501,2022-07-11,Jacutinga/MG,0,61,0,4269
1077098,2022-07-12,Jacutinga/MG,0,61,0,4269
1082695,2022-07-13,Jacutinga/MG,0,61,93,4362
1088292,2022-07-14,Jacutinga/MG,0,61,0,4362
1093889,2022-07-15,Jacutinga/MG,0,61,0,4362
1099486,2022-07-16,Jacutinga/MG,0,61,0,4362
1105083,2022-07-17,Jacutinga/MG,0,61,0,4362
1110680,2022-07-18,Jacutinga/MG,0,61,0,4362
1116277,2022-07-19,Jacutinga/MG,0,61,0,4362
1121874,2022-07-20,Jacutinga/MG,0,61,0,4362
1127471,2022-07-21,Jacutinga/MG,0,61,0,4362
1133068,2022-07-22,Jacutinga/MG,0,61,0,4362
1138665,2022-07-23,Jacutinga/MG,0,61,0,4362
1144262,2022-07-24,Jacutinga/MG,0,61,0,4362
1149859,2022-07-25,Jacutinga/MG,0,61,0,4362
1155456,2022-07-26,Jacutinga/MG,0,61,0,4362
1161053,2022-07-27,Jacutinga/MG,0,61,0,4362
1166650,2022-07-28,Jacutinga/MG,0,61,0,4362
1172247,2022-07-29,Jacutinga/MG,0,61,0,4362
1177844,2022-07-30,Jacutinga/MG,0,61,0,4362
1183441,2022-07-31,Jacutinga/MG,0,61,0,4362
1189038,2022-08-01,Jacutinga/MG,0,61,0,4362
1194635,2022-08-02,Jacutinga/MG,0,61,0,4362
1200232,2022-08-03,Jacutinga/MG,0,61,0,4362
1205829,2022-08-04,Jacutinga/MG,0,61,0,4362
1211426,2022-08-05,Jacutinga/MG,0,61,0,4362
1217023,2022-08-06,Jacutinga/MG,0,61,0,4362
1222620,2022-08-07,Jacutinga/MG,0,61,0,4362
1228217,2022-08-08,Jacutinga/MG,0,61,0,4362
1233814,2022-08-09,Jacutinga/MG,0,61,0,4362
1239411,2022-08-10,Jacutinga/MG,0,61,0,4362
1245008,2022-08-11,Jacutinga/MG,0,61,0,4362
1250605,2022-08-12,Jacutinga/MG,0,61,0,4362
1256202,2022-08-13,Jacutinga/MG,0,61,0,4362
1261799,2022-08-14,Jacutinga/MG,0,61,0,4362
1267396,2022-08-15,Jacutinga/MG,0,61,0,4362
1272993,2022-08-16,Jacutinga/MG,0,61,250,4612
1278590,2022-08-17,Jacutinga/MG,0,61,0,4612
1284187,2022-08-18,Jacutinga/MG,0,61,0,4612
1289784,2022-08-19,Jacutinga/MG,0,61,0,4612
1295381,2022-08-20,Jacutinga/MG,0,61,0,4612
1300978,2022-08-21,Jacutinga/MG,0,61,0,4612
1306575,2022-08-22,Jacutinga/MG,0,61,0,4612
1312172,2022-08-23,Jacutinga/MG,0,61,0,4612
1317769,2022-08-24,Jacutinga/MG,0,61,0,4612
1323366,2022-08-25,Jacutinga/MG,0,61,0,4612
2724,2022-01-01,Lambari/MG,0,41,0,2223
8321,2022-01-02,Lambari/MG,0,41,0,2223
13918,2022-01-03,Lambari/MG,0,41,6,2229
19515,2022-01-04,Lambari/MG,0,41,0,2229
25112,2022-01-05,Lambari/MG,0,41,0,2229
30709,2022-01-06,Lambari/MG,0,41,0,2229
36306,2022-01-07,Lambari/MG,0,41,34,2263
41903,2022-01-08,Lambari/MG,0,41,25,2288
47500,2022-01-09,Lambari/MG,0,41,43,2331
53097,2022-01-10,Lambari/MG,0,41,7,2338
58694,2022-01-11,Lambari/MG,0,41,0,2338
64291,2022-01-12,Lambari/MG,0,41,0,2338
69888,2022-01-13,Lambari/MG,0,41,45,2383
75485,2022-01-14,Lambari/MG,0,41,33,2416
81082,2022-01-15,Lambari/MG,0,41,39,2455
86679,2022-01-16,Lambari/MG,0,41,0,2455
92276,2022-01-17,Lambari/MG,0,41,72,2527
97873,2022-01-18,Lambari/MG,0,41,0,2527
103470,2022-01-19,Lambari/MG,0,41,42,2569
109067,2022-01-20,Lambari/MG,0,41,37,2606
114664,2022-01-21,Lambari/MG,0,41,67,2673
120261,2022-01-22,Lambari/MG,0,41,42,2715
125858,2022-01-23,Lambari/MG,0,41,93,2808
131455,2022-01-24,Lambari/MG,0,41,4,2812
137052,2022-01-25,Lambari/MG,0,41,0,2812
142649,2022-01-26,Lambari/MG,0,41,37,2849
148246,2022-01-27,Lambari/MG,0,41,53,2902
153843,2022-01-28,Lambari/MG,0,41,85,2987
159440,2022-01-29,Lambari/MG,1,42,103,3090
165037,2022-01-30,Lambari/MG,0,42,0,3090
170634,2022-01-31,Lambari/MG,0,42,70,3160
176231,2022-02-01,Lambari/MG,0,42,0,3160
181828,2022-02-02,Lambari/MG,0,42,57,3217
187425,2022-02-03,Lambari/MG,0,42,66,3283
193022,2022-02-04,Lambari/MG,0,42,56,3339
198619,2022-02-05,Lambari/MG,0,42,51,3390
204216,2022-02-06,Lambari/MG,0,42,50,3440
209813,2022-02-07,Lambari/MG,0,42,3,3443
215410,2022-02-08,Lambari/MG,0,42,0,3443
221007,2022-02-09,Lambari/MG,0,42,52,3495
226604,2022-02-10,Lambari/MG,0,42,38,3533
232201,2022-02-11,Lambari/MG,1,43,33,3566
237798,2022-02-12,Lambari/MG,0,43,16,3582
243395,2022-02-13,Lambari/MG,0,43,37,3619
248992,2022-02-14,Lambari/MG,0,43,0,3619
254589,2022-02-15,Lambari/MG,0,43,4,3623
260186,2022-02-16,Lambari/MG,0,43,24,3647
265783,2022-02-17,Lambari/MG,1,44,29,3676
271380,2022-02-18,Lambari/MG,0,44,29,3705
276977,2022-02-19,Lambari/MG,0,44,20,3725
282574,2022-02-20,Lambari/MG,0,44,21,3746
288171,2022-02-21,Lambari/MG,0,44,1,3747
293768,2022-02-22,Lambari/MG,0,44,0,3747
299365,2022-02-23,Lambari/MG,0,44,22,3769
304962,2022-02-24,Lambari/MG,0,44,18,3787
310559,2022-02-25,Lambari/MG,0,44,15,3802
316156,2022-02-26,Lambari/MG,0,44,9,3811
321753,2022-02-27,Lambari/MG,0,44,2,3813
327350,2022-02-28,Lambari/MG,0,44,0,3813
332947,2022-03-01,Lambari/MG,0,44,3,3816
338544,2022-03-02,Lambari/MG,0,44,0,3816
344141,2022-03-03,Lambari/MG,0,44,12,3828
349738,2022-03-04,Lambari/MG,0,44,8,3836
355335,2022-03-05,Lambari/MG,0,44,7,3843
360932,2022-03-06,Lambari/MG,0,44,6,3849
366529,2022-03-07,Lambari/MG,0,44,0,3849
372126,2022-03-08,Lambari/MG,0,44,0,3849
377723,2022-03-09,Lambari/MG,0,44,0,3849
383320,2022-03-10,Lambari/MG,0,44,15,3864
388917,2022-03-11,Lambari/MG,0,44,9,3873
394514,2022-03-12,Lambari/MG,0,44,8,3881
400111,2022-03-13,Lambari/MG,0,44,11,3892
405708,2022-03-14,Lambari/MG,0,44,0,3892
411305,2022-03-15,Lambari/MG,0,44,0,3892
416902,2022-03-16,Lambari/MG,0,44,6,3898
422499,2022-03-17,Lambari/MG,0,44,0,3898
428096,2022-03-18,Lambari/MG,0,44,5,3903
433693,2022-03-19,Lambari/MG,0,44,2,3905
439290,2022-03-20,Lambari/MG,0,44,0,3905
444887,2022-03-21,Lambari/MG,0,44,2,3907
450484,2022-03-22,Lambari/MG,0,44,0,3907
456081,2022-03-23,Lambari/MG,0,44,0,3907
461678,2022-03-24,Lambari/MG,0,44,3,3910
467275,2022-03-25,Lambari/MG,0,44,4,3914
472872,2022-03-26,Lambari/MG,0,44,2,3916
478469,2022-03-27,Lambari/MG,0,44,0,3916
484066,2022-03-28,Lambari/MG,0,44,0,3916
489663,2022-03-29,Lambari/MG,0,44,17,3933
495260,2022-03-30,Lambari/MG,0,44,2,3935
500857,2022-03-31,Lambari/MG,0,44,3,3938
506454,2022-04-01,Lambari/MG,0,44,0,3938
512051,2022-04-02,Lambari/MG,0,44,0,3938
517648,2022-04-03,Lambari/MG,0,44,0,3938
523245,2022-04-04,Lambari/MG,0,44,3,3941
528842,2022-04-05,Lambari/MG,0,44,0,3941
534439,2022-04-06,Lambari/MG,0,44,0,3941
540036,2022-04-07,Lambari/MG,0,44,3,3944
545633,2022-04-08,Lambari/MG,0,44,0,3944
551230,2022-04-09,Lambari/MG,0,44,1,3945
556827,2022-04-10,Lambari/MG,0,44,1,3946
562424,2022-04-11,Lambari/MG,0,44,0,3946
568021,2022-04-12,Lambari/MG,0,44,0,3946
573618,2022-04-13,Lambari/MG,0,44,3,3949
579215,2022-04-14,Lambari/MG,0,44,0,3949
584812,2022-04-15,Lambari/MG,0,44,3,3952
590409,2022-04-16,Lambari/MG,0,44,2,3954
596006,2022-04-17,Lambari/MG,0,44,0,3954
601603,2022-04-18,Lambari/MG,0,44,0,3954
607200,2022-04-19,Lambari/MG,0,44,0,3954
612797,2022-04-20,Lambari/MG,0,44,0,3954
618394,2022-04-21,Lambari/MG,0,44,1,3955
623991,2022-04-22,Lambari/MG,0,44,6,3961
629588,2022-04-23,Lambari/MG,0,44,0,3961
635185,2022-04-24,Lambari/MG,0,44,0,3961
640782,2022-04-25,Lambari/MG,0,44,0,3961
646379,2022-04-26,Lambari/MG,0,44,1,3962
651976,2022-04-27,Lambari/MG,0,44,0,3962
657573,2022-04-28,Lambari/MG,0,44,5,3967
663170,2022-04-29,Lambari/MG,0,44,7,3974
668767,2022-04-30,Lambari/MG,0,44,3,3977
674364,2022-05-01,Lambari/MG,0,44,0,3977
679961,2022-05-02,Lambari/MG,0,44,0,3977
685558,2022-05-03,Lambari/MG,0,44,0,3977
691155,2022-05-04,Lambari/MG,0,44,0,3977
696752,2022-05-05,Lambari/MG,0,44,0,3977
702349,2022-05-06,Lambari/MG,0,44,0,3977
707946,2022-05-07,Lambari/MG,0,44,0,3977
713543,2022-05-08,Lambari/MG,0,44,0,3977
719140,2022-05-09,Lambari/MG,0,44,0,3977
724737,2022-05-10,Lambari/MG,0,44,0,3977
730334,2022-05-11,Lambari/MG,1,45,2,3979
735931,2022-05-12,Lambari/MG,0,45,0,3979
741528,2022-05-13,Lambari/MG,0,45,2,3981
747125,2022-05-14,Lambari/MG,0,45,0,3981
752722,2022-05-15,Lambari/MG,0,45,0,3981
758319,2022-05-16,Lambari/MG,0,45,0,3981
763916,2022-05-17,Lambari/MG,0,45,8,3989
769513,2022-05-18,Lambari/MG,0,45,6,3995
775110,2022-05-19,Lambari/MG,0,45,0,3995
780707,2022-05-20,Lambari/MG,0,45,5,4000
786304,2022-05-21,Lambari/MG,0,45,0,4000
791901,2022-05-22,Lambari/MG,0,45,0,4000
797498,2022-05-23,Lambari/MG,0,45,3,4003
803095,2022-05-24,Lambari/MG,0,45,5,4008
808692,2022-05-25,Lambari/MG,0,45,9,4017
814289,2022-05-26,Lambari/MG,0,45,3,4020
819886,2022-05-27,Lambari/MG,0,45,0,4020
825483,2022-05-28,Lambari/MG,0,45,0,4020
831080,2022-05-29,Lambari/MG,0,45,0,4020
836677,2022-05-30,Lambari/MG,0,45,24,4044
842274,2022-05-31,Lambari/MG,0,45,0,4044
847871,2022-06-01,Lambari/MG,0,45,0,4044
853468,2022-06-02,Lambari/MG,0,45,26,4070
859065,2022-06-03,Lambari/MG,0,45,28,4098
864662,2022-06-04,Lambari/MG,0,45,0,4098
870259,2022-06-05,Lambari/MG,0,45,0,4098
875856,2022-06-06,Lambari/MG,0,45,24,4122
881453,2022-06-07,Lambari/MG,0,45,25,4147
887050,2022-06-08,Lambari/MG,0,45,23,4170
892647,2022-06-09,Lambari/MG,0,45,13,4183
898244,2022-06-10,Lambari/MG,0,45,20,4203
903841,2022-06-11,Lambari/MG,0,45,0,4203
909438,2022-06-12,Lambari/MG,0,45,0,4203
915035,2022-06-13,Lambari/MG,3,48,36,4239
920632,2022-06-14,Lambari/MG,0,48,0,4239
926229,2022-06-15,Lambari/MG,16,64,53,4292
931826,2022-06-16,Lambari/MG,0,64,0,4292
937423,2022-06-17,Lambari/MG,0,64,0,4292
943020,2022-06-18,Lambari/MG,0,64,0,4292
948617,2022-06-19,Lambari/MG,0,64,0,4292
954214,2022-06-20,Lambari/MG,0,64,22,4314
959811,2022-06-21,Lambari/MG,0,64,3,4317
965408,2022-06-22,Lambari/MG,0,64,25,4342
971005,2022-06-23,Lambari/MG,0,64,14,4356
976602,2022-06-24,Lambari/MG,0,64,17,4373
982199,2022-06-25,Lambari/MG,0,64,0,4373
987796,2022-06-26,Lambari/MG,0,64,0,4373
993393,2022-06-27,Lambari/MG,0,64,16,4389
998990,2022-06-28,Lambari/MG,0,64,0,4389
1004587,2022-06-29,Lambari/MG,0,64,26,4415
1010184,2022-06-30,Lambari/MG,0,64,12,4427
1015781,2022-07-01,Lambari/MG,0,64,22,4449
1021378,2022-07-02,Lambari/MG,0,64,0,4449
1026975,2022-07-03,Lambari/MG,0,64,0,4449
1032572,2022-07-04,Lambari/MG,0,64,9,4458
1038169,2022-07-05,Lambari/MG,0,64,4,4462
1043766,2022-07-06,Lambari/MG,0,64,9,4471
1049363,2022-07-07,Lambari/MG,0,64,9,4480
1054960,2022-07-08,Lambari/MG,0,64,5,4485
1060557,2022-07-09,Lambari/MG,0,64,0,4485
1066154,2022-07-10,Lambari/MG,0,64,0,4485
1071751,2022-07-11,Lambari/MG,0,64,17,4502
1077348,2022-07-12,Lambari/MG,0,64,7,4509
1082945,2022-07-13,Lambari/MG,0,64,4,4513
1088542,2022-07-14,Lambari/MG,0,64,11,4524
1094139,2022-07-15,Lambari/MG,0,64,10,4534
1099736,2022-07-16,Lambari/MG,0,64,0,4534
1105333,2022-07-17,Lambari/MG,0,64,0,4534
1110930,2022-07-18,Lambari/MG,0,64,5,4539
1116527,2022-07-19,Lambari/MG,0,64,0,4539
1122124,2022-07-20,Lambari/MG,0,64,14,4553
1127721,2022-07-21,Lambari/MG,0,64,2,4555
1133318,2022-07-22,Lambari/MG,0,64,0,4555
1138915,2022-07-23,Lambari/MG,0,64,0,4555
1144512,2022-07-24,Lambari/MG,0,64,0,4555
1150109,2022-07-25,Lambari/MG,0,64,4,4559
1155706,2022-07-26,Lambari/MG,0,64,0,4559
1161303,2022-07-27,Lambari/MG,0,64,9,4568
1166900,2022-07-28,Lambari/MG,0,64,0,4568
1172497,2022-07-29,Lambari/MG,0,64,0,4568
1178094,2022-07-30,Lambari/MG,0,64,0,4568
1183691,2022-07-31,Lambari/MG,0,64,0,4568
1189288,2022-08-01,Lambari/MG,0,64,2,4570
1194885,2022-08-02,Lambari/MG,0,64,4,4574
1200482,2022-08-03,Lambari/MG,0,64,0,4574
1206079,2022-08-04,Lambari/MG,0,64,3,4577
1211676,2022-08-05,Lambari/MG,0,64,2,4579
1217273,2022-08-06,Lambari/MG,0,64,0,4579
1222870,2022-08-07,Lambari/MG,0,64,0,4579
1228467,2022-08-08,Lambari/MG,0,64,-1,4578
1234064,2022-08-09,Lambari/MG,0,64,2,4580
1239661,2022-08-10,Lambari/MG,0,64,3,4583
1245258,2022-08-11,Lambari/MG,-1,63,0,4583
1250855,2022-08-12,Lambari/MG,0,63,0,4583
1256452,2022-08-13,Lambari/MG,0,63,0,4583
1262049,2022-08-14,Lambari/MG,0,63,0,4583
1267646,2022-08-15,Lambari/MG,0,63,0,4583
1273243,2022-08-16,Lambari/MG,0,63,1,4584
1278840,2022-08-17,Lambari/MG,0,63,4,4588
1284437,2022-08-18,Lambari/MG,0,63,0,4588
1290034,2022-08-19,Lambari/MG,0,63,0,4588
1295631,2022-08-20,Lambari/MG,0,63,0,4588
1301228,2022-08-21,Lambari/MG,0,63,0,4588
1306825,2022-08-22,Lambari/MG,0,63,-1,4587
1312422,2022-08-23,Lambari/MG,0,63,0,4587
1318019,2022-08-24,Lambari/MG,0,63,1,4588
1323616,2022-08-25,Lambari/MG,0,63,0,4588
2832,2022-01-01,Machado/MG,0,98,0,4726
8429,2022-01-02,Machado/MG,0,98,0,4726
14026,2022-01-03,Machado/MG,0,98,0,4726
19623,2022-01-04,Machado/MG,0,98,0,4726
25220,2022-01-05,Machado/MG,0,98,0,4726
30817,2022-01-06,Machado/MG,0,98,0,4726
36414,2022-01-07,Machado/MG,0,98,207,4933
42011,2022-01-08,Machado/MG,0,98,113,5046
47608,2022-01-09,Machado/MG,0,98,0,5046
53205,2022-01-10,Machado/MG,0,98,0,5046
58802,2022-01-11,Machado/MG,0,98,70,5116
64399,2022-01-12,Machado/MG,0,98,0,5116
69996,2022-01-13,Machado/MG,0,98,0,5116
75593,2022-01-14,Machado/MG,0,98,374,5490
81190,2022-01-15,Machado/MG,0,98,69,5559
86787,2022-01-16,Machado/MG,0,98,0,5559
92384,2022-01-17,Machado/MG,0,98,0,5559
97981,2022-01-18,Machado/MG,0,98,140,5699
103578,2022-01-19,Machado/MG,0,98,188,5887
109175,2022-01-20,Machado/MG,0,98,85,5972
114772,2022-01-21,Machado/MG,0,98,83,6055
120369,2022-01-22,Machado/MG,0,98,111,6166
125966,2022-01-23,Machado/MG,0,98,0,6166
131563,2022-01-24,Machado/MG,0,98,0,6166
137160,2022-01-25,Machado/MG,0,98,0,6166
142757,2022-01-26,Machado/MG,0,98,141,6307
148354,2022-01-27,Machado/MG,0,98,298,6605
153951,2022-01-28,Machado/MG,0,98,0,6605
159548,2022-01-29,Machado/MG,0,98,179,6784
165145,2022-01-30,Machado/MG,0,98,0,6784
170742,2022-01-31,Machado/MG,0,98,0,6784
176339,2022-02-01,Machado/MG,0,98,80,6864
181936,2022-02-02,Machado/MG,0,98,158,7022
187533,2022-02-03,Machado/MG,0,98,0,7022
193130,2022-02-04,Machado/MG,1,99,66,7088
198727,2022-02-05,Machado/MG,6,105,144,7232
204324,2022-02-06,Machado/MG,1,106,0,7232
209921,2022-02-07,Machado/MG,0,106,0,7232
215518,2022-02-08,Machado/MG,1,107,72,7304
221115,2022-02-09,Machado/MG,0,107,148,7452
226712,2022-02-10,Machado/MG,0,107,0,7452
232309,2022-02-11,Machado/MG,0,107,146,7598
237906,2022-02-12,Machado/MG,0,107,44,7642
243503,2022-02-13,Machado/MG,0,107,0,7642
249100,2022-02-14,Machado/MG,0,107,0,7642
254697,2022-02-15,Machado/MG,0,107,0,7642
260294,2022-02-16,Machado/MG,0,107,72,7714
265891,2022-02-17,Machado/MG,0,107,159,7873
271488,2022-02-18,Machado/MG,1,108,57,7930
277085,2022-02-19,Machado/MG,0,108,42,7972
282682,2022-02-20,Machado/MG,0,108,0,7972
288279,2022-02-21,Machado/MG,0,108,0,7972
293876,2022-02-22,Machado/MG,0,108,73,8045
299473,2022-02-23,Machado/MG,0,108,63,8108
305070,2022-02-24,Machado/MG,1,109,61,8169
310667,2022-02-25,Machado/MG,0,109,34,8203
316264,2022-02-26,Machado/MG,0,109,34,8237
321861,2022-02-27,Machado/MG,0,109,0,8237
327458,2022-02-28,Machado/MG,0,109,0,8237
333055,2022-03-01,Machado/MG,0,109,0,8237
338652,2022-03-02,Machado/MG,0,109,0,8237
344249,2022-03-03,Machado/MG,0,109,22,8259
349846,2022-03-04,Machado/MG,0,109,65,8324
355443,2022-03-05,Machado/MG,0,109,28,8352
361040,2022-03-06,Machado/MG,0,109,0,8352
366637,2022-03-07,Machado/MG,0,109,0,8352
372234,2022-03-08,Machado/MG,0,109,0,8352
377831,2022-03-09,Machado/MG,0,109,16,8368
383428,2022-03-10,Machado/MG,1,110,0,8368
389025,2022-03-11,Machado/MG,0,110,35,8403
394622,2022-03-12,Machado/MG,0,110,7,8410
400219,2022-03-13,Machado/MG,0,110,0,8410
405816,2022-03-14,Machado/MG,0,110,0,8410
411413,2022-03-15,Machado/MG,0,110,12,8422
417010,2022-03-16,Machado/MG,1,111,15,8437
422607,2022-03-17,Machado/MG,0,111,0,8437
428204,2022-03-18,Machado/MG,0,111,0,8437
433801,2022-03-19,Machado/MG,0,111,28,8465
439398,2022-03-20,Machado/MG,0,111,0,8465
444995,2022-03-21,Machado/MG,0,111,0,8465
450592,2022-03-22,Machado/MG,0,111,11,8476
456189,2022-03-23,Machado/MG,0,111,12,8488
461786,2022-03-24,Machado/MG,0,111,6,8494
467383,2022-03-25,Machado/MG,0,111,0,8494
472980,2022-03-26,Machado/MG,0,111,0,8494
478577,2022-03-27,Machado/MG,0,111,0,8494
484174,2022-03-28,Machado/MG,0,111,0,8494
489771,2022-03-29,Machado/MG,0,111,20,8514
495368,2022-03-30,Machado/MG,0,111,0,8514
500965,2022-03-31,Machado/MG,0,111,0,8514
506562,2022-04-01,Machado/MG,0,111,0,8514
512159,2022-04-02,Machado/MG,0,111,0,8514
517756,2022-04-03,Machado/MG,0,111,0,8514
523353,2022-04-04,Machado/MG,0,111,24,8538
528950,2022-04-05,Machado/MG,0,111,0,8538
534547,2022-04-06,Machado/MG,0,111,0,8538
540144,2022-04-07,Machado/MG,0,111,2,8540
545741,2022-04-08,Machado/MG,0,111,0,8540
551338,2022-04-09,Machado/MG,0,111,4,8544
556935,2022-04-10,Machado/MG,0,111,0,8544
562532,2022-04-11,Machado/MG,0,111,0,8544
568129,2022-04-12,Machado/MG,0,111,0,8544
573726,2022-04-13,Machado/MG,0,111,0,8544
579323,2022-04-14,Machado/MG,0,111,0,8544
584920,2022-04-15,Machado/MG,0,111,0,8544
590517,2022-04-16,Machado/MG,0,111,0,8544
596114,2022-04-17,Machado/MG,0,111,0,8544
601711,2022-04-18,Machado/MG,0,111,0,8544
607308,2022-04-19,Machado/MG,0,111,0,8544
612905,2022-04-20,Machado/MG,0,111,0,8544
618502,2022-04-21,Machado/MG,0,111,7,8551
624099,2022-04-22,Machado/MG,0,111,0,8551
629696,2022-04-23,Machado/MG,0,111,0,8551
635293,2022-04-24,Machado/MG,0,111,0,8551
640890,2022-04-25,Machado/MG,0,111,0,8551
646487,2022-04-26,Machado/MG,0,111,1,8552
652084,2022-04-27,Machado/MG,0,111,0,8552
657681,2022-04-28,Machado/MG,0,111,0,8552
663278,2022-04-29,Machado/MG,0,111,0,8552
668875,2022-04-30,Machado/MG,0,111,0,8552
674472,2022-05-01,Machado/MG,0,111,0,8552
680069,2022-05-02,Machado/MG,0,111,0,8552
685666,2022-05-03,Machado/MG,0,111,0,8552
691263,2022-05-04,Machado/MG,0,111,0,8552
696860,2022-05-05,Machado/MG,0,111,0,8552
702457,2022-05-06,Machado/MG,0,111,0,8552
708054,2022-05-07,Machado/MG,0,111,0,8552
713651,2022-05-08,Machado/MG,0,111,0,8552
719248,2022-05-09,Machado/MG,0,111,19,8571
724845,2022-05-10,Machado/MG,0,111,0,8571
730442,2022-05-11,Machado/MG,0,111,0,8571
736039,2022-05-12,Machado/MG,0,111,0,8571
741636,2022-05-13,Machado/MG,0,111,0,8571
747233,2022-05-14,Machado/MG,0,111,0,8571
752830,2022-05-15,Machado/MG,0,111,0,8571
758427,2022-05-16,Machado/MG,0,111,0,8571
764024,2022-05-17,Machado/MG,0,111,0,8571
769621,2022-05-18,Machado/MG,0,111,0,8571
775218,2022-05-19,Machado/MG,0,111,0,8571
780815,2022-05-20,Machado/MG,0,111,0,8571
786412,2022-05-21,Machado/MG,0,111,0,8571
792009,2022-05-22,Machado/MG,0,111,0,8571
797606,2022-05-23,Machado/MG,0,111,0,8571
803203,2022-05-24,Machado/MG,0,111,0,8571
808800,2022-05-25,Machado/MG,0,111,0,8571
814397,2022-05-26,Machado/MG,0,111,0,8571
819994,2022-05-27,Machado/MG,0,111,0,8571
825591,2022-05-28,Machado/MG,0,111,0,8571
831188,2022-05-29,Machado/MG,0,111,0,8571
836785,2022-05-30,Machado/MG,0,111,297,8868
842382,2022-05-31,Machado/MG,0,111,0,8868
847979,2022-06-01,Machado/MG,0,111,0,8868
853576,2022-06-02,Machado/MG,0,111,0,8868
859173,2022-06-03,Machado/MG,0,111,0,8868
864770,2022-06-04,Machado/MG,0,111,0,8868
870367,2022-06-05,Machado/MG,0,111,0,8868
875964,2022-06-06,Machado/MG,0,111,226,9094
881561,2022-06-07,Machado/MG,0,111,0,9094
887158,2022-06-08,Machado/MG,0,111,0,9094
892755,2022-06-09,Machado/MG,0,111,0,9094
898352,2022-06-10,Machado/MG,0,111,0,9094
903949,2022-06-11,Machado/MG,0,111,0,9094
909546,2022-06-12,Machado/MG,0,111,0,9094
915143,2022-06-13,Machado/MG,1,112,235,9329
920740,2022-06-14,Machado/MG,0,112,0,9329
926337,2022-06-15,Machado/MG,0,112,0,9329
931934,2022-06-16,Machado/MG,0,112,0,9329
937531,2022-06-17,Machado/MG,0,112,0,9329
943128,2022-06-18,Machado/MG,0,112,0,9329
948725,2022-06-19,Machado/MG,0,112,0,9329
954322,2022-06-20,Machado/MG,0,112,0,9329
959919,2022-06-21,Machado/MG,0,112,0,9329
965516,2022-06-22,Machado/MG,0,112,0,9329
971113,2022-06-23,Machado/MG,0,112,0,9329
976710,2022-06-24,Machado/MG,0,112,0,9329
982307,2022-06-25,Machado/MG,0,112,0,9329
987904,2022-06-26,Machado/MG,0,112,0,9329
993501,2022-06-27,Machado/MG,0,112,173,9502
999098,2022-06-28,Machado/MG,0,112,0,9502
1004695,2022-06-29,Machado/MG,0,112,0,9502
1010292,2022-06-30,Machado/MG,0,112,0,9502
1015889,2022-07-01,Machado/MG,0,112,0,9502
1021486,2022-07-02,Machado/MG,0,112,0,9502
1027083,2022-07-03,Machado/MG,0,112,0,9502
1032680,2022-07-04,Machado/MG,0,112,223,9725
1038277,2022-07-05,Machado/MG,0,112,0,9725
1043874,2022-07-06,Machado/MG,0,112,0,9725
1049471,2022-07-07,Machado/MG,0,112,0,9725
1055068,2022-07-08,Machado/MG,0,112,0,9725
1060665,2022-07-09,Machado/MG,0,112,0,9725
1066262,2022-07-10,Machado/MG,0,112,0,9725
1071859,2022-07-11,Machado/MG,0,112,179,9904
1077456,2022-07-12,Machado/MG,0,112,0,9904
1083053,2022-07-13,Machado/MG,0,112,0,9904
1088650,2022-07-14,Machado/MG,0,112,0,9904
1094247,2022-07-15,Machado/MG,0,112,0,9904
1099844,2022-07-16,Machado/MG,0,112,0,9904
1105441,2022-07-17,Machado/MG,0,112,0,9904
1111038,2022-07-18,Machado/MG,0,112,109,10013
1116635,2022-07-19,Machado/MG,0,112,0,10013
1122232,2022-07-20,Machado/MG,0,112,0,10013
1127829,2022-07-21,Machado/MG,0,112,0,10013
1133426,2022-07-22,Machado/MG,0,112,0,10013
1139023,2022-07-23,Machado/MG,0,112,0,10013
1144620,2022-07-24,Machado/MG,0,112,0,10013
1150217,2022-07-25,Machado/MG,0,112,69,10082
1155814,2022-07-26,Machado/MG,0,112,0,10082
1161411,2022-07-27,Machado/MG,0,112,0,10082
1167008,2022-07-28,Machado/MG,0,112,0,10082
1172605,2022-07-29,Machado/MG,0,112,0,10082
1178202,2022-07-30,Machado/MG,0,112,0,10082
1183799,2022-07-31,Machado/MG,0,112,0,10082
1189396,2022-08-01,Machado/MG,0,112,52,10134
1194993,2022-08-02,Machado/MG,1,113,0,10134
1200590,2022-08-03,Machado/MG,0,113,0,10134
1206187,2022-08-04,Machado/MG,0,113,0,10134
1211784,2022-08-05,Machado/MG,0,113,0,10134
1217381,2022-08-06,Machado/MG,0,113,0,10134
1222978,2022-08-07,Machado/MG,0,113,0,10134
1228575,2022-08-08,Machado/MG,0,113,0,10134
1234172,2022-08-09,Machado/MG,0,113,0,10134
1239769,2022-08-10,Machado/MG,0,113,0,10134
1245366,2022-08-11,Machado/MG,0,113,0,10134
1250963,2022-08-12,Machado/MG,0,113,0,10134
1256560,2022-08-13,Machado/MG,0,113,0,10134
1262157,2022-08-14,Machado/MG,0,113,0,10134
1267754,2022-08-15,Machado/MG,0,113,0,10134
1273351,2022-08-16,Machado/MG,0,113,56,10190
1278948,2022-08-17,Machado/MG,0,113,0,10190
1284545,2022-08-18,Machado/MG,0,113,0,10190
1290142,2022-08-19,Machado/MG,0,113,0,10190
1295739,2022-08-20,Machado/MG,0,113,0,10190
1301336,2022-08-21,Machado/MG,0,113,0,10190
1306933,2022-08-22,Machado/MG,0,113,11,10201
1312530,2022-08-23,Machado/MG,0,113,0,10201
1318127,2022-08-24,Machado/MG,0,113,0,10201
1323724,2022-08-25,Machado/MG,0,113,0,10201
3109,2022-01-01,Monsenhor Paulo/MG,0,10,1,921
8706,2022-01-02,Monsenhor Paulo/MG,0,10,0,921
14303,2022-01-03,Monsenhor Paulo/MG,0,10,0,921
19900,2022-01-04,Monsenhor Paulo/MG,0,10,0,921
25497,2022-01-05,Monsenhor Paulo/MG,0,10,9,930
31094,2022-01-06,Monsenhor Paulo/MG,0,10,0,930
36691,2022-01-07,Monsenhor Paulo/MG,0,10,0,930
42288,2022-01-08,Monsenhor Paulo/MG,0,10,3,933
47885,2022-01-09,Monsenhor Paulo/MG,0,10,0,933
53482,2022-01-10,Monsenhor Paulo/MG,0,10,0,933
59079,2022-01-11,Monsenhor Paulo/MG,0,10,14,947
64676,2022-01-12,Monsenhor Paulo/MG,0,10,0,947
70273,2022-01-13,Monsenhor Paulo/MG,0,10,15,962
75870,2022-01-14,Monsenhor Paulo/MG,0,10,0,962
81467,2022-01-15,Monsenhor Paulo/MG,0,10,10,972
87064,2022-01-16,Monsenhor Paulo/MG,0,10,0,972
92661,2022-01-17,Monsenhor Paulo/MG,0,10,0,972
98258,2022-01-18,Monsenhor Paulo/MG,0,10,0,972
103855,2022-01-19,Monsenhor Paulo/MG,0,10,0,972
109452,2022-01-20,Monsenhor Paulo/MG,0,10,0,972
115049,2022-01-21,Monsenhor Paulo/MG,0,10,0,972
120646,2022-01-22,Monsenhor Paulo/MG,0,10,21,993
126243,2022-01-23,Monsenhor Paulo/MG,0,10,37,1030
131840,2022-01-24,Monsenhor Paulo/MG,0,10,37,1067
137437,2022-01-25,Monsenhor Paulo/MG,0,10,20,1087
143034,2022-01-26,Monsenhor Paulo/MG,0,10,26,1113
148631,2022-01-27,Monsenhor Paulo/MG,0,10,32,1145
154228,2022-01-28,Monsenhor Paulo/MG,0,10,0,1145
159825,2022-01-29,Monsenhor Paulo/MG,0,10,40,1185
165422,2022-01-30,Monsenhor Paulo/MG,0,10,36,1221
171019,2022-01-31,Monsenhor Paulo/MG,0,10,10,1231
176616,2022-02-01,Monsenhor Paulo/MG,0,10,0,1231
182213,2022-02-02,Monsenhor Paulo/MG,0,10,13,1244
187810,2022-02-03,Monsenhor Paulo/MG,0,10,13,1257
193407,2022-02-04,Monsenhor Paulo/MG,0,10,8,1265
199004,2022-02-05,Monsenhor Paulo/MG,0,10,10,1275
204601,2022-02-06,Monsenhor Paulo/MG,0,10,8,1283
210198,2022-02-07,Monsenhor Paulo/MG,0,10,4,1287
215795,2022-02-08,Monsenhor Paulo/MG,0,10,0,1287
221392,2022-02-09,Monsenhor Paulo/MG,0,10,6,1293
226989,2022-02-10,Monsenhor Paulo/MG,0,10,19,1312
232586,2022-02-11,Monsenhor Paulo/MG,0,10,0,1312
238183,2022-02-12,Monsenhor Paulo/MG,0,10,8,1320
243780,2022-02-13,Monsenhor Paulo/MG,0,10,0,1320
249377,2022-02-14,Monsenhor Paulo/MG,0,10,0,1320
254974,2022-02-15,Monsenhor Paulo/MG,0,10,0,1320
260571,2022-02-16,Monsenhor Paulo/MG,0,10,10,1330
266168,2022-02-17,Monsenhor Paulo/MG,0,10,22,1352
271765,2022-02-18,Monsenhor Paulo/MG,0,10,11,1363
277362,2022-02-19,Monsenhor Paulo/MG,0,10,0,1363
282959,2022-02-20,Monsenhor Paulo/MG,0,10,0,1363
288556,2022-02-21,Monsenhor Paulo/MG,0,10,0,1363
294153,2022-02-22,Monsenhor Paulo/MG,0,10,17,1380
299750,2022-02-23,Monsenhor Paulo/MG,0,10,0,1380
305347,2022-02-24,Monsenhor Paulo/MG,0,10,6,1386
310944,2022-02-25,Monsenhor Paulo/MG,0,10,0,1386
316541,2022-02-26,Monsenhor Paulo/MG,0,10,10,1396
322138,2022-02-27,Monsenhor Paulo/MG,0,10,14,1410
327735,2022-02-28,Monsenhor Paulo/MG,0,10,0,1410
333332,2022-03-01,Monsenhor Paulo/MG,0,10,1,1411
338929,2022-03-02,Monsenhor Paulo/MG,0,10,0,1411
344526,2022-03-03,Monsenhor Paulo/MG,0,10,0,1411
350123,2022-03-04,Monsenhor Paulo/MG,0,10,13,1424
355720,2022-03-05,Monsenhor Paulo/MG,0,10,0,1424
361317,2022-03-06,Monsenhor Paulo/MG,0,10,0,1424
366914,2022-03-07,Monsenhor Paulo/MG,0,10,1,1425
372511,2022-03-08,Monsenhor Paulo/MG,0,10,0,1425
378108,2022-03-09,Monsenhor Paulo/MG,0,10,2,1427
383705,2022-03-10,Monsenhor Paulo/MG,0,10,0,1427
389302,2022-03-11,Monsenhor Paulo/MG,0,10,1,1428
394899,2022-03-12,Monsenhor Paulo/MG,0,10,0,1428
400496,2022-03-13,Monsenhor Paulo/MG,0,10,2,1430
406093,2022-03-14,Monsenhor Paulo/MG,0,10,1,1431
411690,2022-03-15,Monsenhor Paulo/MG,0,10,0,1431
417287,2022-03-16,Monsenhor Paulo/MG,0,10,2,1433
422884,2022-03-17,Monsenhor Paulo/MG,0,10,1,1434
428481,2022-03-18,Monsenhor Paulo/MG,0,10,0,1434
434078,2022-03-19,Monsenhor Paulo/MG,0,10,0,1434
439675,2022-03-20,Monsenhor Paulo/MG,0,10,0,1434
445272,2022-03-21,Monsenhor Paulo/MG,0,10,0,1434
450869,2022-03-22,Monsenhor Paulo/MG,0,10,0,1434
456466,2022-03-23,Monsenhor Paulo/MG,0,10,1,1435
462063,2022-03-24,Monsenhor Paulo/MG,0,10,0,1435
467660,2022-03-25,Monsenhor Paulo/MG,0,10,0,1435
473257,2022-03-26,Monsenhor Paulo/MG,0,10,0,1435
478854,2022-03-27,Monsenhor Paulo/MG,0,10,0,1435
484451,2022-03-28,Monsenhor Paulo/MG,0,10,0,1435
490048,2022-03-29,Monsenhor Paulo/MG,0,10,0,1435
495645,2022-03-30,Monsenhor Paulo/MG,0,10,1,1436
501242,2022-03-31,Monsenhor Paulo/MG,0,10,0,1436
506839,2022-04-01,Monsenhor Paulo/MG,0,10,0,1436
512436,2022-04-02,Monsenhor Paulo/MG,0,10,0,1436
518033,2022-04-03,Monsenhor Paulo/MG,0,10,0,1436
523630,2022-04-04,Monsenhor Paulo/MG,0,10,1,1437
529227,2022-04-05,Monsenhor Paulo/MG,0,10,0,1437
534824,2022-04-06,Monsenhor Paulo/MG,0,10,0,1437
540421,2022-04-07,Monsenhor Paulo/MG,0,10,0,1437
546018,2022-04-08,Monsenhor Paulo/MG,0,10,0,1437
551615,2022-04-09,Monsenhor Paulo/MG,0,10,2,1439
557212,2022-04-10,Monsenhor Paulo/MG,0,10,0,1439
562809,2022-04-11,Monsenhor Paulo/MG,0,10,0,1439
568406,2022-04-12,Monsenhor Paulo/MG,0,10,0,1439
574003,2022-04-13,Monsenhor Paulo/MG,0,10,1,1440
579600,2022-04-14,Monsenhor Paulo/MG,0,10,0,1440
585197,2022-04-15,Monsenhor Paulo/MG,0,10,0,1440
590794,2022-04-16,Monsenhor Paulo/MG,0,10,0,1440
596391,2022-04-17,Monsenhor Paulo/MG,0,10,0,1440
601988,2022-04-18,Monsenhor Paulo/MG,0,10,0,1440
607585,2022-04-19,Monsenhor Paulo/MG,0,10,0,1440
613182,2022-04-20,Monsenhor Paulo/MG,0,10,0,1440
618779,2022-04-21,Monsenhor Paulo/MG,0,10,0,1440
624376,2022-04-22,Monsenhor Paulo/MG,0,10,0,1440
629973,2022-04-23,Monsenhor Paulo/MG,0,10,1,1441
635570,2022-04-24,Monsenhor Paulo/MG,0,10,0,1441
641167,2022-04-25,Monsenhor Paulo/MG,0,10,0,1441
646764,2022-04-26,Monsenhor Paulo/MG,0,10,0,1441
652361,2022-04-27,Monsenhor Paulo/MG,0,10,0,1441
657958,2022-04-28,Monsenhor Paulo/MG,0,10,2,1443
663555,2022-04-29,Monsenhor Paulo/MG,0,10,1,1444
669152,2022-04-30,Monsenhor Paulo/MG,0,10,0,1444
674749,2022-05-01,Monsenhor Paulo/MG,0,10,0,1444
680346,2022-05-02,Monsenhor Paulo/MG,0,10,1,1445
685943,2022-05-03,Monsenhor Paulo/MG,0,10,3,1448
691540,2022-05-04,Monsenhor Paulo/MG,0,10,-1,1447
697137,2022-05-05,Monsenhor Paulo/MG,0,10,2,1449
702734,2022-05-06,Monsenhor Paulo/MG,0,10,0,1449
708331,2022-05-07,Monsenhor Paulo/MG,0,10,0,1449
713928,2022-05-08,Monsenhor Paulo/MG,0,10,0,1449
719525,2022-05-09,Monsenhor Paulo/MG,0,10,3,1452
725122,2022-05-10,Monsenhor Paulo/MG,0,10,2,1454
730719,2022-05-11,Monsenhor Paulo/MG,0,10,2,1456
736316,2022-05-12,Monsenhor Paulo/MG,0,10,1,1457
741913,2022-05-13,Monsenhor Paulo/MG,0,10,2,1459
747510,2022-05-14,Monsenhor Paulo/MG,0,10,0,1459
753107,2022-05-15,Monsenhor Paulo/MG,0,10,0,1459
758704,2022-05-16,Monsenhor Paulo/MG,0,10,1,1460
764301,2022-05-17,Monsenhor Paulo/MG,0,10,1,1461
769898,2022-05-18,Monsenhor Paulo/MG,0,10,3,1464
775495,2022-05-19,Monsenhor Paulo/MG,0,10,0,1464
781092,2022-05-20,Monsenhor Paulo/MG,0,10,2,1466
786689,2022-05-21,Monsenhor Paulo/MG,0,10,0,1466
792286,2022-05-22,Monsenhor Paulo/MG,0,10,0,1466
797883,2022-05-23,Monsenhor Paulo/MG,0,10,4,1470
803480,2022-05-24,Monsenhor Paulo/MG,0,10,4,1474
809077,2022-05-25,Monsenhor Paulo/MG,0,10,9,1483
814674,2022-05-26,Monsenhor Paulo/MG,0,10,0,1483
820271,2022-05-27,Monsenhor Paulo/MG,0,10,2,1485
825868,2022-05-28,Monsenhor Paulo/MG,0,10,0,1485
831465,2022-05-29,Monsenhor Paulo/MG,0,10,0,1485
837062,2022-05-30,Monsenhor Paulo/MG,0,10,7,1492
842659,2022-05-31,Monsenhor Paulo/MG,0,10,12,1504
848256,2022-06-01,Monsenhor Paulo/MG,0,10,15,1519
853853,2022-06-02,Monsenhor Paulo/MG,0,10,2,1521
859450,2022-06-03,Monsenhor Paulo/MG,0,10,9,1530
865047,2022-06-04,Monsenhor Paulo/MG,0,10,0,1530
870644,2022-06-05,Monsenhor Paulo/MG,0,10,0,1530
876241,2022-06-06,Monsenhor Paulo/MG,0,10,38,1568
881838,2022-06-07,Monsenhor Paulo/MG,0,10,8,1576
887435,2022-06-08,Monsenhor Paulo/MG,0,10,5,1581
893032,2022-06-09,Monsenhor Paulo/MG,0,10,3,1584
898629,2022-06-10,Monsenhor Paulo/MG,0,10,0,1584
904226,2022-06-11,Monsenhor Paulo/MG,0,10,0,1584
909823,2022-06-12,Monsenhor Paulo/MG,0,10,0,1584
915420,2022-06-13,Monsenhor Paulo/MG,0,10,9,1593
921017,2022-06-14,Monsenhor Paulo/MG,0,10,2,1595
926614,2022-06-15,Monsenhor Paulo/MG,0,10,19,1614
932211,2022-06-16,Monsenhor Paulo/MG,0,10,0,1614
937808,2022-06-17,Monsenhor Paulo/MG,0,10,0,1614
943405,2022-06-18,Monsenhor Paulo/MG,0,10,0,1614
949002,2022-06-19,Monsenhor Paulo/MG,0,10,0,1614
954599,2022-06-20,Monsenhor Paulo/MG,0,10,12,1626
960196,2022-06-21,Monsenhor Paulo/MG,0,10,0,1626
965793,2022-06-22,Monsenhor Paulo/MG,0,10,3,1629
971390,2022-06-23,Monsenhor Paulo/MG,0,10,0,1629
976987,2022-06-24,Monsenhor Paulo/MG,0,10,10,1639
982584,2022-06-25,Monsenhor Paulo/MG,0,10,0,1639
988181,2022-06-26,Monsenhor Paulo/MG,0,10,0,1639
993778,2022-06-27,Monsenhor Paulo/MG,0,10,0,1639
999375,2022-06-28,Monsenhor Paulo/MG,0,10,4,1643
1004972,2022-06-29,Monsenhor Paulo/MG,0,10,8,1651
1010569,2022-06-30,Monsenhor Paulo/MG,0,10,4,1655
1016166,2022-07-01,Monsenhor Paulo/MG,0,10,5,1660
1021763,2022-07-02,Monsenhor Paulo/MG,0,10,0,1660
1027360,2022-07-03,Monsenhor Paulo/MG,0,10,0,1660
1032957,2022-07-04,Monsenhor Paulo/MG,0,10,0,1660
1038554,2022-07-05,Monsenhor Paulo/MG,0,10,35,1695
1044151,2022-07-06,Monsenhor Paulo/MG,0,10,17,1712
1049748,2022-07-07,Monsenhor Paulo/MG,0,10,2,1714
1055345,2022-07-08,Monsenhor Paulo/MG,0,10,0,1714
1060942,2022-07-09,Monsenhor Paulo/MG,0,10,0,1714
1066539,2022-07-10,Monsenhor Paulo/MG,0,10,0,1714
1072136,2022-07-11,Monsenhor Paulo/MG,0,10,0,1714
1077733,2022-07-12,Monsenhor Paulo/MG,0,10,11,1725
1083330,2022-07-13,Monsenhor Paulo/MG,0,10,9,1734
1088927,2022-07-14,Monsenhor Paulo/MG,0,10,15,1749
1094524,2022-07-15,Monsenhor Paulo/MG,0,10,9,1758
1100121,2022-07-16,Monsenhor Paulo/MG,0,10,0,1758
1105718,2022-07-17,Monsenhor Paulo/MG,0,10,0,1758
1111315,2022-07-18,Monsenhor Paulo/MG,0,10,13,1771
1116912,2022-07-19,Monsenhor Paulo/MG,0,10,14,1785
1122509,2022-07-20,Monsenhor Paulo/MG,0,10,18,1803
1128106,2022-07-21,Monsenhor Paulo/MG,0,10,6,1809
1133703,2022-07-22,Monsenhor Paulo/MG,0,10,0,1809
1139300,2022-07-23,Monsenhor Paulo/MG,0,10,0,1809
1144897,2022-07-24,Monsenhor Paulo/MG,0,10,0,1809
1150494,2022-07-25,Monsenhor Paulo/MG,0,10,8,1817
1156091,2022-07-26,Monsenhor Paulo/MG,0,10,3,1820
1161688,2022-07-27,Monsenhor Paulo/MG,0,10,0,1820
1167285,2022-07-28,Monsenhor Paulo/MG,0,10,0,1820
1172882,2022-07-29,Monsenhor Paulo/MG,0,10,0,1820
1178479,2022-07-30,Monsenhor Paulo/MG,0,10,0,1820
1184076,2022-07-31,Monsenhor Paulo/MG,0,10,0,1820
1189673,2022-08-01,Monsenhor Paulo/MG,0,10,0,1820
1195270,2022-08-02,Monsenhor Paulo/MG,0,10,0,1820
1200867,2022-08-03,Monsenhor Paulo/MG,0,10,0,1820
1206464,2022-08-04,Monsenhor Paulo/MG,0,10,0,1820
1212061,2022-08-05,Monsenhor Paulo/MG,0,10,0,1820
1217658,2022-08-06,Monsenhor Paulo/MG,0,10,0,1820
1223255,2022-08-07,Monsenhor Paulo/MG,0,10,0,1820
1228852,2022-08-08,Monsenhor Paulo/MG,0,10,0,1820
1234449,2022-08-09,Monsenhor Paulo/MG,0,10,0,1820
1240046,2022-08-10,Monsenhor Paulo/MG,0,10,7,1827
1245643,2022-08-11,Monsenhor Paulo/MG,0,10,0,1827
1251240,2022-08-12,Monsenhor Paulo/MG,0,10,0,1827
1256837,2022-08-13,Monsenhor Paulo/MG,0,10,0,1827
1262434,2022-08-14,Monsenhor Paulo/MG,0,10,0,1827
1268031,2022-08-15,Monsenhor Paulo/MG,0,10,0,1827
1273628,2022-08-16,Monsenhor Paulo/MG,0,10,3,1830
1279225,2022-08-17,Monsenhor Paulo/MG,0,10,0,1830
1284822,2022-08-18,Monsenhor Paulo/MG,0,10,0,1830
1290419,2022-08-19,Monsenhor Paulo/MG,0,10,0,1830
1296016,2022-08-20,Monsenhor Paulo/MG,0,10,0,1830
1301613,2022-08-21,Monsenhor Paulo/MG,0,10,0,1830
1307210,2022-08-22,Monsenhor Paulo/MG,0,10,0,1830
1312807,2022-08-23,Monsenhor Paulo/MG,0,10,0,1830
1318404,2022-08-24,Monsenhor Paulo/MG,0,10,0,1830
1324001,2022-08-25,Monsenhor Paulo/MG,0,10,2,1832
3129,2022-01-01,Monte Belo/MG,0,36,2,1273
8726,2022-01-02,Monte Belo/MG,0,36,0,1273
14323,2022-01-03,Monte Belo/MG,0,36,0,1273
19920,2022-01-04,Monte Belo/MG,0,36,0,1273
25517,2022-01-05,Monte Belo/MG,0,36,16,1289
31114,2022-01-06,Monte Belo/MG,0,36,9,1298
36711,2022-01-07,Monte Belo/MG,0,36,31,1329
42308,2022-01-08,Monte Belo/MG,0,36,37,1366
47905,2022-01-09,Monte Belo/MG,0,36,0,1366
53502,2022-01-10,Monte Belo/MG,0,36,0,1366
59099,2022-01-11,Monte Belo/MG,0,36,31,1397
64696,2022-01-12,Monte Belo/MG,0,36,52,1449
70293,2022-01-13,Monte Belo/MG,0,36,38,1487
75890,2022-01-14,Monte Belo/MG,0,36,59,1546
81487,2022-01-15,Monte Belo/MG,0,36,43,1589
87084,2022-01-16,Monte Belo/MG,0,36,0,1589
92681,2022-01-17,Monte Belo/MG,0,36,0,1589
98278,2022-01-18,Monte Belo/MG,0,36,0,1589
103875,2022-01-19,Monte Belo/MG,0,36,127,1716
109472,2022-01-20,Monte Belo/MG,0,36,42,1758
115069,2022-01-21,Monte Belo/MG,0,36,40,1798
120666,2022-01-22,Monte Belo/MG,0,36,46,1844
126263,2022-01-23,Monte Belo/MG,0,36,0,1844
131860,2022-01-24,Monte Belo/MG,0,36,0,1844
137457,2022-01-25,Monte Belo/MG,0,36,17,1861
143054,2022-01-26,Monte Belo/MG,0,36,48,1909
148651,2022-01-27,Monte Belo/MG,0,36,33,1942
154248,2022-01-28,Monte Belo/MG,0,36,17,1959
159845,2022-01-29,Monte Belo/MG,1,37,17,1976
165442,2022-01-30,Monte Belo/MG,0,37,0,1976
171039,2022-01-31,Monte Belo/MG,0,37,0,1976
176636,2022-02-01,Monte Belo/MG,0,37,6,1982
182233,2022-02-02,Monte Belo/MG,0,37,41,2023
187830,2022-02-03,Monte Belo/MG,0,37,7,2030
193427,2022-02-04,Monte Belo/MG,0,37,14,2044
199024,2022-02-05,Monte Belo/MG,0,37,18,2062
204621,2022-02-06,Monte Belo/MG,0,37,0,2062
210218,2022-02-07,Monte Belo/MG,0,37,0,2062
215815,2022-02-08,Monte Belo/MG,0,37,30,2092
221412,2022-02-09,Monte Belo/MG,0,37,70,2162
227009,2022-02-10,Monte Belo/MG,0,37,0,2162
232606,2022-02-11,Monte Belo/MG,0,37,70,2232
238203,2022-02-12,Monte Belo/MG,0,37,43,2275
243800,2022-02-13,Monte Belo/MG,0,37,0,2275
249397,2022-02-14,Monte Belo/MG,0,37,0,2275
254994,2022-02-15,Monte Belo/MG,0,37,21,2296
260591,2022-02-16,Monte Belo/MG,0,37,60,2356
266188,2022-02-17,Monte Belo/MG,0,37,19,2375
271785,2022-02-18,Monte Belo/MG,0,37,30,2405
277382,2022-02-19,Monte Belo/MG,0,37,16,2421
282979,2022-02-20,Monte Belo/MG,0,37,0,2421
288576,2022-02-21,Monte Belo/MG,0,37,0,2421
294173,2022-02-22,Monte Belo/MG,0,37,17,2438
299770,2022-02-23,Monte Belo/MG,0,37,24,2462
305367,2022-02-24,Monte Belo/MG,0,37,17,2479
310964,2022-02-25,Monte Belo/MG,0,37,8,2487
316561,2022-02-26,Monte Belo/MG,0,37,13,2500
322158,2022-02-27,Monte Belo/MG,0,37,0,2500
327755,2022-02-28,Monte Belo/MG,0,37,0,2500
333352,2022-03-01,Monte Belo/MG,0,37,0,2500
338949,2022-03-02,Monte Belo/MG,0,37,0,2500
344546,2022-03-03,Monte Belo/MG,0,37,14,2514
350143,2022-03-04,Monte Belo/MG,0,37,30,2544
355740,2022-03-05,Monte Belo/MG,0,37,16,2560
361337,2022-03-06,Monte Belo/MG,0,37,0,2560
366934,2022-03-07,Monte Belo/MG,0,37,0,2560
372531,2022-03-08,Monte Belo/MG,0,37,5,2565
378128,2022-03-09,Monte Belo/MG,0,37,2,2567
383725,2022-03-10,Monte Belo/MG,0,37,1,2568
389322,2022-03-11,Monte Belo/MG,1,38,0,2568
394919,2022-03-12,Monte Belo/MG,0,38,2,2570
400516,2022-03-13,Monte Belo/MG,0,38,0,2570
406113,2022-03-14,Monte Belo/MG,0,38,0,2570
411710,2022-03-15,Monte Belo/MG,0,38,1,2571
417307,2022-03-16,Monte Belo/MG,0,38,0,2571
422904,2022-03-17,Monte Belo/MG,0,38,7,2578
428501,2022-03-18,Monte Belo/MG,0,38,0,2578
434098,2022-03-19,Monte Belo/MG,0,38,3,2581
439695,2022-03-20,Monte Belo/MG,0,38,0,2581
445292,2022-03-21,Monte Belo/MG,0,38,0,2581
450889,2022-03-22,Monte Belo/MG,1,39,1,2582
456486,2022-03-23,Monte Belo/MG,0,39,2,2584
462083,2022-03-24,Monte Belo/MG,0,39,3,2587
467680,2022-03-25,Monte Belo/MG,0,39,0,2587
473277,2022-03-26,Monte Belo/MG,0,39,0,2587
478874,2022-03-27,Monte Belo/MG,0,39,0,2587
484471,2022-03-28,Monte Belo/MG,0,39,0,2587
490068,2022-03-29,Monte Belo/MG,0,39,0,2587
495665,2022-03-30,Monte Belo/MG,0,39,4,2591
501262,2022-03-31,Monte Belo/MG,0,39,4,2595
506859,2022-04-01,Monte Belo/MG,0,39,2,2597
512456,2022-04-02,Monte Belo/MG,0,39,0,2597
518053,2022-04-03,Monte Belo/MG,0,39,0,2597
523650,2022-04-04,Monte Belo/MG,0,39,2,2599
529247,2022-04-05,Monte Belo/MG,0,39,3,2602
534844,2022-04-06,Monte Belo/MG,0,39,2,2604
540441,2022-04-07,Monte Belo/MG,0,39,0,2604
546038,2022-04-08,Monte Belo/MG,0,39,0,2604
551635,2022-04-09,Monte Belo/MG,0,39,0,2604
557232,2022-04-10,Monte Belo/MG,0,39,0,2604
562829,2022-04-11,Monte Belo/MG,0,39,0,2604
568426,2022-04-12,Monte Belo/MG,0,39,0,2604
574023,2022-04-13,Monte Belo/MG,0,39,0,2604
579620,2022-04-14,Monte Belo/MG,0,39,0,2604
585217,2022-04-15,Monte Belo/MG,0,39,0,2604
590814,2022-04-16,Monte Belo/MG,0,39,0,2604
596411,2022-04-17,Monte Belo/MG,0,39,0,2604
602008,2022-04-18,Monte Belo/MG,0,39,0,2604
607605,2022-04-19,Monte Belo/MG,0,39,0,2604
613202,2022-04-20,Monte Belo/MG,0,39,0,2604
618799,2022-04-21,Monte Belo/MG,0,39,2,2606
624396,2022-04-22,Monte Belo/MG,0,39,0,2606
629993,2022-04-23,Monte Belo/MG,0,39,0,2606
635590,2022-04-24,Monte Belo/MG,0,39,0,2606
641187,2022-04-25,Monte Belo/MG,0,39,0,2606
646784,2022-04-26,Monte Belo/MG,0,39,0,2606
652381,2022-04-27,Monte Belo/MG,0,39,0,2606
657978,2022-04-28,Monte Belo/MG,0,39,0,2606
663575,2022-04-29,Monte Belo/MG,0,39,0,2606
669172,2022-04-30,Monte Belo/MG,0,39,0,2606
674769,2022-05-01,Monte Belo/MG,0,39,0,2606
680366,2022-05-02,Monte Belo/MG,0,39,0,2606
685963,2022-05-03,Monte Belo/MG,0,39,0,2606
691560,2022-05-04,Monte Belo/MG,0,39,0,2606
697157,2022-05-05,Monte Belo/MG,0,39,0,2606
702754,2022-05-06,Monte Belo/MG,0,39,0,2606
708351,2022-05-07,Monte Belo/MG,0,39,0,2606
713948,2022-05-08,Monte Belo/MG,0,39,0,2606
719545,2022-05-09,Monte Belo/MG,0,39,0,2606
725142,2022-05-10,Monte Belo/MG,0,39,0,2606
730739,2022-05-11,Monte Belo/MG,0,39,0,2606
736336,2022-05-12,Monte Belo/MG,0,39,0,2606
741933,2022-05-13,Monte Belo/MG,0,39,6,2612
747530,2022-05-14,Monte Belo/MG,0,39,0,2612
753127,2022-05-15,Monte Belo/MG,0,39,0,2612
758724,2022-05-16,Monte Belo/MG,0,39,3,2615
764321,2022-05-17,Monte Belo/MG,0,39,0,2615
769918,2022-05-18,Monte Belo/MG,0,39,0,2615
775515,2022-05-19,Monte Belo/MG,0,39,0,2615
781112,2022-05-20,Monte Belo/MG,0,39,8,2623
786709,2022-05-21,Monte Belo/MG,0,39,0,2623
792306,2022-05-22,Monte Belo/MG,0,39,0,2623
797903,2022-05-23,Monte Belo/MG,0,39,0,2623
803500,2022-05-24,Monte Belo/MG,0,39,0,2623
809097,2022-05-25,Monte Belo/MG,0,39,4,2627
814694,2022-05-26,Monte Belo/MG,0,39,0,2627
820291,2022-05-27,Monte Belo/MG,0,39,0,2627
825888,2022-05-28,Monte Belo/MG,0,39,0,2627
831485,2022-05-29,Monte Belo/MG,0,39,0,2627
837082,2022-05-30,Monte Belo/MG,0,39,5,2632
842679,2022-05-31,Monte Belo/MG,0,39,8,2640
848276,2022-06-01,Monte Belo/MG,0,39,0,2640
853873,2022-06-02,Monte Belo/MG,0,39,6,2646
859470,2022-06-03,Monte Belo/MG,0,39,0,2646
865067,2022-06-04,Monte Belo/MG,0,39,0,2646
870664,2022-06-05,Monte Belo/MG,0,39,0,2646
876261,2022-06-06,Monte Belo/MG,0,39,4,2650
881858,2022-06-07,Monte Belo/MG,0,39,0,2650
887455,2022-06-08,Monte Belo/MG,0,39,0,2650
893052,2022-06-09,Monte Belo/MG,0,39,0,2650
898649,2022-06-10,Monte Belo/MG,0,39,0,2650
904246,2022-06-11,Monte Belo/MG,0,39,0,2650
909843,2022-06-12,Monte Belo/MG,0,39,0,2650
915440,2022-06-13,Monte Belo/MG,0,39,37,2687
921037,2022-06-14,Monte Belo/MG,0,39,0,2687
926634,2022-06-15,Monte Belo/MG,1,40,6,2693
932231,2022-06-16,Monte Belo/MG,0,40,0,2693
937828,2022-06-17,Monte Belo/MG,0,40,0,2693
943425,2022-06-18,Monte Belo/MG,0,40,0,2693
949022,2022-06-19,Monte Belo/MG,0,40,0,2693
954619,2022-06-20,Monte Belo/MG,0,40,0,2693
960216,2022-06-21,Monte Belo/MG,0,40,22,2715
965813,2022-06-22,Monte Belo/MG,0,40,0,2715
971410,2022-06-23,Monte Belo/MG,0,40,26,2741
977007,2022-06-24,Monte Belo/MG,0,40,0,2741
982604,2022-06-25,Monte Belo/MG,0,40,0,2741
988201,2022-06-26,Monte Belo/MG,0,40,0,2741
993798,2022-06-27,Monte Belo/MG,0,40,62,2803
999395,2022-06-28,Monte Belo/MG,0,40,0,2803
1004992,2022-06-29,Monte Belo/MG,0,40,0,2803
1010589,2022-06-30,Monte Belo/MG,0,40,0,2803
1016186,2022-07-01,Monte Belo/MG,0,40,0,2803
1021783,2022-07-02,Monte Belo/MG,0,40,0,2803
1027380,2022-07-03,Monte Belo/MG,0,40,0,2803
1032977,2022-07-04,Monte Belo/MG,0,40,46,2849
1038574,2022-07-05,Monte Belo/MG,0,40,0,2849
1044171,2022-07-06,Monte Belo/MG,0,40,0,2849
1049768,2022-07-07,Monte Belo/MG,0,40,0,2849
1055365,2022-07-08,Monte Belo/MG,0,40,54,2903
1060962,2022-07-09,Monte Belo/MG,0,40,0,2903
1066559,2022-07-10,Monte Belo/MG,0,40,0,2903
1072156,2022-07-11,Monte Belo/MG,0,40,19,2922
1077753,2022-07-12,Monte Belo/MG,0,40,0,2922
1083350,2022-07-13,Monte Belo/MG,0,40,0,2922
1088947,2022-07-14,Monte Belo/MG,0,40,0,2922
1094544,2022-07-15,Monte Belo/MG,0,40,0,2922
1100141,2022-07-16,Monte Belo/MG,0,40,0,2922
1105738,2022-07-17,Monte Belo/MG,0,40,0,2922
1111335,2022-07-18,Monte Belo/MG,0,40,29,2951
1116932,2022-07-19,Monte Belo/MG,0,40,0,2951
1122529,2022-07-20,Monte Belo/MG,0,40,0,2951
1128126,2022-07-21,Monte Belo/MG,0,40,0,2951
1133723,2022-07-22,Monte Belo/MG,0,40,0,2951
1139320,2022-07-23,Monte Belo/MG,0,40,0,2951
1144917,2022-07-24,Monte Belo/MG,0,40,0,2951
1150514,2022-07-25,Monte Belo/MG,0,40,12,2963
1156111,2022-07-26,Monte Belo/MG,0,40,0,2963
1161708,2022-07-27,Monte Belo/MG,0,40,0,2963
1167305,2022-07-28,Monte Belo/MG,0,40,0,2963
1172902,2022-07-29,Monte Belo/MG,0,40,0,2963
1178499,2022-07-30,Monte Belo/MG,0,40,0,2963
1184096,2022-07-31,Monte Belo/MG,0,40,0,2963
1189693,2022-08-01,Monte Belo/MG,0,40,12,2975
1195290,2022-08-02,Monte Belo/MG,0,40,0,2975
1200887,2022-08-03,Monte Belo/MG,0,40,0,2975
1206484,2022-08-04,Monte Belo/MG,0,40,0,2975
1212081,2022-08-05,Monte Belo/MG,0,40,0,2975
1217678,2022-08-06,Monte Belo/MG,0,40,0,2975
1223275,2022-08-07,Monte Belo/MG,0,40,0,2975
1228872,2022-08-08,Monte Belo/MG,0,40,13,2988
1234469,2022-08-09,Monte Belo/MG,0,40,0,2988
1240066,2022-08-10,Monte Belo/MG,0,40,0,2988
1245663,2022-08-11,Monte Belo/MG,0,40,0,2988
1251260,2022-08-12,Monte Belo/MG,0,40,0,2988
1256857,2022-08-13,Monte Belo/MG,0,40,0,2988
1262454,2022-08-14,Monte Belo/MG,0,40,0,2988
1268051,2022-08-15,Monte Belo/MG,0,40,0,2988
1273648,2022-08-16,Monte Belo/MG,0,40,18,3006
1279245,2022-08-17,Monte Belo/MG,0,40,0,3006
1284842,2022-08-18,Monte Belo/MG,0,40,0,3006
1290439,2022-08-19,Monte Belo/MG,0,40,0,3006
1296036,2022-08-20,Monte Belo/MG,0,40,0,3006
1301633,2022-08-21,Monte Belo/MG,0,40,0,3006
1307230,2022-08-22,Monte Belo/MG,0,40,0,3006
1312827,2022-08-23,Monte Belo/MG,0,40,0,3006
1318424,2022-08-24,Monte Belo/MG,0,40,0,3006
1324021,2022-08-25,Monte Belo/MG,0,40,0,3006
3138,2022-01-01,Monte Santo de Minas/MG,0,56,0,1639
8735,2022-01-02,Monte Santo de Minas/MG,0,56,0,1639
14332,2022-01-03,Monte Santo de Minas/MG,0,56,0,1639
19929,2022-01-04,Monte Santo de Minas/MG,0,56,0,1639
25526,2022-01-05,Monte Santo de Minas/MG,0,56,38,1677
31123,2022-01-06,Monte Santo de Minas/MG,0,56,30,1707
36720,2022-01-07,Monte Santo de Minas/MG,0,56,0,1707
42317,2022-01-08,Monte Santo de Minas/MG,0,56,0,1707
47914,2022-01-09,Monte Santo de Minas/MG,0,56,0,1707
53511,2022-01-10,Monte Santo de Minas/MG,0,56,0,1707
59108,2022-01-11,Monte Santo de Minas/MG,0,56,377,2084
64705,2022-01-12,Monte Santo de Minas/MG,0,56,97,2181
70302,2022-01-13,Monte Santo de Minas/MG,0,56,146,2327
75899,2022-01-14,Monte Santo de Minas/MG,0,56,112,2439
81496,2022-01-15,Monte Santo de Minas/MG,0,56,104,2543
87093,2022-01-16,Monte Santo de Minas/MG,0,56,0,2543
92690,2022-01-17,Monte Santo de Minas/MG,0,56,0,2543
98287,2022-01-18,Monte Santo de Minas/MG,0,56,173,2716
103884,2022-01-19,Monte Santo de Minas/MG,0,56,0,2716
109481,2022-01-20,Monte Santo de Minas/MG,0,56,0,2716
115078,2022-01-21,Monte Santo de Minas/MG,0,56,173,2889
120675,2022-01-22,Monte Santo de Minas/MG,0,56,0,2889
126272,2022-01-23,Monte Santo de Minas/MG,0,56,0,2889
131869,2022-01-24,Monte Santo de Minas/MG,0,56,0,2889
137466,2022-01-25,Monte Santo de Minas/MG,0,56,153,3042
143063,2022-01-26,Monte Santo de Minas/MG,1,57,56,3098
148660,2022-01-27,Monte Santo de Minas/MG,0,57,0,3098
154257,2022-01-28,Monte Santo de Minas/MG,0,57,0,3098
159854,2022-01-29,Monte Santo de Minas/MG,0,57,0,3098
165451,2022-01-30,Monte Santo de Minas/MG,0,57,188,3286
171048,2022-01-31,Monte Santo de Minas/MG,0,57,0,3286
176645,2022-02-01,Monte Santo de Minas/MG,0,57,0,3286
182242,2022-02-02,Monte Santo de Minas/MG,0,57,91,3377
187839,2022-02-03,Monte Santo de Minas/MG,0,57,0,3377
193436,2022-02-04,Monte Santo de Minas/MG,0,57,67,3444
199033,2022-02-05,Monte Santo de Minas/MG,0,57,40,3484
204630,2022-02-06,Monte Santo de Minas/MG,0,57,0,3484
210227,2022-02-07,Monte Santo de Minas/MG,0,57,0,3484
215824,2022-02-08,Monte Santo de Minas/MG,1,58,34,3518
221421,2022-02-09,Monte Santo de Minas/MG,0,58,68,3586
227018,2022-02-10,Monte Santo de Minas/MG,1,59,34,3620
232615,2022-02-11,Monte Santo de Minas/MG,1,60,0,3620
238212,2022-02-12,Monte Santo de Minas/MG,0,60,26,3646
243809,2022-02-13,Monte Santo de Minas/MG,0,60,0,3646
249406,2022-02-14,Monte Santo de Minas/MG,0,60,0,3646
255003,2022-02-15,Monte Santo de Minas/MG,0,60,20,3666
260600,2022-02-16,Monte Santo de Minas/MG,0,60,0,3666
266197,2022-02-17,Monte Santo de Minas/MG,0,60,71,3737
271794,2022-02-18,Monte Santo de Minas/MG,3,63,0,3737
277391,2022-02-19,Monte Santo de Minas/MG,0,63,0,3737
282988,2022-02-20,Monte Santo de Minas/MG,0,63,0,3737
288585,2022-02-21,Monte Santo de Minas/MG,0,63,0,3737
294182,2022-02-22,Monte Santo de Minas/MG,0,63,68,3805
299779,2022-02-23,Monte Santo de Minas/MG,1,64,50,3855
305376,2022-02-24,Monte Santo de Minas/MG,0,64,21,3876
310973,2022-02-25,Monte Santo de Minas/MG,0,64,21,3897
316570,2022-02-26,Monte Santo de Minas/MG,0,64,10,3907
322167,2022-02-27,Monte Santo de Minas/MG,0,64,0,3907
327764,2022-02-28,Monte Santo de Minas/MG,0,64,0,3907
333361,2022-03-01,Monte Santo de Minas/MG,0,64,0,3907
338958,2022-03-02,Monte Santo de Minas/MG,0,64,0,3907
344555,2022-03-03,Monte Santo de Minas/MG,0,64,37,3944
350152,2022-03-04,Monte Santo de Minas/MG,0,64,15,3959
355749,2022-03-05,Monte Santo de Minas/MG,0,64,5,3964
361346,2022-03-06,Monte Santo de Minas/MG,0,64,0,3964
366943,2022-03-07,Monte Santo de Minas/MG,0,64,0,3964
372540,2022-03-08,Monte Santo de Minas/MG,0,64,1,3965
378137,2022-03-09,Monte Santo de Minas/MG,1,65,22,3987
383734,2022-03-10,Monte Santo de Minas/MG,0,65,0,3987
389331,2022-03-11,Monte Santo de Minas/MG,0,65,18,4005
394928,2022-03-12,Monte Santo de Minas/MG,0,65,0,4005
400525,2022-03-13,Monte Santo de Minas/MG,0,65,0,4005
406122,2022-03-14,Monte Santo de Minas/MG,0,65,0,4005
411719,2022-03-15,Monte Santo de Minas/MG,0,65,9,4014
417316,2022-03-16,Monte Santo de Minas/MG,0,65,6,4020
422913,2022-03-17,Monte Santo de Minas/MG,0,65,3,4023
428510,2022-03-18,Monte Santo de Minas/MG,1,66,1,4024
434107,2022-03-19,Monte Santo de Minas/MG,0,66,4,4028
439704,2022-03-20,Monte Santo de Minas/MG,0,66,0,4028
445301,2022-03-21,Monte Santo de Minas/MG,0,66,0,4028
450898,2022-03-22,Monte Santo de Minas/MG,0,66,2,4030
456495,2022-03-23,Monte Santo de Minas/MG,0,66,3,4033
462092,2022-03-24,Monte Santo de Minas/MG,1,67,2,4035
467689,2022-03-25,Monte Santo de Minas/MG,0,67,0,4035
473286,2022-03-26,Monte Santo de Minas/MG,0,67,4,4039
478883,2022-03-27,Monte Santo de Minas/MG,0,67,0,4039
484480,2022-03-28,Monte Santo de Minas/MG,0,67,0,4039
490077,2022-03-29,Monte Santo de Minas/MG,0,67,1,4040
495674,2022-03-30,Monte Santo de Minas/MG,0,67,0,4040
501271,2022-03-31,Monte Santo de Minas/MG,0,67,0,4040
506868,2022-04-01,Monte Santo de Minas/MG,0,67,1,4041
512465,2022-04-02,Monte Santo de Minas/MG,0,67,0,4041
518062,2022-04-03,Monte Santo de Minas/MG,0,67,0,4041
523659,2022-04-04,Monte Santo de Minas/MG,0,67,8,4049
529256,2022-04-05,Monte Santo de Minas/MG,0,67,0,4049
534853,2022-04-06,Monte Santo de Minas/MG,0,67,0,4049
540450,2022-04-07,Monte Santo de Minas/MG,0,67,4,4053
546047,2022-04-08,Monte Santo de Minas/MG,0,67,0,4053
551644,2022-04-09,Monte Santo de Minas/MG,0,67,0,4053
557241,2022-04-10,Monte Santo de Minas/MG,0,67,0,4053
562838,2022-04-11,Monte Santo de Minas/MG,0,67,0,4053
568435,2022-04-12,Monte Santo de Minas/MG,0,67,4,4057
574032,2022-04-13,Monte Santo de Minas/MG,0,67,0,4057
579629,2022-04-14,Monte Santo de Minas/MG,0,67,0,4057
585226,2022-04-15,Monte Santo de Minas/MG,0,67,0,4057
590823,2022-04-16,Monte Santo de Minas/MG,0,67,0,4057
596420,2022-04-17,Monte Santo de Minas/MG,0,67,0,4057
602017,2022-04-18,Monte Santo de Minas/MG,0,67,0,4057
607614,2022-04-19,Monte Santo de Minas/MG,0,67,0,4057
613211,2022-04-20,Monte Santo de Minas/MG,0,67,19,4076
618808,2022-04-21,Monte Santo de Minas/MG,0,67,0,4076
624405,2022-04-22,Monte Santo de Minas/MG,0,67,0,4076
630002,2022-04-23,Monte Santo de Minas/MG,0,67,0,4076
635599,2022-04-24,Monte Santo de Minas/MG,0,67,0,4076
641196,2022-04-25,Monte Santo de Minas/MG,0,67,0,4076
646793,2022-04-26,Monte Santo de Minas/MG,0,67,0,4076
652390,2022-04-27,Monte Santo de Minas/MG,0,67,59,4135
657987,2022-04-28,Monte Santo de Minas/MG,0,67,0,4135
663584,2022-04-29,Monte Santo de Minas/MG,0,67,0,4135
669181,2022-04-30,Monte Santo de Minas/MG,0,67,39,4174
674778,2022-05-01,Monte Santo de Minas/MG,0,67,4,4178
680375,2022-05-02,Monte Santo de Minas/MG,0,67,0,4178
685972,2022-05-03,Monte Santo de Minas/MG,0,67,0,4178
691569,2022-05-04,Monte Santo de Minas/MG,0,67,0,4178
697166,2022-05-05,Monte Santo de Minas/MG,0,67,37,4215
702763,2022-05-06,Monte Santo de Minas/MG,0,67,5,4220
708360,2022-05-07,Monte Santo de Minas/MG,0,67,0,4220
713957,2022-05-08,Monte Santo de Minas/MG,0,67,0,4220
719554,2022-05-09,Monte Santo de Minas/MG,0,67,0,4220
725151,2022-05-10,Monte Santo de Minas/MG,0,67,0,4220
730748,2022-05-11,Monte Santo de Minas/MG,0,67,11,4231
736345,2022-05-12,Monte Santo de Minas/MG,0,67,45,4276
741942,2022-05-13,Monte Santo de Minas/MG,0,67,0,4276
747539,2022-05-14,Monte Santo de Minas/MG,0,67,0,4276
753136,2022-05-15,Monte Santo de Minas/MG,0,67,0,4276
758733,2022-05-16,Monte Santo de Minas/MG,0,67,21,4297
764330,2022-05-17,Monte Santo de Minas/MG,0,67,15,4312
769927,2022-05-18,Monte Santo de Minas/MG,0,67,0,4312
775524,2022-05-19,Monte Santo de Minas/MG,0,67,0,4312
781121,2022-05-20,Monte Santo de Minas/MG,0,67,50,4362
786718,2022-05-21,Monte Santo de Minas/MG,0,67,0,4362
792315,2022-05-22,Monte Santo de Minas/MG,0,67,0,4362
797912,2022-05-23,Monte Santo de Minas/MG,0,67,0,4362
803509,2022-05-24,Monte Santo de Minas/MG,0,67,27,4389
809106,2022-05-25,Monte Santo de Minas/MG,0,67,0,4389
814703,2022-05-26,Monte Santo de Minas/MG,0,67,0,4389
820300,2022-05-27,Monte Santo de Minas/MG,0,67,17,4406
825897,2022-05-28,Monte Santo de Minas/MG,0,67,0,4406
831494,2022-05-29,Monte Santo de Minas/MG,0,67,0,4406
837091,2022-05-30,Monte Santo de Minas/MG,0,67,13,4419
842688,2022-05-31,Monte Santo de Minas/MG,0,67,25,4444
848285,2022-06-01,Monte Santo de Minas/MG,1,68,0,4444
853882,2022-06-02,Monte Santo de Minas/MG,0,68,0,4444
859479,2022-06-03,Monte Santo de Minas/MG,0,68,61,4505
865076,2022-06-04,Monte Santo de Minas/MG,0,68,0,4505
870673,2022-06-05,Monte Santo de Minas/MG,0,68,0,4505
876270,2022-06-06,Monte Santo de Minas/MG,0,68,0,4505
881867,2022-06-07,Monte Santo de Minas/MG,0,68,0,4505
887464,2022-06-08,Monte Santo de Minas/MG,0,68,0,4505
893061,2022-06-09,Monte Santo de Minas/MG,0,68,60,4565
898658,2022-06-10,Monte Santo de Minas/MG,0,68,0,4565
904255,2022-06-11,Monte Santo de Minas/MG,0,68,0,4565
909852,2022-06-12,Monte Santo de Minas/MG,0,68,0,4565
915449,2022-06-13,Monte Santo de Minas/MG,0,68,24,4589
921046,2022-06-14,Monte Santo de Minas/MG,0,68,0,4589
926643,2022-06-15,Monte Santo de Minas/MG,0,68,19,4608
932240,2022-06-16,Monte Santo de Minas/MG,0,68,0,4608
937837,2022-06-17,Monte Santo de Minas/MG,0,68,0,4608
943434,2022-06-18,Monte Santo de Minas/MG,0,68,0,4608
949031,2022-06-19,Monte Santo de Minas/MG,0,68,0,4608
954628,2022-06-20,Monte Santo de Minas/MG,0,68,0,4608
960225,2022-06-21,Monte Santo de Minas/MG,0,68,0,4608
965822,2022-06-22,Monte Santo de Minas/MG,0,68,0,4608
971419,2022-06-23,Monte Santo de Minas/MG,0,68,52,4660
977016,2022-06-24,Monte Santo de Minas/MG,0,68,4,4664
982613,2022-06-25,Monte Santo de Minas/MG,0,68,0,4664
988210,2022-06-26,Monte Santo de Minas/MG,0,68,0,4664
993807,2022-06-27,Monte Santo de Minas/MG,0,68,0,4664
999404,2022-06-28,Monte Santo de Minas/MG,0,68,0,4664
1005001,2022-06-29,Monte Santo de Minas/MG,0,68,36,4700
1010598,2022-06-30,Monte Santo de Minas/MG,0,68,0,4700
1016195,2022-07-01,Monte Santo de Minas/MG,0,68,0,4700
1021792,2022-07-02,Monte Santo de Minas/MG,0,68,0,4700
1027389,2022-07-03,Monte Santo de Minas/MG,0,68,0,4700
1032986,2022-07-04,Monte Santo de Minas/MG,0,68,12,4712
1038583,2022-07-05,Monte Santo de Minas/MG,0,68,0,4712
1044180,2022-07-06,Monte Santo de Minas/MG,0,68,36,4748
1049777,2022-07-07,Monte Santo de Minas/MG,0,68,34,4782
1055374,2022-07-08,Monte Santo de Minas/MG,0,68,5,4787
1060971,2022-07-09,Monte Santo de Minas/MG,0,68,0,4787
1066568,2022-07-10,Monte Santo de Minas/MG,0,68,0,4787
1072165,2022-07-11,Monte Santo de Minas/MG,0,68,0,4787
1077762,2022-07-12,Monte Santo de Minas/MG,0,68,10,4797
1083359,2022-07-13,Monte Santo de Minas/MG,0,68,12,4809
1088956,2022-07-14,Monte Santo de Minas/MG,0,68,21,4830
1094553,2022-07-15,Monte Santo de Minas/MG,0,68,0,4830
1100150,2022-07-16,Monte Santo de Minas/MG,0,68,0,4830
1105747,2022-07-17,Monte Santo de Minas/MG,0,68,0,4830
1111344,2022-07-18,Monte Santo de Minas/MG,0,68,0,4830
1116941,2022-07-19,Monte Santo de Minas/MG,0,68,76,4906
1122538,2022-07-20,Monte Santo de Minas/MG,0,68,1,4907
1128135,2022-07-21,Monte Santo de Minas/MG,0,68,0,4907
1133732,2022-07-22,Monte Santo de Minas/MG,0,68,9,4916
1139329,2022-07-23,Monte Santo de Minas/MG,0,68,0,4916
1144926,2022-07-24,Monte Santo de Minas/MG,0,68,0,4916
1150523,2022-07-25,Monte Santo de Minas/MG,0,68,4,4920
1156120,2022-07-26,Monte Santo de Minas/MG,0,68,1,4921
1161717,2022-07-27,Monte Santo de Minas/MG,0,68,0,4921
1167314,2022-07-28,Monte Santo de Minas/MG,0,68,0,4921
1172911,2022-07-29,Monte Santo de Minas/MG,0,68,0,4921
1178508,2022-07-30,Monte Santo de Minas/MG,0,68,0,4921
1184105,2022-07-31,Monte Santo de Minas/MG,0,68,0,4921
1189702,2022-08-01,Monte Santo de Minas/MG,0,68,0,4921
1195299,2022-08-02,Monte Santo de Minas/MG,0,68,14,4935
1200896,2022-08-03,Monte Santo de Minas/MG,0,68,0,4935
1206493,2022-08-04,Monte Santo de Minas/MG,0,68,0,4935
1212090,2022-08-05,Monte Santo de Minas/MG,0,68,9,4944
1217687,2022-08-06,Monte Santo de Minas/MG,0,68,0,4944
1223284,2022-08-07,Monte Santo de Minas/MG,0,68,0,4944
1228881,2022-08-08,Monte Santo de Minas/MG,0,68,0,4944
1234478,2022-08-09,Monte Santo de Minas/MG,0,68,0,4944
1240075,2022-08-10,Monte Santo de Minas/MG,0,68,11,4955
1245672,2022-08-11,Monte Santo de Minas/MG,0,68,0,4955
1251269,2022-08-12,Monte Santo de Minas/MG,0,68,5,4960
1256866,2022-08-13,Monte Santo de Minas/MG,0,68,0,4960
1262463,2022-08-14,Monte Santo de Minas/MG,0,68,0,4960
1268060,2022-08-15,Monte Santo de Minas/MG,0,68,0,4960
1273657,2022-08-16,Monte Santo de Minas/MG,0,68,6,4966
1279254,2022-08-17,Monte Santo de Minas/MG,0,68,0,4966
1284851,2022-08-18,Monte Santo de Minas/MG,1,69,0,4966
1290448,2022-08-19,Monte Santo de Minas/MG,0,69,9,4975
1296045,2022-08-20,Monte Santo de Minas/MG,0,69,0,4975
1301642,2022-08-21,Monte Santo de Minas/MG,0,69,0,4975
1307239,2022-08-22,Monte Santo de Minas/MG,0,69,2,4977
1312836,2022-08-23,Monte Santo de Minas/MG,0,69,0,4977
1318433,2022-08-24,Monte Santo de Minas/MG,0,69,0,4977
1324030,2022-08-25,Monte Santo de Minas/MG,0,69,0,4977
3217,2022-01-01,Muzambinho/MG,0,36,0,1975
8814,2022-01-02,Muzambinho/MG,0,36,0,1975
14411,2022-01-03,Muzambinho/MG,0,36,0,1975
20008,2022-01-04,Muzambinho/MG,0,36,9,1984
25605,2022-01-05,Muzambinho/MG,0,36,0,1984
31202,2022-01-06,Muzambinho/MG,0,36,0,1984
36799,2022-01-07,Muzambinho/MG,0,36,0,1984
42396,2022-01-08,Muzambinho/MG,0,36,0,1984
47993,2022-01-09,Muzambinho/MG,0,36,0,1984
53590,2022-01-10,Muzambinho/MG,0,36,0,1984
59187,2022-01-11,Muzambinho/MG,0,36,0,1984
64784,2022-01-12,Muzambinho/MG,0,36,304,2288
70381,2022-01-13,Muzambinho/MG,0,36,60,2348
75978,2022-01-14,Muzambinho/MG,0,36,0,2348
81575,2022-01-15,Muzambinho/MG,0,36,0,2348
87172,2022-01-16,Muzambinho/MG,0,36,0,2348
92769,2022-01-17,Muzambinho/MG,0,36,0,2348
98366,2022-01-18,Muzambinho/MG,0,36,0,2348
103963,2022-01-19,Muzambinho/MG,0,36,495,2843
109560,2022-01-20,Muzambinho/MG,0,36,96,2939
115157,2022-01-21,Muzambinho/MG,0,36,0,2939
120754,2022-01-22,Muzambinho/MG,0,36,180,3119
126351,2022-01-23,Muzambinho/MG,1,37,0,3119
131948,2022-01-24,Muzambinho/MG,0,37,0,3119
137545,2022-01-25,Muzambinho/MG,0,37,141,3260
143142,2022-01-26,Muzambinho/MG,0,37,98,3358
148739,2022-01-27,Muzambinho/MG,0,37,85,3443
154336,2022-01-28,Muzambinho/MG,1,38,48,3491
159933,2022-01-29,Muzambinho/MG,0,38,57,3548
165530,2022-01-30,Muzambinho/MG,0,38,0,3548
171127,2022-01-31,Muzambinho/MG,0,38,0,3548
176724,2022-02-01,Muzambinho/MG,0,38,95,3643
182321,2022-02-02,Muzambinho/MG,0,38,62,3705
187918,2022-02-03,Muzambinho/MG,1,39,53,3758
193515,2022-02-04,Muzambinho/MG,0,39,79,3837
199112,2022-02-05,Muzambinho/MG,0,39,60,3897
204709,2022-02-06,Muzambinho/MG,0,39,0,3897
210306,2022-02-07,Muzambinho/MG,0,39,0,3897
215903,2022-02-08,Muzambinho/MG,0,39,94,3991
221500,2022-02-09,Muzambinho/MG,0,39,70,4061
227097,2022-02-10,Muzambinho/MG,2,41,37,4098
232694,2022-02-11,Muzambinho/MG,1,42,71,4169
238291,2022-02-12,Muzambinho/MG,1,43,50,4219
243888,2022-02-13,Muzambinho/MG,0,43,0,4219
249485,2022-02-14,Muzambinho/MG,0,43,0,4219
255082,2022-02-15,Muzambinho/MG,0,43,83,4302
260679,2022-02-16,Muzambinho/MG,0,43,67,4369
266276,2022-02-17,Muzambinho/MG,1,44,28,4397
271873,2022-02-18,Muzambinho/MG,0,44,0,4397
277470,2022-02-19,Muzambinho/MG,0,44,0,4397
283067,2022-02-20,Muzambinho/MG,0,44,0,4397
288664,2022-02-21,Muzambinho/MG,0,44,0,4397
294261,2022-02-22,Muzambinho/MG,0,44,109,4506
299858,2022-02-23,Muzambinho/MG,0,44,0,4506
305455,2022-02-24,Muzambinho/MG,0,44,46,4552
311052,2022-02-25,Muzambinho/MG,0,44,21,4573
316649,2022-02-26,Muzambinho/MG,0,44,26,4599
322246,2022-02-27,Muzambinho/MG,0,44,0,4599
327843,2022-02-28,Muzambinho/MG,0,44,0,4599
333440,2022-03-01,Muzambinho/MG,0,44,31,4630
339037,2022-03-02,Muzambinho/MG,0,44,0,4630
344634,2022-03-03,Muzambinho/MG,0,44,9,4639
350231,2022-03-04,Muzambinho/MG,0,44,14,4653
355828,2022-03-05,Muzambinho/MG,0,44,14,4667
361425,2022-03-06,Muzambinho/MG,0,44,0,4667
367022,2022-03-07,Muzambinho/MG,0,44,0,4667
372619,2022-03-08,Muzambinho/MG,0,44,22,4689
378216,2022-03-09,Muzambinho/MG,0,44,14,4703
383813,2022-03-10,Muzambinho/MG,0,44,7,4710
389410,2022-03-11,Muzambinho/MG,0,44,9,4719
395007,2022-03-12,Muzambinho/MG,1,45,11,4730
400604,2022-03-13,Muzambinho/MG,0,45,0,4730
406201,2022-03-14,Muzambinho/MG,0,45,0,4730
411798,2022-03-15,Muzambinho/MG,0,45,9,4739
417395,2022-03-16,Muzambinho/MG,0,45,15,4754
422992,2022-03-17,Muzambinho/MG,0,45,4,4758
428589,2022-03-18,Muzambinho/MG,0,45,2,4760
434186,2022-03-19,Muzambinho/MG,0,45,13,4773
439783,2022-03-20,Muzambinho/MG,0,45,0,4773
445380,2022-03-21,Muzambinho/MG,0,45,0,4773
450977,2022-03-22,Muzambinho/MG,0,45,8,4781
456574,2022-03-23,Muzambinho/MG,0,45,5,4786
462171,2022-03-24,Muzambinho/MG,0,45,1,4787
467768,2022-03-25,Muzambinho/MG,0,45,2,4789
473365,2022-03-26,Muzambinho/MG,0,45,0,4789
478962,2022-03-27,Muzambinho/MG,0,45,0,4789
484559,2022-03-28,Muzambinho/MG,0,45,0,4789
490156,2022-03-29,Muzambinho/MG,0,45,0,4789
495753,2022-03-30,Muzambinho/MG,0,45,3,4792
501350,2022-03-31,Muzambinho/MG,0,45,0,4792
506947,2022-04-01,Muzambinho/MG,0,45,0,4792
512544,2022-04-02,Muzambinho/MG,0,45,0,4792
518141,2022-04-03,Muzambinho/MG,0,45,0,4792
523738,2022-04-04,Muzambinho/MG,0,45,0,4792
529335,2022-04-05,Muzambinho/MG,0,45,0,4792
534932,2022-04-06,Muzambinho/MG,0,45,2,4794
540529,2022-04-07,Muzambinho/MG,0,45,0,4794
546126,2022-04-08,Muzambinho/MG,0,45,0,4794
551723,2022-04-09,Muzambinho/MG,0,45,0,4794
557320,2022-04-10,Muzambinho/MG,0,45,0,4794
562917,2022-04-11,Muzambinho/MG,0,45,0,4794
568514,2022-04-12,Muzambinho/MG,0,45,0,4794
574111,2022-04-13,Muzambinho/MG,0,45,0,4794
579708,2022-04-14,Muzambinho/MG,0,45,13,4807
585305,2022-04-15,Muzambinho/MG,0,45,0,4807
590902,2022-04-16,Muzambinho/MG,0,45,0,4807
596499,2022-04-17,Muzambinho/MG,0,45,0,4807
602096,2022-04-18,Muzambinho/MG,0,45,0,4807
607693,2022-04-19,Muzambinho/MG,0,45,0,4807
613290,2022-04-20,Muzambinho/MG,0,45,0,4807
618887,2022-04-21,Muzambinho/MG,0,45,3,4810
624484,2022-04-22,Muzambinho/MG,0,45,0,4810
630081,2022-04-23,Muzambinho/MG,0,45,0,4810
635678,2022-04-24,Muzambinho/MG,0,45,0,4810
641275,2022-04-25,Muzambinho/MG,0,45,0,4810
646872,2022-04-26,Muzambinho/MG,0,45,0,4810
652469,2022-04-27,Muzambinho/MG,0,45,1,4811
658066,2022-04-28,Muzambinho/MG,0,45,0,4811
663663,2022-04-29,Muzambinho/MG,0,45,0,4811
669260,2022-04-30,Muzambinho/MG,0,45,0,4811
674857,2022-05-01,Muzambinho/MG,0,45,0,4811
680454,2022-05-02,Muzambinho/MG,0,45,0,4811
686051,2022-05-03,Muzambinho/MG,0,45,0,4811
691648,2022-05-04,Muzambinho/MG,0,45,0,4811
697245,2022-05-05,Muzambinho/MG,0,45,17,4828
702842,2022-05-06,Muzambinho/MG,0,45,0,4828
708439,2022-05-07,Muzambinho/MG,0,45,0,4828
714036,2022-05-08,Muzambinho/MG,0,45,0,4828
719633,2022-05-09,Muzambinho/MG,0,45,0,4828
725230,2022-05-10,Muzambinho/MG,0,45,16,4844
730827,2022-05-11,Muzambinho/MG,0,45,0,4844
736424,2022-05-12,Muzambinho/MG,0,45,0,4844
742021,2022-05-13,Muzambinho/MG,0,45,0,4844
747618,2022-05-14,Muzambinho/MG,0,45,0,4844
753215,2022-05-15,Muzambinho/MG,0,45,0,4844
758812,2022-05-16,Muzambinho/MG,0,45,0,4844
764409,2022-05-17,Muzambinho/MG,0,45,0,4844
770006,2022-05-18,Muzambinho/MG,0,45,0,4844
775603,2022-05-19,Muzambinho/MG,0,45,0,4844
781200,2022-05-20,Muzambinho/MG,0,45,0,4844
786797,2022-05-21,Muzambinho/MG,0,45,0,4844
792394,2022-05-22,Muzambinho/MG,0,45,0,4844
797991,2022-05-23,Muzambinho/MG,0,45,0,4844
803588,2022-05-24,Muzambinho/MG,0,45,0,4844
809185,2022-05-25,Muzambinho/MG,0,45,81,4925
814782,2022-05-26,Muzambinho/MG,0,45,0,4925
820379,2022-05-27,Muzambinho/MG,0,45,10,4935
825976,2022-05-28,Muzambinho/MG,0,45,0,4935
831573,2022-05-29,Muzambinho/MG,0,45,0,4935
837170,2022-05-30,Muzambinho/MG,0,45,0,4935
842767,2022-05-31,Muzambinho/MG,0,45,0,4935
848364,2022-06-01,Muzambinho/MG,0,45,67,5002
853961,2022-06-02,Muzambinho/MG,0,45,0,5002
859558,2022-06-03,Muzambinho/MG,0,45,0,5002
865155,2022-06-04,Muzambinho/MG,0,45,0,5002
870752,2022-06-05,Muzambinho/MG,0,45,0,5002
876349,2022-06-06,Muzambinho/MG,0,45,0,5002
881946,2022-06-07,Muzambinho/MG,0,45,0,5002
887543,2022-06-08,Muzambinho/MG,0,45,145,5147
893140,2022-06-09,Muzambinho/MG,0,45,0,5147
898737,2022-06-10,Muzambinho/MG,0,45,0,5147
904334,2022-06-11,Muzambinho/MG,0,45,0,5147
909931,2022-06-12,Muzambinho/MG,0,45,0,5147
915528,2022-06-13,Muzambinho/MG,0,45,0,5147
921125,2022-06-14,Muzambinho/MG,1,46,0,5147
926722,2022-06-15,Muzambinho/MG,0,46,202,5349
932319,2022-06-16,Muzambinho/MG,0,46,0,5349
937916,2022-06-17,Muzambinho/MG,0,46,0,5349
943513,2022-06-18,Muzambinho/MG,0,46,0,5349
949110,2022-06-19,Muzambinho/MG,0,46,0,5349
954707,2022-06-20,Muzambinho/MG,0,46,0,5349
960304,2022-06-21,Muzambinho/MG,0,46,0,5349
965901,2022-06-22,Muzambinho/MG,0,46,111,5460
971498,2022-06-23,Muzambinho/MG,0,46,0,5460
977095,2022-06-24,Muzambinho/MG,0,46,30,5490
982692,2022-06-25,Muzambinho/MG,0,46,0,5490
988289,2022-06-26,Muzambinho/MG,0,46,0,5490
993886,2022-06-27,Muzambinho/MG,1,47,0,5490
999483,2022-06-28,Muzambinho/MG,0,47,0,5490
1005080,2022-06-29,Muzambinho/MG,0,47,147,5637
1010677,2022-06-30,Muzambinho/MG,0,47,0,5637
1016274,2022-07-01,Muzambinho/MG,0,47,0,5637
1021871,2022-07-02,Muzambinho/MG,0,47,0,5637
1027468,2022-07-03,Muzambinho/MG,0,47,0,5637
1033065,2022-07-04,Muzambinho/MG,0,47,0,5637
1038662,2022-07-05,Muzambinho/MG,0,47,0,5637
1044259,2022-07-06,Muzambinho/MG,0,47,0,5637
1049856,2022-07-07,Muzambinho/MG,0,47,121,5758
1055453,2022-07-08,Muzambinho/MG,0,47,0,5758
1061050,2022-07-09,Muzambinho/MG,0,47,0,5758
1066647,2022-07-10,Muzambinho/MG,0,47,0,5758
1072244,2022-07-11,Muzambinho/MG,1,48,0,5758
1077841,2022-07-12,Muzambinho/MG,0,48,0,5758
1083438,2022-07-13,Muzambinho/MG,1,49,112,5870
1089035,2022-07-14,Muzambinho/MG,0,49,0,5870
1094632,2022-07-15,Muzambinho/MG,-1,48,0,5870
1100229,2022-07-16,Muzambinho/MG,0,48,0,5870
1105826,2022-07-17,Muzambinho/MG,0,48,0,5870
1111423,2022-07-18,Muzambinho/MG,0,48,0,5870
1117020,2022-07-19,Muzambinho/MG,0,48,0,5870
1122617,2022-07-20,Muzambinho/MG,1,49,70,5940
1128214,2022-07-21,Muzambinho/MG,0,49,0,5940
1133811,2022-07-22,Muzambinho/MG,0,49,20,5960
1139408,2022-07-23,Muzambinho/MG,0,49,0,5960
1145005,2022-07-24,Muzambinho/MG,0,49,0,5960
1150602,2022-07-25,Muzambinho/MG,0,49,0,5960
1156199,2022-07-26,Muzambinho/MG,0,49,0,5960
1161796,2022-07-27,Muzambinho/MG,0,49,0,5960
1167393,2022-07-28,Muzambinho/MG,1,50,0,5960
1172990,2022-07-29,Muzambinho/MG,0,50,48,6008
1178587,2022-07-30,Muzambinho/MG,0,50,0,6008
1184184,2022-07-31,Muzambinho/MG,0,50,0,6008
1189781,2022-08-01,Muzambinho/MG,0,50,0,6008
1195378,2022-08-02,Muzambinho/MG,0,50,0,6008
1200975,2022-08-03,Muzambinho/MG,0,50,30,6038
1206572,2022-08-04,Muzambinho/MG,0,50,0,6038
1212169,2022-08-05,Muzambinho/MG,0,50,0,6038
1217766,2022-08-06,Muzambinho/MG,0,50,0,6038
1223363,2022-08-07,Muzambinho/MG,0,50,0,6038
1228960,2022-08-08,Muzambinho/MG,0,50,0,6038
1234557,2022-08-09,Muzambinho/MG,0,50,0,6038
1240154,2022-08-10,Muzambinho/MG,0,50,26,6064
1245751,2022-08-11,Muzambinho/MG,0,50,0,6064
1251348,2022-08-12,Muzambinho/MG,0,50,0,6064
1256945,2022-08-13,Muzambinho/MG,0,50,0,6064
1262542,2022-08-14,Muzambinho/MG,0,50,0,6064
1268139,2022-08-15,Muzambinho/MG,0,50,0,6064
1273736,2022-08-16,Muzambinho/MG,0,50,0,6064
1279333,2022-08-17,Muzambinho/MG,0,50,0,6064
1284930,2022-08-18,Muzambinho/MG,0,50,19,6083
1290527,2022-08-19,Muzambinho/MG,0,50,0,6083
1296124,2022-08-20,Muzambinho/MG,0,50,0,6083
1301721,2022-08-21,Muzambinho/MG,0,50,0,6083
1307318,2022-08-22,Muzambinho/MG,0,50,0,6083
1312915,2022-08-23,Muzambinho/MG,0,50,0,6083
1318512,2022-08-24,Muzambinho/MG,0,50,10,6093
1324109,2022-08-25,Muzambinho/MG,0,50,0,6093
3469,2022-01-01,Ouro Fino/MG,0,74,0,3025
9066,2022-01-02,Ouro Fino/MG,0,74,0,3025
14663,2022-01-03,Ouro Fino/MG,0,74,0,3025
20260,2022-01-04,Ouro Fino/MG,0,74,38,3063
25857,2022-01-05,Ouro Fino/MG,0,74,0,3063
31454,2022-01-06,Ouro Fino/MG,0,74,0,3063
37051,2022-01-07,Ouro Fino/MG,0,74,0,3063
42648,2022-01-08,Ouro Fino/MG,0,74,0,3063
48245,2022-01-09,Ouro Fino/MG,0,74,0,3063
53842,2022-01-10,Ouro Fino/MG,0,74,0,3063
59439,2022-01-11,Ouro Fino/MG,0,74,357,3420
65036,2022-01-12,Ouro Fino/MG,0,74,0,3420
70633,2022-01-13,Ouro Fino/MG,0,74,0,3420
76230,2022-01-14,Ouro Fino/MG,0,74,192,3612
81827,2022-01-15,Ouro Fino/MG,0,74,0,3612
87424,2022-01-16,Ouro Fino/MG,0,74,0,3612
93021,2022-01-17,Ouro Fino/MG,0,74,0,3612
98618,2022-01-18,Ouro Fino/MG,0,74,323,3935
104215,2022-01-19,Ouro Fino/MG,0,74,0,3935
109812,2022-01-20,Ouro Fino/MG,0,74,0,3935
115409,2022-01-21,Ouro Fino/MG,0,74,0,3935
121006,2022-01-22,Ouro Fino/MG,0,74,397,4332
126603,2022-01-23,Ouro Fino/MG,0,74,0,4332
132200,2022-01-24,Ouro Fino/MG,0,74,0,4332
137797,2022-01-25,Ouro Fino/MG,0,74,228,4560
143394,2022-01-26,Ouro Fino/MG,0,74,0,4560
148991,2022-01-27,Ouro Fino/MG,0,74,0,4560
154588,2022-01-28,Ouro Fino/MG,0,74,0,4560
160185,2022-01-29,Ouro Fino/MG,0,74,0,4560
165782,2022-01-30,Ouro Fino/MG,0,74,0,4560
171379,2022-01-31,Ouro Fino/MG,0,74,0,4560
176976,2022-02-01,Ouro Fino/MG,0,74,508,5068
182573,2022-02-02,Ouro Fino/MG,1,75,0,5068
188170,2022-02-03,Ouro Fino/MG,0,75,0,5068
193767,2022-02-04,Ouro Fino/MG,0,75,0,5068
199364,2022-02-05,Ouro Fino/MG,0,75,0,5068
204961,2022-02-06,Ouro Fino/MG,0,75,0,5068
210558,2022-02-07,Ouro Fino/MG,0,75,0,5068
216155,2022-02-08,Ouro Fino/MG,0,75,304,5372
221752,2022-02-09,Ouro Fino/MG,0,75,0,5372
227349,2022-02-10,Ouro Fino/MG,0,75,0,5372
232946,2022-02-11,Ouro Fino/MG,1,76,0,5372
238543,2022-02-12,Ouro Fino/MG,0,76,0,5372
244140,2022-02-13,Ouro Fino/MG,1,77,0,5372
249737,2022-02-14,Ouro Fino/MG,0,77,0,5372
255334,2022-02-15,Ouro Fino/MG,0,77,0,5372
260931,2022-02-16,Ouro Fino/MG,0,77,0,5372
266528,2022-02-17,Ouro Fino/MG,0,77,0,5372
272125,2022-02-18,Ouro Fino/MG,0,77,0,5372
277722,2022-02-19,Ouro Fino/MG,0,77,338,5710
283319,2022-02-20,Ouro Fino/MG,0,77,0,5710
288916,2022-02-21,Ouro Fino/MG,0,77,0,5710
294513,2022-02-22,Ouro Fino/MG,0,77,0,5710
300110,2022-02-23,Ouro Fino/MG,1,78,0,5710
305707,2022-02-24,Ouro Fino/MG,0,78,93,5803
311304,2022-02-25,Ouro Fino/MG,0,78,0,5803
316901,2022-02-26,Ouro Fino/MG,0,78,0,5803
322498,2022-02-27,Ouro Fino/MG,0,78,0,5803
328095,2022-02-28,Ouro Fino/MG,0,78,0,5803
333692,2022-03-01,Ouro Fino/MG,0,78,49,5852
339289,2022-03-02,Ouro Fino/MG,0,78,0,5852
344886,2022-03-03,Ouro Fino/MG,0,78,0,5852
350483,2022-03-04,Ouro Fino/MG,0,78,0,5852
356080,2022-03-05,Ouro Fino/MG,0,78,0,5852
361677,2022-03-06,Ouro Fino/MG,0,78,0,5852
367274,2022-03-07,Ouro Fino/MG,0,78,0,5852
372871,2022-03-08,Ouro Fino/MG,0,78,0,5852
378468,2022-03-09,Ouro Fino/MG,0,78,57,5909
384065,2022-03-10,Ouro Fino/MG,0,78,0,5909
389662,2022-03-11,Ouro Fino/MG,0,78,0,5909
395259,2022-03-12,Ouro Fino/MG,0,78,0,5909
400856,2022-03-13,Ouro Fino/MG,0,78,0,5909
406453,2022-03-14,Ouro Fino/MG,0,78,0,5909
412050,2022-03-15,Ouro Fino/MG,1,79,22,5931
417647,2022-03-16,Ouro Fino/MG,0,79,9,5940
423244,2022-03-17,Ouro Fino/MG,1,80,0,5940
428841,2022-03-18,Ouro Fino/MG,0,80,0,5940
434438,2022-03-19,Ouro Fino/MG,0,80,16,5956
440035,2022-03-20,Ouro Fino/MG,0,80,0,5956
445632,2022-03-21,Ouro Fino/MG,0,80,0,5956
451229,2022-03-22,Ouro Fino/MG,0,80,0,5956
456826,2022-03-23,Ouro Fino/MG,0,80,0,5956
462423,2022-03-24,Ouro Fino/MG,0,80,0,5956
468020,2022-03-25,Ouro Fino/MG,0,80,0,5956
473617,2022-03-26,Ouro Fino/MG,0,80,0,5956
479214,2022-03-27,Ouro Fino/MG,0,80,0,5956
484811,2022-03-28,Ouro Fino/MG,0,80,0,5956
490408,2022-03-29,Ouro Fino/MG,0,80,0,5956
496005,2022-03-30,Ouro Fino/MG,0,80,0,5956
501602,2022-03-31,Ouro Fino/MG,0,80,29,5985
507199,2022-04-01,Ouro Fino/MG,0,80,0,5985
512796,2022-04-02,Ouro Fino/MG,0,80,0,5985
518393,2022-04-03,Ouro Fino/MG,0,80,0,5985
523990,2022-04-04,Ouro Fino/MG,0,80,0,5985
529587,2022-04-05,Ouro Fino/MG,0,80,0,5985
535184,2022-04-06,Ouro Fino/MG,0,80,0,5985
540781,2022-04-07,Ouro Fino/MG,0,80,0,5985
546378,2022-04-08,Ouro Fino/MG,0,80,0,5985
551975,2022-04-09,Ouro Fino/MG,0,80,0,5985
557572,2022-04-10,Ouro Fino/MG,0,80,0,5985
563169,2022-04-11,Ouro Fino/MG,0,80,0,5985
568766,2022-04-12,Ouro Fino/MG,0,80,0,5985
574363,2022-04-13,Ouro Fino/MG,0,80,0,5985
579960,2022-04-14,Ouro Fino/MG,0,80,0,5985
585557,2022-04-15,Ouro Fino/MG,0,80,0,5985
591154,2022-04-16,Ouro Fino/MG,0,80,0,5985
596751,2022-04-17,Ouro Fino/MG,0,80,0,5985
602348,2022-04-18,Ouro Fino/MG,0,80,0,5985
607945,2022-04-19,Ouro Fino/MG,0,80,0,5985
613542,2022-04-20,Ouro Fino/MG,0,80,0,5985
619139,2022-04-21,Ouro Fino/MG,0,80,0,5985
624736,2022-04-22,Ouro Fino/MG,0,80,0,5985
630333,2022-04-23,Ouro Fino/MG,0,80,0,5985
635930,2022-04-24,Ouro Fino/MG,0,80,0,5985
641527,2022-04-25,Ouro Fino/MG,0,80,0,5985
647124,2022-04-26,Ouro Fino/MG,0,80,0,5985
652721,2022-04-27,Ouro Fino/MG,0,80,0,5985
658318,2022-04-28,Ouro Fino/MG,0,80,0,5985
663915,2022-04-29,Ouro Fino/MG,0,80,0,5985
669512,2022-04-30,Ouro Fino/MG,0,80,0,5985
675109,2022-05-01,Ouro Fino/MG,0,80,0,5985
680706,2022-05-02,Ouro Fino/MG,0,80,0,5985
686303,2022-05-03,Ouro Fino/MG,0,80,0,5985
691900,2022-05-04,Ouro Fino/MG,0,80,0,5985
697497,2022-05-05,Ouro Fino/MG,0,80,0,5985
703094,2022-05-06,Ouro Fino/MG,0,80,0,5985
708691,2022-05-07,Ouro Fino/MG,0,80,0,5985
714288,2022-05-08,Ouro Fino/MG,0,80,0,5985
719885,2022-05-09,Ouro Fino/MG,0,80,0,5985
725482,2022-05-10,Ouro Fino/MG,0,80,0,5985
731079,2022-05-11,Ouro Fino/MG,0,80,0,5985
736676,2022-05-12,Ouro Fino/MG,0,80,0,5985
742273,2022-05-13,Ouro Fino/MG,0,80,0,5985
747870,2022-05-14,Ouro Fino/MG,0,80,0,5985
753467,2022-05-15,Ouro Fino/MG,0,80,0,5985
759064,2022-05-16,Ouro Fino/MG,0,80,0,5985
764661,2022-05-17,Ouro Fino/MG,0,80,0,5985
770258,2022-05-18,Ouro Fino/MG,0,80,0,5985
775855,2022-05-19,Ouro Fino/MG,0,80,0,5985
781452,2022-05-20,Ouro Fino/MG,0,80,0,5985
787049,2022-05-21,Ouro Fino/MG,0,80,0,5985
792646,2022-05-22,Ouro Fino/MG,0,80,0,5985
798243,2022-05-23,Ouro Fino/MG,0,80,0,5985
803840,2022-05-24,Ouro Fino/MG,0,80,0,5985
809437,2022-05-25,Ouro Fino/MG,0,80,0,5985
815034,2022-05-26,Ouro Fino/MG,0,80,96,6081
820631,2022-05-27,Ouro Fino/MG,0,80,0,6081
826228,2022-05-28,Ouro Fino/MG,0,80,0,6081
831825,2022-05-29,Ouro Fino/MG,0,80,0,6081
837422,2022-05-30,Ouro Fino/MG,0,80,21,6102
843019,2022-05-31,Ouro Fino/MG,0,80,0,6102
848616,2022-06-01,Ouro Fino/MG,0,80,42,6144
854213,2022-06-02,Ouro Fino/MG,0,80,0,6144
859810,2022-06-03,Ouro Fino/MG,0,80,88,6232
865407,2022-06-04,Ouro Fino/MG,0,80,0,6232
871004,2022-06-05,Ouro Fino/MG,0,80,0,6232
876601,2022-06-06,Ouro Fino/MG,0,80,0,6232
882198,2022-06-07,Ouro Fino/MG,0,80,0,6232
887795,2022-06-08,Ouro Fino/MG,0,80,202,6434
893392,2022-06-09,Ouro Fino/MG,0,80,0,6434
898989,2022-06-10,Ouro Fino/MG,0,80,150,6584
904586,2022-06-11,Ouro Fino/MG,0,80,0,6584
910183,2022-06-12,Ouro Fino/MG,0,80,0,6584
915780,2022-06-13,Ouro Fino/MG,0,80,0,6584
921377,2022-06-14,Ouro Fino/MG,0,80,0,6584
926974,2022-06-15,Ouro Fino/MG,1,81,230,6814
932571,2022-06-16,Ouro Fino/MG,0,81,0,6814
938168,2022-06-17,Ouro Fino/MG,0,81,0,6814
943765,2022-06-18,Ouro Fino/MG,0,81,0,6814
949362,2022-06-19,Ouro Fino/MG,0,81,0,6814
954959,2022-06-20,Ouro Fino/MG,0,81,0,6814
960556,2022-06-21,Ouro Fino/MG,0,81,0,6814
966153,2022-06-22,Ouro Fino/MG,0,81,0,6814
971750,2022-06-23,Ouro Fino/MG,0,81,0,6814
977347,2022-06-24,Ouro Fino/MG,0,81,367,7181
982944,2022-06-25,Ouro Fino/MG,0,81,0,7181
988541,2022-06-26,Ouro Fino/MG,0,81,0,7181
994138,2022-06-27,Ouro Fino/MG,0,81,29,7210
999735,2022-06-28,Ouro Fino/MG,0,81,0,7210
1005332,2022-06-29,Ouro Fino/MG,0,81,0,7210
1010929,2022-06-30,Ouro Fino/MG,0,81,0,7210
1016526,2022-07-01,Ouro Fino/MG,0,81,0,7210
1022123,2022-07-02,Ouro Fino/MG,0,81,0,7210
1027720,2022-07-03,Ouro Fino/MG,0,81,0,7210
1033317,2022-07-04,Ouro Fino/MG,0,81,0,7210
1038914,2022-07-05,Ouro Fino/MG,0,81,262,7472
1044511,2022-07-06,Ouro Fino/MG,0,81,67,7539
1050108,2022-07-07,Ouro Fino/MG,0,81,0,7539
1055705,2022-07-08,Ouro Fino/MG,0,81,0,7539
1061302,2022-07-09,Ouro Fino/MG,0,81,0,7539
1066899,2022-07-10,Ouro Fino/MG,0,81,0,7539
1072496,2022-07-11,Ouro Fino/MG,0,81,106,7645
1078093,2022-07-12,Ouro Fino/MG,0,81,21,7666
1083690,2022-07-13,Ouro Fino/MG,1,82,22,7688
1089287,2022-07-14,Ouro Fino/MG,0,82,0,7688
1094884,2022-07-15,Ouro Fino/MG,0,82,0,7688
1100481,2022-07-16,Ouro Fino/MG,0,82,0,7688
1106078,2022-07-17,Ouro Fino/MG,0,82,0,7688
1111675,2022-07-18,Ouro Fino/MG,0,82,60,7748
1117272,2022-07-19,Ouro Fino/MG,0,82,17,7765
1122869,2022-07-20,Ouro Fino/MG,1,83,0,7765
1128466,2022-07-21,Ouro Fino/MG,0,83,40,7805
1134063,2022-07-22,Ouro Fino/MG,0,83,0,7805
1139660,2022-07-23,Ouro Fino/MG,0,83,0,7805
1145257,2022-07-24,Ouro Fino/MG,0,83,0,7805
1150854,2022-07-25,Ouro Fino/MG,0,83,0,7805
1156451,2022-07-26,Ouro Fino/MG,0,83,32,7837
1162048,2022-07-27,Ouro Fino/MG,0,83,0,7837
1167645,2022-07-28,Ouro Fino/MG,0,83,0,7837
1173242,2022-07-29,Ouro Fino/MG,0,83,34,7871
1178839,2022-07-30,Ouro Fino/MG,0,83,0,7871
1184436,2022-07-31,Ouro Fino/MG,0,83,0,7871
1190033,2022-08-01,Ouro Fino/MG,0,83,0,7871
1195630,2022-08-02,Ouro Fino/MG,0,83,0,7871
1201227,2022-08-03,Ouro Fino/MG,0,83,12,7883
1206824,2022-08-04,Ouro Fino/MG,0,83,0,7883
1212421,2022-08-05,Ouro Fino/MG,0,83,0,7883
1218018,2022-08-06,Ouro Fino/MG,0,83,0,7883
1223615,2022-08-07,Ouro Fino/MG,0,83,0,7883
1229212,2022-08-08,Ouro Fino/MG,0,83,0,7883
1234809,2022-08-09,Ouro Fino/MG,0,83,8,7891
1240406,2022-08-10,Ouro Fino/MG,0,83,0,7891
1246003,2022-08-11,Ouro Fino/MG,0,83,0,7891
1251600,2022-08-12,Ouro Fino/MG,0,83,0,7891
1257197,2022-08-13,Ouro Fino/MG,0,83,0,7891
1262794,2022-08-14,Ouro Fino/MG,0,83,0,7891
1268391,2022-08-15,Ouro Fino/MG,0,83,0,7891
1273988,2022-08-16,Ouro Fino/MG,0,83,0,7891
1279585,2022-08-17,Ouro Fino/MG,0,83,0,7891
1285182,2022-08-18,Ouro Fino/MG,0,83,0,7891
1290779,2022-08-19,Ouro Fino/MG,0,83,0,7891
1296376,2022-08-20,Ouro Fino/MG,0,83,0,7891
1301973,2022-08-21,Ouro Fino/MG,0,83,0,7891
1307570,2022-08-22,Ouro Fino/MG,0,83,0,7891
1313167,2022-08-23,Ouro Fino/MG,0,83,0,7891
1318764,2022-08-24,Ouro Fino/MG,0,83,0,7891
1324361,2022-08-25,Ouro Fino/MG,0,83,0,7891
3556,2022-01-01,Paraguaçu/MG,0,50,0,2314
9153,2022-01-02,Paraguaçu/MG,0,50,0,2314
14750,2022-01-03,Paraguaçu/MG,0,50,0,2314
20347,2022-01-04,Paraguaçu/MG,0,50,50,2364
25944,2022-01-05,Paraguaçu/MG,0,50,72,2436
31541,2022-01-06,Paraguaçu/MG,0,50,0,2436
37138,2022-01-07,Paraguaçu/MG,0,50,188,2624
42735,2022-01-08,Paraguaçu/MG,0,50,86,2710
48332,2022-01-09,Paraguaçu/MG,0,50,0,2710
53929,2022-01-10,Paraguaçu/MG,0,50,0,2710
59526,2022-01-11,Paraguaçu/MG,0,50,68,2778
65123,2022-01-12,Paraguaçu/MG,0,50,86,2864
70720,2022-01-13,Paraguaçu/MG,0,50,101,2965
76317,2022-01-14,Paraguaçu/MG,0,50,91,3056
81914,2022-01-15,Paraguaçu/MG,0,50,60,3116
87511,2022-01-16,Paraguaçu/MG,0,50,0,3116
93108,2022-01-17,Paraguaçu/MG,0,50,0,3116
98705,2022-01-18,Paraguaçu/MG,0,50,167,3283
104302,2022-01-19,Paraguaçu/MG,0,50,112,3395
109899,2022-01-20,Paraguaçu/MG,0,50,75,3470
115496,2022-01-21,Paraguaçu/MG,0,50,97,3567
121093,2022-01-22,Paraguaçu/MG,1,51,88,3655
126690,2022-01-23,Paraguaçu/MG,0,51,0,3655
132287,2022-01-24,Paraguaçu/MG,0,51,0,3655
137884,2022-01-25,Paraguaçu/MG,0,51,140,3795
143481,2022-01-26,Paraguaçu/MG,0,51,111,3906
149078,2022-01-27,Paraguaçu/MG,0,51,63,3969
154675,2022-01-28,Paraguaçu/MG,0,51,72,4041
160272,2022-01-29,Paraguaçu/MG,0,51,67,4108
165869,2022-01-30,Paraguaçu/MG,0,51,0,4108
171466,2022-01-31,Paraguaçu/MG,0,51,0,4108
177063,2022-02-01,Paraguaçu/MG,0,51,82,4190
182660,2022-02-02,Paraguaçu/MG,0,51,77,4267
188257,2022-02-03,Paraguaçu/MG,0,51,43,4310
193854,2022-02-04,Paraguaçu/MG,0,51,29,4339
199451,2022-02-05,Paraguaçu/MG,0,51,33,4372
205048,2022-02-06,Paraguaçu/MG,0,51,0,4372
210645,2022-02-07,Paraguaçu/MG,0,51,0,4372
216242,2022-02-08,Paraguaçu/MG,0,51,51,4423
221839,2022-02-09,Paraguaçu/MG,0,51,40,4463
227436,2022-02-10,Paraguaçu/MG,0,51,25,4488
233033,2022-02-11,Paraguaçu/MG,1,52,20,4508
238630,2022-02-12,Paraguaçu/MG,0,52,23,4531
244227,2022-02-13,Paraguaçu/MG,0,52,0,4531
249824,2022-02-14,Paraguaçu/MG,0,52,0,4531
255421,2022-02-15,Paraguaçu/MG,0,52,32,4563
261018,2022-02-16,Paraguaçu/MG,0,52,37,4600
266615,2022-02-17,Paraguaçu/MG,0,52,16,4616
272212,2022-02-18,Paraguaçu/MG,0,52,24,4640
277809,2022-02-19,Paraguaçu/MG,0,52,34,4674
283406,2022-02-20,Paraguaçu/MG,1,53,0,4674
289003,2022-02-21,Paraguaçu/MG,0,53,0,4674
294600,2022-02-22,Paraguaçu/MG,0,53,38,4712
300197,2022-02-23,Paraguaçu/MG,0,53,0,4712
305794,2022-02-24,Paraguaçu/MG,0,53,46,4758
311391,2022-02-25,Paraguaçu/MG,0,53,44,4802
316988,2022-02-26,Paraguaçu/MG,0,53,45,4847
322585,2022-02-27,Paraguaçu/MG,0,53,0,4847
328182,2022-02-28,Paraguaçu/MG,0,53,0,4847
333779,2022-03-01,Paraguaçu/MG,0,53,0,4847
339376,2022-03-02,Paraguaçu/MG,0,53,0,4847
344973,2022-03-03,Paraguaçu/MG,0,53,32,4879
350570,2022-03-04,Paraguaçu/MG,0,53,56,4935
356167,2022-03-05,Paraguaçu/MG,1,54,32,4967
361764,2022-03-06,Paraguaçu/MG,1,55,0,4967
367361,2022-03-07,Paraguaçu/MG,0,55,0,4967
372958,2022-03-08,Paraguaçu/MG,0,55,12,4979
378555,2022-03-09,Paraguaçu/MG,0,55,23,5002
384152,2022-03-10,Paraguaçu/MG,0,55,13,5015
389749,2022-03-11,Paraguaçu/MG,1,56,0,5015
395346,2022-03-12,Paraguaçu/MG,0,56,14,5029
400943,2022-03-13,Paraguaçu/MG,0,56,0,5029
406540,2022-03-14,Paraguaçu/MG,0,56,0,5029
412137,2022-03-15,Paraguaçu/MG,1,57,15,5044
417734,2022-03-16,Paraguaçu/MG,0,57,11,5055
423331,2022-03-17,Paraguaçu/MG,0,57,10,5065
428928,2022-03-18,Paraguaçu/MG,0,57,3,5068
434525,2022-03-19,Paraguaçu/MG,0,57,5,5073
440122,2022-03-20,Paraguaçu/MG,0,57,0,5073
445719,2022-03-21,Paraguaçu/MG,0,57,0,5073
451316,2022-03-22,Paraguaçu/MG,0,57,5,5078
456913,2022-03-23,Paraguaçu/MG,0,57,1,5079
462510,2022-03-24,Paraguaçu/MG,0,57,7,5086
468107,2022-03-25,Paraguaçu/MG,0,57,2,5088
473704,2022-03-26,Paraguaçu/MG,0,57,2,5090
479301,2022-03-27,Paraguaçu/MG,0,57,0,5090
484898,2022-03-28,Paraguaçu/MG,0,57,0,5090
490495,2022-03-29,Paraguaçu/MG,0,57,2,5092
496092,2022-03-30,Paraguaçu/MG,-1,56,4,5096
501689,2022-03-31,Paraguaçu/MG,0,56,1,5097
507286,2022-04-01,Paraguaçu/MG,0,56,2,5099
512883,2022-04-02,Paraguaçu/MG,0,56,0,5099
518480,2022-04-03,Paraguaçu/MG,0,56,0,5099
524077,2022-04-04,Paraguaçu/MG,0,56,5,5104
529674,2022-04-05,Paraguaçu/MG,0,56,0,5104
535271,2022-04-06,Paraguaçu/MG,0,56,0,5104
540868,2022-04-07,Paraguaçu/MG,0,56,9,5113
546465,2022-04-08,Paraguaçu/MG,0,56,2,5115
552062,2022-04-09,Paraguaçu/MG,0,56,0,5115
557659,2022-04-10,Paraguaçu/MG,0,56,0,5115
563256,2022-04-11,Paraguaçu/MG,0,56,0,5115
568853,2022-04-12,Paraguaçu/MG,0,56,0,5115
574450,2022-04-13,Paraguaçu/MG,0,56,2,5117
580047,2022-04-14,Paraguaçu/MG,0,56,3,5120
585644,2022-04-15,Paraguaçu/MG,0,56,0,5120
591241,2022-04-16,Paraguaçu/MG,0,56,0,5120
596838,2022-04-17,Paraguaçu/MG,0,56,0,5120
602435,2022-04-18,Paraguaçu/MG,0,56,0,5120
608032,2022-04-19,Paraguaçu/MG,0,56,0,5120
613629,2022-04-20,Paraguaçu/MG,0,56,0,5120
619226,2022-04-21,Paraguaçu/MG,0,56,2,5122
624823,2022-04-22,Paraguaçu/MG,0,56,0,5122
630420,2022-04-23,Paraguaçu/MG,0,56,0,5122
636017,2022-04-24,Paraguaçu/MG,0,56,0,5122
641614,2022-04-25,Paraguaçu/MG,0,56,0,5122
647211,2022-04-26,Paraguaçu/MG,0,56,0,5122
652808,2022-04-27,Paraguaçu/MG,0,56,0,5122
658405,2022-04-28,Paraguaçu/MG,0,56,1,5123
664002,2022-04-29,Paraguaçu/MG,0,56,2,5125
669599,2022-04-30,Paraguaçu/MG,0,56,0,5125
675196,2022-05-01,Paraguaçu/MG,0,56,0,5125
680793,2022-05-02,Paraguaçu/MG,0,56,0,5125
686390,2022-05-03,Paraguaçu/MG,0,56,0,5125
691987,2022-05-04,Paraguaçu/MG,0,56,4,5129
697584,2022-05-05,Paraguaçu/MG,0,56,0,5129
703181,2022-05-06,Paraguaçu/MG,0,56,5,5134
708778,2022-05-07,Paraguaçu/MG,0,56,0,5134
714375,2022-05-08,Paraguaçu/MG,0,56,0,5134
719972,2022-05-09,Paraguaçu/MG,0,56,0,5134
725569,2022-05-10,Paraguaçu/MG,0,56,5,5139
731166,2022-05-11,Paraguaçu/MG,0,56,2,5141
736763,2022-05-12,Paraguaçu/MG,0,56,0,5141
742360,2022-05-13,Paraguaçu/MG,0,56,4,5145
747957,2022-05-14,Paraguaçu/MG,0,56,0,5145
753554,2022-05-15,Paraguaçu/MG,0,56,0,5145
759151,2022-05-16,Paraguaçu/MG,0,56,2,5147
764748,2022-05-17,Paraguaçu/MG,0,56,2,5149
770345,2022-05-18,Paraguaçu/MG,0,56,6,5155
775942,2022-05-19,Paraguaçu/MG,0,56,8,5163
781539,2022-05-20,Paraguaçu/MG,0,56,0,5163
787136,2022-05-21,Paraguaçu/MG,0,56,0,5163
792733,2022-05-22,Paraguaçu/MG,0,56,0,5163
798330,2022-05-23,Paraguaçu/MG,0,56,2,5165
803927,2022-05-24,Paraguaçu/MG,0,56,0,5165
809524,2022-05-25,Paraguaçu/MG,0,56,26,5191
815121,2022-05-26,Paraguaçu/MG,0,56,13,5204
820718,2022-05-27,Paraguaçu/MG,0,56,18,5222
826315,2022-05-28,Paraguaçu/MG,0,56,0,5222
831912,2022-05-29,Paraguaçu/MG,0,56,0,5222
837509,2022-05-30,Paraguaçu/MG,0,56,25,5247
843106,2022-05-31,Paraguaçu/MG,0,56,0,5247
848703,2022-06-01,Paraguaçu/MG,0,56,91,5338
854300,2022-06-02,Paraguaçu/MG,0,56,46,5384
859897,2022-06-03,Paraguaçu/MG,0,56,49,5433
865494,2022-06-04,Paraguaçu/MG,0,56,0,5433
871091,2022-06-05,Paraguaçu/MG,0,56,0,5433
876688,2022-06-06,Paraguaçu/MG,0,56,41,5474
882285,2022-06-07,Paraguaçu/MG,0,56,40,5514
887882,2022-06-08,Paraguaçu/MG,0,56,0,5514
893479,2022-06-09,Paraguaçu/MG,0,56,0,5514
899076,2022-06-10,Paraguaçu/MG,0,56,103,5617
904673,2022-06-11,Paraguaçu/MG,0,56,0,5617
910270,2022-06-12,Paraguaçu/MG,0,56,0,5617
915867,2022-06-13,Paraguaçu/MG,0,56,0,5617
921464,2022-06-14,Paraguaçu/MG,0,56,44,5661
927061,2022-06-15,Paraguaçu/MG,0,56,47,5708
932658,2022-06-16,Paraguaçu/MG,0,56,0,5708
938255,2022-06-17,Paraguaçu/MG,0,56,0,5708
943852,2022-06-18,Paraguaçu/MG,0,56,0,5708
949449,2022-06-19,Paraguaçu/MG,0,56,0,5708
955046,2022-06-20,Paraguaçu/MG,0,56,15,5723
960643,2022-06-21,Paraguaçu/MG,0,56,13,5736
966240,2022-06-22,Paraguaçu/MG,0,56,18,5754
971837,2022-06-23,Paraguaçu/MG,0,56,39,5793
977434,2022-06-24,Paraguaçu/MG,0,56,18,5811
983031,2022-06-25,Paraguaçu/MG,0,56,0,5811
988628,2022-06-26,Paraguaçu/MG,0,56,0,5811
994225,2022-06-27,Paraguaçu/MG,0,56,29,5840
999822,2022-06-28,Paraguaçu/MG,0,56,18,5858
1005419,2022-06-29,Paraguaçu/MG,0,56,43,5901
1011016,2022-06-30,Paraguaçu/MG,0,56,0,5901
1016613,2022-07-01,Paraguaçu/MG,0,56,62,5963
1022210,2022-07-02,Paraguaçu/MG,0,56,0,5963
1027807,2022-07-03,Paraguaçu/MG,0,56,0,5963
1033404,2022-07-04,Paraguaçu/MG,0,56,25,5988
1039001,2022-07-05,Paraguaçu/MG,0,56,28,6016
1044598,2022-07-06,Paraguaçu/MG,0,56,0,6016
1050195,2022-07-07,Paraguaçu/MG,0,56,77,6093
1055792,2022-07-08,Paraguaçu/MG,0,56,19,6112
1061389,2022-07-09,Paraguaçu/MG,0,56,0,6112
1066986,2022-07-10,Paraguaçu/MG,0,56,0,6112
1072583,2022-07-11,Paraguaçu/MG,0,56,27,6139
1078180,2022-07-12,Paraguaçu/MG,0,56,36,6175
1083777,2022-07-13,Paraguaçu/MG,0,56,21,6196
1089374,2022-07-14,Paraguaçu/MG,0,56,31,6227
1094971,2022-07-15,Paraguaçu/MG,1,57,21,6248
1100568,2022-07-16,Paraguaçu/MG,0,57,0,6248
1106165,2022-07-17,Paraguaçu/MG,0,57,0,6248
1111762,2022-07-18,Paraguaçu/MG,0,57,33,6281
1117359,2022-07-19,Paraguaçu/MG,1,58,0,6281
1122956,2022-07-20,Paraguaçu/MG,0,58,58,6339
1128553,2022-07-21,Paraguaçu/MG,0,58,39,6378
1134150,2022-07-22,Paraguaçu/MG,0,58,16,6394
1139747,2022-07-23,Paraguaçu/MG,0,58,0,6394
1145344,2022-07-24,Paraguaçu/MG,0,58,0,6394
1150941,2022-07-25,Paraguaçu/MG,0,58,17,6411
1156538,2022-07-26,Paraguaçu/MG,0,58,0,6411
1162135,2022-07-27,Paraguaçu/MG,0,58,0,6411
1167732,2022-07-28,Paraguaçu/MG,0,58,67,6478
1173329,2022-07-29,Paraguaçu/MG,0,58,13,6491
1178926,2022-07-30,Paraguaçu/MG,0,58,0,6491
1184523,2022-07-31,Paraguaçu/MG,0,58,0,6491
1190120,2022-08-01,Paraguaçu/MG,0,58,29,6520
1195717,2022-08-02,Paraguaçu/MG,0,58,20,6540
1201314,2022-08-03,Paraguaçu/MG,0,58,0,6540
1206911,2022-08-04,Paraguaçu/MG,0,58,13,6553
1212508,2022-08-05,Paraguaçu/MG,1,59,25,6578
1218105,2022-08-06,Paraguaçu/MG,0,59,0,6578
1223702,2022-08-07,Paraguaçu/MG,0,59,0,6578
1229299,2022-08-08,Paraguaçu/MG,0,59,6,6584
1234896,2022-08-09,Paraguaçu/MG,0,59,5,6589
1240493,2022-08-10,Paraguaçu/MG,0,59,8,6597
1246090,2022-08-11,Paraguaçu/MG,0,59,0,6597
1251687,2022-08-12,Paraguaçu/MG,0,59,9,6606
1257284,2022-08-13,Paraguaçu/MG,0,59,0,6606
1262881,2022-08-14,Paraguaçu/MG,0,59,0,6606
1268478,2022-08-15,Paraguaçu/MG,0,59,0,6606
1274075,2022-08-16,Paraguaçu/MG,0,59,5,6611
1279672,2022-08-17,Paraguaçu/MG,0,59,0,6611
1285269,2022-08-18,Paraguaçu/MG,0,59,2,6613
1290866,2022-08-19,Paraguaçu/MG,0,59,6,6619
1296463,2022-08-20,Paraguaçu/MG,0,59,0,6619
1302060,2022-08-21,Paraguaçu/MG,0,59,0,6619
1307657,2022-08-22,Paraguaçu/MG,0,59,0,6619
1313254,2022-08-23,Paraguaçu/MG,0,59,1,6620
1318851,2022-08-24,Paraguaçu/MG,0,59,0,6620
1324448,2022-08-25,Paraguaçu/MG,0,59,0,6620
3560,2022-01-01,Paraisópolis/MG,0,59,0,2108
9157,2022-01-02,Paraisópolis/MG,0,59,0,2108
14754,2022-01-03,Paraisópolis/MG,0,59,16,2124
20351,2022-01-04,Paraisópolis/MG,0,59,0,2124
25948,2022-01-05,Paraisópolis/MG,0,59,7,2131
31545,2022-01-06,Paraisópolis/MG,0,59,24,2155
37142,2022-01-07,Paraisópolis/MG,0,59,0,2155
42739,2022-01-08,Paraisópolis/MG,0,59,95,2250
48336,2022-01-09,Paraisópolis/MG,0,59,0,2250
53933,2022-01-10,Paraisópolis/MG,0,59,0,2250
59530,2022-01-11,Paraisópolis/MG,0,59,67,2317
65127,2022-01-12,Paraisópolis/MG,1,60,29,2346
70724,2022-01-13,Paraisópolis/MG,0,60,89,2435
76321,2022-01-14,Paraisópolis/MG,0,60,96,2531
81918,2022-01-15,Paraisópolis/MG,0,60,115,2646
87515,2022-01-16,Paraisópolis/MG,0,60,0,2646
93112,2022-01-17,Paraisópolis/MG,0,60,0,2646
98709,2022-01-18,Paraisópolis/MG,0,60,70,2716
104306,2022-01-19,Paraisópolis/MG,0,60,0,2716
109903,2022-01-20,Paraisópolis/MG,0,60,137,2853
115500,2022-01-21,Paraisópolis/MG,1,61,91,2944
121097,2022-01-22,Paraisópolis/MG,0,61,50,2994
126694,2022-01-23,Paraisópolis/MG,1,62,0,2994
132291,2022-01-24,Paraisópolis/MG,0,62,0,2994
137888,2022-01-25,Paraisópolis/MG,0,62,41,3035
143485,2022-01-26,Paraisópolis/MG,2,64,0,3035
149082,2022-01-27,Paraisópolis/MG,0,64,88,3123
154679,2022-01-28,Paraisópolis/MG,0,64,91,3214
160276,2022-01-29,Paraisópolis/MG,0,64,91,3305
165873,2022-01-30,Paraisópolis/MG,0,64,0,3305
171470,2022-01-31,Paraisópolis/MG,0,64,0,3305
177067,2022-02-01,Paraisópolis/MG,0,64,87,3392
182664,2022-02-02,Paraisópolis/MG,3,67,36,3428
188261,2022-02-03,Paraisópolis/MG,0,67,98,3526
193858,2022-02-04,Paraisópolis/MG,0,67,46,3572
199455,2022-02-05,Paraisópolis/MG,0,67,46,3618
205052,2022-02-06,Paraisópolis/MG,0,67,0,3618
210649,2022-02-07,Paraisópolis/MG,0,67,0,3618
216246,2022-02-08,Paraisópolis/MG,0,67,46,3664
221843,2022-02-09,Paraisópolis/MG,0,67,63,3727
227440,2022-02-10,Paraisópolis/MG,0,67,0,3727
233037,2022-02-11,Paraisópolis/MG,0,67,84,3811
238634,2022-02-12,Paraisópolis/MG,0,67,38,3849
244231,2022-02-13,Paraisópolis/MG,0,67,0,3849
249828,2022-02-14,Paraisópolis/MG,0,67,0,3849
255425,2022-02-15,Paraisópolis/MG,0,67,31,3880
261022,2022-02-16,Paraisópolis/MG,0,67,16,3896
266619,2022-02-17,Paraisópolis/MG,0,67,23,3919
272216,2022-02-18,Paraisópolis/MG,0,67,1,3920
277813,2022-02-19,Paraisópolis/MG,0,67,5,3925
283410,2022-02-20,Paraisópolis/MG,0,67,0,3925
289007,2022-02-21,Paraisópolis/MG,0,67,0,3925
294604,2022-02-22,Paraisópolis/MG,0,67,13,3938
300201,2022-02-23,Paraisópolis/MG,0,67,10,3948
305798,2022-02-24,Paraisópolis/MG,0,67,10,3958
311395,2022-02-25,Paraisópolis/MG,0,67,10,3968
316992,2022-02-26,Paraisópolis/MG,0,67,9,3977
322589,2022-02-27,Paraisópolis/MG,0,67,0,3977
328186,2022-02-28,Paraisópolis/MG,0,67,0,3977
333783,2022-03-01,Paraisópolis/MG,0,67,0,3977
339380,2022-03-02,Paraisópolis/MG,0,67,0,3977
344977,2022-03-03,Paraisópolis/MG,0,67,11,3988
350574,2022-03-04,Paraisópolis/MG,0,67,0,3988
356171,2022-03-05,Paraisópolis/MG,0,67,15,4003
361768,2022-03-06,Paraisópolis/MG,0,67,0,4003
367365,2022-03-07,Paraisópolis/MG,0,67,0,4003
372962,2022-03-08,Paraisópolis/MG,0,67,4,4007
378559,2022-03-09,Paraisópolis/MG,0,67,5,4012
384156,2022-03-10,Paraisópolis/MG,0,67,0,4012
389753,2022-03-11,Paraisópolis/MG,0,67,4,4016
395350,2022-03-12,Paraisópolis/MG,0,67,6,4022
400947,2022-03-13,Paraisópolis/MG,0,67,0,4022
406544,2022-03-14,Paraisópolis/MG,0,67,0,4022
412141,2022-03-15,Paraisópolis/MG,0,67,1,4023
417738,2022-03-16,Paraisópolis/MG,0,67,1,4024
423335,2022-03-17,Paraisópolis/MG,0,67,2,4026
428932,2022-03-18,Paraisópolis/MG,0,67,0,4026
434529,2022-03-19,Paraisópolis/MG,0,67,0,4026
440126,2022-03-20,Paraisópolis/MG,0,67,0,4026
445723,2022-03-21,Paraisópolis/MG,0,67,0,4026
451320,2022-03-22,Paraisópolis/MG,0,67,1,4027
456917,2022-03-23,Paraisópolis/MG,0,67,0,4027
462514,2022-03-24,Paraisópolis/MG,0,67,0,4027
468111,2022-03-25,Paraisópolis/MG,0,67,0,4027
473708,2022-03-26,Paraisópolis/MG,0,67,0,4027
479305,2022-03-27,Paraisópolis/MG,0,67,0,4027
484902,2022-03-28,Paraisópolis/MG,0,67,0,4027
490499,2022-03-29,Paraisópolis/MG,0,67,0,4027
496096,2022-03-30,Paraisópolis/MG,0,67,0,4027
501693,2022-03-31,Paraisópolis/MG,0,67,0,4027
507290,2022-04-01,Paraisópolis/MG,0,67,0,4027
512887,2022-04-02,Paraisópolis/MG,0,67,0,4027
518484,2022-04-03,Paraisópolis/MG,0,67,0,4027
524081,2022-04-04,Paraisópolis/MG,0,67,3,4030
529678,2022-04-05,Paraisópolis/MG,0,67,1,4031
535275,2022-04-06,Paraisópolis/MG,0,67,0,4031
540872,2022-04-07,Paraisópolis/MG,0,67,0,4031
546469,2022-04-08,Paraisópolis/MG,0,67,-1,4030
552066,2022-04-09,Paraisópolis/MG,0,67,0,4030
557663,2022-04-10,Paraisópolis/MG,0,67,0,4030
563260,2022-04-11,Paraisópolis/MG,0,67,0,4030
568857,2022-04-12,Paraisópolis/MG,0,67,0,4030
574454,2022-04-13,Paraisópolis/MG,0,67,0,4030
580051,2022-04-14,Paraisópolis/MG,0,67,3,4033
585648,2022-04-15,Paraisópolis/MG,0,67,0,4033
591245,2022-04-16,Paraisópolis/MG,0,67,0,4033
596842,2022-04-17,Paraisópolis/MG,0,67,0,4033
602439,2022-04-18,Paraisópolis/MG,0,67,0,4033
608036,2022-04-19,Paraisópolis/MG,0,67,0,4033
613633,2022-04-20,Paraisópolis/MG,0,67,0,4033
619230,2022-04-21,Paraisópolis/MG,0,67,0,4033
624827,2022-04-22,Paraisópolis/MG,0,67,0,4033
630424,2022-04-23,Paraisópolis/MG,0,67,0,4033
636021,2022-04-24,Paraisópolis/MG,0,67,0,4033
641618,2022-04-25,Paraisópolis/MG,0,67,0,4033
647215,2022-04-26,Paraisópolis/MG,0,67,5,4038
652812,2022-04-27,Paraisópolis/MG,0,67,0,4038
658409,2022-04-28,Paraisópolis/MG,0,67,0,4038
664006,2022-04-29,Paraisópolis/MG,0,67,0,4038
669603,2022-04-30,Paraisópolis/MG,0,67,0,4038
675200,2022-05-01,Paraisópolis/MG,0,67,0,4038
680797,2022-05-02,Paraisópolis/MG,0,67,0,4038
686394,2022-05-03,Paraisópolis/MG,0,67,0,4038
691991,2022-05-04,Paraisópolis/MG,0,67,10,4048
697588,2022-05-05,Paraisópolis/MG,0,67,0,4048
703185,2022-05-06,Paraisópolis/MG,0,67,0,4048
708782,2022-05-07,Paraisópolis/MG,0,67,0,4048
714379,2022-05-08,Paraisópolis/MG,0,67,0,4048
719976,2022-05-09,Paraisópolis/MG,0,67,0,4048
725573,2022-05-10,Paraisópolis/MG,0,67,0,4048
731170,2022-05-11,Paraisópolis/MG,0,67,0,4048
736767,2022-05-12,Paraisópolis/MG,0,67,0,4048
742364,2022-05-13,Paraisópolis/MG,0,67,0,4048
747961,2022-05-14,Paraisópolis/MG,0,67,0,4048
753558,2022-05-15,Paraisópolis/MG,0,67,0,4048
759155,2022-05-16,Paraisópolis/MG,0,67,13,4061
764752,2022-05-17,Paraisópolis/MG,0,67,0,4061
770349,2022-05-18,Paraisópolis/MG,0,67,45,4106
775946,2022-05-19,Paraisópolis/MG,0,67,0,4106
781543,2022-05-20,Paraisópolis/MG,0,67,0,4106
787140,2022-05-21,Paraisópolis/MG,0,67,0,4106
792737,2022-05-22,Paraisópolis/MG,0,67,0,4106
798334,2022-05-23,Paraisópolis/MG,0,67,0,4106
803931,2022-05-24,Paraisópolis/MG,0,67,0,4106
809528,2022-05-25,Paraisópolis/MG,0,67,0,4106
815125,2022-05-26,Paraisópolis/MG,0,67,0,4106
820722,2022-05-27,Paraisópolis/MG,0,67,0,4106
826319,2022-05-28,Paraisópolis/MG,0,67,0,4106
831916,2022-05-29,Paraisópolis/MG,0,67,0,4106
837513,2022-05-30,Paraisópolis/MG,1,68,40,4146
843110,2022-05-31,Paraisópolis/MG,0,68,0,4146
848707,2022-06-01,Paraisópolis/MG,0,68,0,4146
854304,2022-06-02,Paraisópolis/MG,0,68,52,4198
859901,2022-06-03,Paraisópolis/MG,0,68,0,4198
865498,2022-06-04,Paraisópolis/MG,0,68,0,4198
871095,2022-06-05,Paraisópolis/MG,0,68,0,4198
876692,2022-06-06,Paraisópolis/MG,0,68,0,4198
882289,2022-06-07,Paraisópolis/MG,0,68,0,4198
887886,2022-06-08,Paraisópolis/MG,1,69,64,4262
893483,2022-06-09,Paraisópolis/MG,0,69,0,4262
899080,2022-06-10,Paraisópolis/MG,0,69,0,4262
904677,2022-06-11,Paraisópolis/MG,0,69,0,4262
910274,2022-06-12,Paraisópolis/MG,0,69,0,4262
915871,2022-06-13,Paraisópolis/MG,0,69,0,4262
921468,2022-06-14,Paraisópolis/MG,0,69,0,4262
927065,2022-06-15,Paraisópolis/MG,0,69,70,4332
932662,2022-06-16,Paraisópolis/MG,0,69,0,4332
938259,2022-06-17,Paraisópolis/MG,0,69,0,4332
943856,2022-06-18,Paraisópolis/MG,0,69,0,4332
949453,2022-06-19,Paraisópolis/MG,0,69,0,4332
955050,2022-06-20,Paraisópolis/MG,0,69,0,4332
960647,2022-06-21,Paraisópolis/MG,0,69,0,4332
966244,2022-06-22,Paraisópolis/MG,0,69,0,4332
971841,2022-06-23,Paraisópolis/MG,0,69,26,4358
977438,2022-06-24,Paraisópolis/MG,0,69,0,4358
983035,2022-06-25,Paraisópolis/MG,0,69,0,4358
988632,2022-06-26,Paraisópolis/MG,0,69,0,4358
994229,2022-06-27,Paraisópolis/MG,0,69,0,4358
999826,2022-06-28,Paraisópolis/MG,0,69,0,4358
1005423,2022-06-29,Paraisópolis/MG,0,69,0,4358
1011020,2022-06-30,Paraisópolis/MG,1,70,51,4409
1016617,2022-07-01,Paraisópolis/MG,0,70,0,4409
1022214,2022-07-02,Paraisópolis/MG,0,70,0,4409
1027811,2022-07-03,Paraisópolis/MG,0,70,0,4409
1033408,2022-07-04,Paraisópolis/MG,0,70,0,4409
1039005,2022-07-05,Paraisópolis/MG,0,70,0,4409
1044602,2022-07-06,Paraisópolis/MG,0,70,0,4409
1050199,2022-07-07,Paraisópolis/MG,0,70,0,4409
1055796,2022-07-08,Paraisópolis/MG,0,70,51,4460
1061393,2022-07-09,Paraisópolis/MG,0,70,0,4460
1066990,2022-07-10,Paraisópolis/MG,0,70,0,4460
1072587,2022-07-11,Paraisópolis/MG,0,70,0,4460
1078184,2022-07-12,Paraisópolis/MG,0,70,0,4460
1083781,2022-07-13,Paraisópolis/MG,0,70,49,4509
1089378,2022-07-14,Paraisópolis/MG,0,70,0,4509
1094975,2022-07-15,Paraisópolis/MG,1,71,0,4509
1100572,2022-07-16,Paraisópolis/MG,0,71,0,4509
1106169,2022-07-17,Paraisópolis/MG,0,71,0,4509
1111766,2022-07-18,Paraisópolis/MG,0,71,0,4509
1117363,2022-07-19,Paraisópolis/MG,0,71,0,4509
1122960,2022-07-20,Paraisópolis/MG,0,71,0,4509
1128557,2022-07-21,Paraisópolis/MG,0,71,54,4563
1134154,2022-07-22,Paraisópolis/MG,0,71,0,4563
1139751,2022-07-23,Paraisópolis/MG,0,71,0,4563
1145348,2022-07-24,Paraisópolis/MG,0,71,0,4563
1150945,2022-07-25,Paraisópolis/MG,0,71,0,4563
1156542,2022-07-26,Paraisópolis/MG,0,71,0,4563
1162139,2022-07-27,Paraisópolis/MG,0,71,0,4563
1167736,2022-07-28,Paraisópolis/MG,0,71,0,4563
1173333,2022-07-29,Paraisópolis/MG,0,71,0,4563
1178930,2022-07-30,Paraisópolis/MG,0,71,0,4563
1184527,2022-07-31,Paraisópolis/MG,0,71,0,4563
1190124,2022-08-01,Paraisópolis/MG,0,71,0,4563
1195721,2022-08-02,Paraisópolis/MG,0,71,14,4577
1201318,2022-08-03,Paraisópolis/MG,0,71,0,4577
1206915,2022-08-04,Paraisópolis/MG,0,71,0,4577
1212512,2022-08-05,Paraisópolis/MG,0,71,0,4577
1218109,2022-08-06,Paraisópolis/MG,0,71,0,4577
1223706,2022-08-07,Paraisópolis/MG,0,71,0,4577
1229303,2022-08-08,Paraisópolis/MG,0,71,0,4577
1234900,2022-08-09,Paraisópolis/MG,0,71,0,4577
1240497,2022-08-10,Paraisópolis/MG,0,71,8,4585
1246094,2022-08-11,Paraisópolis/MG,0,71,0,4585
1251691,2022-08-12,Paraisópolis/MG,0,71,0,4585
1257288,2022-08-13,Paraisópolis/MG,0,71,0,4585
1262885,2022-08-14,Paraisópolis/MG,0,71,0,4585
1268482,2022-08-15,Paraisópolis/MG,0,71,0,4585
1274079,2022-08-16,Paraisópolis/MG,0,71,0,4585
1279676,2022-08-17,Paraisópolis/MG,0,71,0,4585
1285273,2022-08-18,Paraisópolis/MG,0,71,0,4585
1290870,2022-08-19,Paraisópolis/MG,0,71,0,4585
1296467,2022-08-20,Paraisópolis/MG,0,71,0,4585
1302064,2022-08-21,Paraisópolis/MG,0,71,0,4585
1307661,2022-08-22,Paraisópolis/MG,0,71,2,4587
1313258,2022-08-23,Paraisópolis/MG,0,71,0,4587
1318855,2022-08-24,Paraisópolis/MG,0,71,0,4587
1324452,2022-08-25,Paraisópolis/MG,0,71,0,4587
3612,2022-01-01,Passa Quatro/MG,0,44,0,1967
9209,2022-01-02,Passa Quatro/MG,0,44,0,1967
14806,2022-01-03,Passa Quatro/MG,0,44,0,1967
20403,2022-01-04,Passa Quatro/MG,0,44,13,1980
26000,2022-01-05,Passa Quatro/MG,0,44,10,1990
31597,2022-01-06,Passa Quatro/MG,0,44,8,1998
37194,2022-01-07,Passa Quatro/MG,0,44,20,2018
42791,2022-01-08,Passa Quatro/MG,0,44,45,2063
48388,2022-01-09,Passa Quatro/MG,0,44,0,2063
53985,2022-01-10,Passa Quatro/MG,0,44,0,2063
59582,2022-01-11,Passa Quatro/MG,0,44,29,2092
65179,2022-01-12,Passa Quatro/MG,0,44,30,2122
70776,2022-01-13,Passa Quatro/MG,0,44,15,2137
76373,2022-01-14,Passa Quatro/MG,0,44,10,2147
81970,2022-01-15,Passa Quatro/MG,0,44,10,2157
87567,2022-01-16,Passa Quatro/MG,0,44,0,2157
93164,2022-01-17,Passa Quatro/MG,0,44,0,2157
98761,2022-01-18,Passa Quatro/MG,0,44,0,2157
104358,2022-01-19,Passa Quatro/MG,0,44,91,2248
109955,2022-01-20,Passa Quatro/MG,0,44,7,2255
115552,2022-01-21,Passa Quatro/MG,2,46,0,2255
121149,2022-01-22,Passa Quatro/MG,0,46,0,2255
126746,2022-01-23,Passa Quatro/MG,0,46,0,2255
132343,2022-01-24,Passa Quatro/MG,0,46,0,2255
137940,2022-01-25,Passa Quatro/MG,0,46,57,2312
143537,2022-01-26,Passa Quatro/MG,0,46,54,2366
149134,2022-01-27,Passa Quatro/MG,0,46,0,2366
154731,2022-01-28,Passa Quatro/MG,0,46,44,2410
160328,2022-01-29,Passa Quatro/MG,0,46,32,2442
165925,2022-01-30,Passa Quatro/MG,0,46,0,2442
171522,2022-01-31,Passa Quatro/MG,0,46,0,2442
177119,2022-02-01,Passa Quatro/MG,0,46,58,2500
182716,2022-02-02,Passa Quatro/MG,0,46,29,2529
188313,2022-02-03,Passa Quatro/MG,1,47,12,2541
193910,2022-02-04,Passa Quatro/MG,0,47,24,2565
199507,2022-02-05,Passa Quatro/MG,0,47,18,2583
205104,2022-02-06,Passa Quatro/MG,0,47,0,2583
210701,2022-02-07,Passa Quatro/MG,0,47,0,2583
216298,2022-02-08,Passa Quatro/MG,0,47,18,2601
221895,2022-02-09,Passa Quatro/MG,0,47,20,2621
227492,2022-02-10,Passa Quatro/MG,0,47,19,2640
233089,2022-02-11,Passa Quatro/MG,0,47,0,2640
238686,2022-02-12,Passa Quatro/MG,0,47,60,2700
244283,2022-02-13,Passa Quatro/MG,0,47,0,2700
249880,2022-02-14,Passa Quatro/MG,0,47,0,2700
255477,2022-02-15,Passa Quatro/MG,0,47,22,2722
261074,2022-02-16,Passa Quatro/MG,0,47,11,2733
266671,2022-02-17,Passa Quatro/MG,0,47,4,2737
272268,2022-02-18,Passa Quatro/MG,1,48,7,2744
277865,2022-02-19,Passa Quatro/MG,0,48,8,2752
283462,2022-02-20,Passa Quatro/MG,0,48,0,2752
289059,2022-02-21,Passa Quatro/MG,0,48,0,2752
294656,2022-02-22,Passa Quatro/MG,0,48,9,2761
300253,2022-02-23,Passa Quatro/MG,0,48,14,2775
305850,2022-02-24,Passa Quatro/MG,0,48,5,2780
311447,2022-02-25,Passa Quatro/MG,0,48,1,2781
317044,2022-02-26,Passa Quatro/MG,0,48,5,2786
322641,2022-02-27,Passa Quatro/MG,0,48,0,2786
328238,2022-02-28,Passa Quatro/MG,0,48,0,2786
333835,2022-03-01,Passa Quatro/MG,0,48,0,2786
339432,2022-03-02,Passa Quatro/MG,0,48,0,2786
345029,2022-03-03,Passa Quatro/MG,0,48,0,2786
350626,2022-03-04,Passa Quatro/MG,0,48,0,2786
356223,2022-03-05,Passa Quatro/MG,0,48,22,2808
361820,2022-03-06,Passa Quatro/MG,0,48,0,2808
367417,2022-03-07,Passa Quatro/MG,0,48,0,2808
373014,2022-03-08,Passa Quatro/MG,0,48,4,2812
378611,2022-03-09,Passa Quatro/MG,0,48,2,2814
384208,2022-03-10,Passa Quatro/MG,0,48,3,2817
389805,2022-03-11,Passa Quatro/MG,0,48,1,2818
395402,2022-03-12,Passa Quatro/MG,0,48,0,2818
400999,2022-03-13,Passa Quatro/MG,0,48,0,2818
406596,2022-03-14,Passa Quatro/MG,0,48,0,2818
412193,2022-03-15,Passa Quatro/MG,0,48,0,2818
417790,2022-03-16,Passa Quatro/MG,0,48,7,2825
423387,2022-03-17,Passa Quatro/MG,0,48,1,2826
428984,2022-03-18,Passa Quatro/MG,0,48,2,2828
434581,2022-03-19,Passa Quatro/MG,1,49,1,2829
440178,2022-03-20,Passa Quatro/MG,0,49,0,2829
445775,2022-03-21,Passa Quatro/MG,0,49,0,2829
451372,2022-03-22,Passa Quatro/MG,0,49,1,2830
456969,2022-03-23,Passa Quatro/MG,0,49,0,2830
462566,2022-03-24,Passa Quatro/MG,0,49,0,2830
468163,2022-03-25,Passa Quatro/MG,0,49,3,2833
473760,2022-03-26,Passa Quatro/MG,0,49,0,2833
479357,2022-03-27,Passa Quatro/MG,0,49,1,2834
484954,2022-03-28,Passa Quatro/MG,0,49,0,2834
490551,2022-03-29,Passa Quatro/MG,0,49,0,2834
496148,2022-03-30,Passa Quatro/MG,0,49,0,2834
501745,2022-03-31,Passa Quatro/MG,0,49,0,2834
507342,2022-04-01,Passa Quatro/MG,0,49,0,2834
512939,2022-04-02,Passa Quatro/MG,0,49,0,2834
518536,2022-04-03,Passa Quatro/MG,0,49,0,2834
524133,2022-04-04,Passa Quatro/MG,0,49,0,2834
529730,2022-04-05,Passa Quatro/MG,0,49,0,2834
535327,2022-04-06,Passa Quatro/MG,0,49,0,2834
540924,2022-04-07,Passa Quatro/MG,0,49,0,2834
546521,2022-04-08,Passa Quatro/MG,0,49,0,2834
552118,2022-04-09,Passa Quatro/MG,0,49,1,2835
557715,2022-04-10,Passa Quatro/MG,0,49,0,2835
563312,2022-04-11,Passa Quatro/MG,0,49,0,2835
568909,2022-04-12,Passa Quatro/MG,0,49,0,2835
574506,2022-04-13,Passa Quatro/MG,0,49,0,2835
580103,2022-04-14,Passa Quatro/MG,0,49,0,2835
585700,2022-04-15,Passa Quatro/MG,0,49,0,2835
591297,2022-04-16,Passa Quatro/MG,0,49,0,2835
596894,2022-04-17,Passa Quatro/MG,0,49,0,2835
602491,2022-04-18,Passa Quatro/MG,0,49,0,2835
608088,2022-04-19,Passa Quatro/MG,0,49,0,2835
613685,2022-04-20,Passa Quatro/MG,0,49,0,2835
619282,2022-04-21,Passa Quatro/MG,0,49,0,2835
624879,2022-04-22,Passa Quatro/MG,0,49,0,2835
630476,2022-04-23,Passa Quatro/MG,0,49,0,2835
636073,2022-04-24,Passa Quatro/MG,0,49,0,2835
641670,2022-04-25,Passa Quatro/MG,0,49,0,2835
647267,2022-04-26,Passa Quatro/MG,0,49,0,2835
652864,2022-04-27,Passa Quatro/MG,0,49,0,2835
658461,2022-04-28,Passa Quatro/MG,0,49,0,2835
664058,2022-04-29,Passa Quatro/MG,0,49,0,2835
669655,2022-04-30,Passa Quatro/MG,0,49,2,2837
675252,2022-05-01,Passa Quatro/MG,0,49,0,2837
680849,2022-05-02,Passa Quatro/MG,0,49,0,2837
686446,2022-05-03,Passa Quatro/MG,0,49,0,2837
692043,2022-05-04,Passa Quatro/MG,0,49,0,2837
697640,2022-05-05,Passa Quatro/MG,0,49,0,2837
703237,2022-05-06,Passa Quatro/MG,0,49,0,2837
708834,2022-05-07,Passa Quatro/MG,0,49,0,2837
714431,2022-05-08,Passa Quatro/MG,0,49,0,2837
720028,2022-05-09,Passa Quatro/MG,0,49,0,2837
725625,2022-05-10,Passa Quatro/MG,0,49,3,2840
731222,2022-05-11,Passa Quatro/MG,0,49,7,2847
736819,2022-05-12,Passa Quatro/MG,0,49,0,2847
742416,2022-05-13,Passa Quatro/MG,0,49,0,2847
748013,2022-05-14,Passa Quatro/MG,0,49,0,2847
753610,2022-05-15,Passa Quatro/MG,0,49,0,2847
759207,2022-05-16,Passa Quatro/MG,0,49,1,2848
764804,2022-05-17,Passa Quatro/MG,0,49,0,2848
770401,2022-05-18,Passa Quatro/MG,0,49,0,2848
775998,2022-05-19,Passa Quatro/MG,0,49,2,2850
781595,2022-05-20,Passa Quatro/MG,0,49,1,2851
787192,2022-05-21,Passa Quatro/MG,0,49,0,2851
792789,2022-05-22,Passa Quatro/MG,0,49,0,2851
798386,2022-05-23,Passa Quatro/MG,0,49,0,2851
803983,2022-05-24,Passa Quatro/MG,0,49,1,2852
809580,2022-05-25,Passa Quatro/MG,0,49,2,2854
815177,2022-05-26,Passa Quatro/MG,0,49,2,2856
820774,2022-05-27,Passa Quatro/MG,0,49,0,2856
826371,2022-05-28,Passa Quatro/MG,0,49,0,2856
831968,2022-05-29,Passa Quatro/MG,0,49,0,2856
837565,2022-05-30,Passa Quatro/MG,0,49,3,2859
843162,2022-05-31,Passa Quatro/MG,0,49,4,2863
848759,2022-06-01,Passa Quatro/MG,0,49,0,2863
854356,2022-06-02,Passa Quatro/MG,0,49,2,2865
859953,2022-06-03,Passa Quatro/MG,0,49,4,2869
865550,2022-06-04,Passa Quatro/MG,0,49,0,2869
871147,2022-06-05,Passa Quatro/MG,0,49,0,2869
876744,2022-06-06,Passa Quatro/MG,0,49,2,2871
882341,2022-06-07,Passa Quatro/MG,0,49,10,2881
887938,2022-06-08,Passa Quatro/MG,0,49,8,2889
893535,2022-06-09,Passa Quatro/MG,0,49,3,2892
899132,2022-06-10,Passa Quatro/MG,0,49,8,2900
904729,2022-06-11,Passa Quatro/MG,0,49,0,2900
910326,2022-06-12,Passa Quatro/MG,0,49,0,2900
915923,2022-06-13,Passa Quatro/MG,0,49,6,2906
921520,2022-06-14,Passa Quatro/MG,0,49,9,2915
927117,2022-06-15,Passa Quatro/MG,0,49,8,2923
932714,2022-06-16,Passa Quatro/MG,0,49,0,2923
938311,2022-06-17,Passa Quatro/MG,0,49,0,2923
943908,2022-06-18,Passa Quatro/MG,0,49,0,2923
949505,2022-06-19,Passa Quatro/MG,0,49,0,2923
955102,2022-06-20,Passa Quatro/MG,0,49,5,2928
960699,2022-06-21,Passa Quatro/MG,0,49,28,2956
966296,2022-06-22,Passa Quatro/MG,0,49,9,2965
971893,2022-06-23,Passa Quatro/MG,0,49,6,2971
977490,2022-06-24,Passa Quatro/MG,1,50,17,2988
983087,2022-06-25,Passa Quatro/MG,0,50,0,2988
988684,2022-06-26,Passa Quatro/MG,0,50,0,2988
994281,2022-06-27,Passa Quatro/MG,0,50,17,3005
999878,2022-06-28,Passa Quatro/MG,0,50,15,3020
1005475,2022-06-29,Passa Quatro/MG,0,50,24,3044
1011072,2022-06-30,Passa Quatro/MG,0,50,23,3067
1016669,2022-07-01,Passa Quatro/MG,0,50,23,3090
1022266,2022-07-02,Passa Quatro/MG,0,50,0,3090
1027863,2022-07-03,Passa Quatro/MG,0,50,0,3090
1033460,2022-07-04,Passa Quatro/MG,0,50,22,3112
1039057,2022-07-05,Passa Quatro/MG,0,50,18,3130
1044654,2022-07-06,Passa Quatro/MG,1,51,0,3130
1050251,2022-07-07,Passa Quatro/MG,0,51,29,3159
1055848,2022-07-08,Passa Quatro/MG,0,51,8,3167
1061445,2022-07-09,Passa Quatro/MG,0,51,0,3167
1067042,2022-07-10,Passa Quatro/MG,0,51,0,3167
1072639,2022-07-11,Passa Quatro/MG,0,51,14,3181
1078236,2022-07-12,Passa Quatro/MG,1,52,17,3198
1083833,2022-07-13,Passa Quatro/MG,0,52,0,3198
1089430,2022-07-14,Passa Quatro/MG,0,52,19,3217
1095027,2022-07-15,Passa Quatro/MG,0,52,7,3224
1100624,2022-07-16,Passa Quatro/MG,0,52,0,3224
1106221,2022-07-17,Passa Quatro/MG,0,52,0,3224
1111818,2022-07-18,Passa Quatro/MG,0,52,8,3232
1117415,2022-07-19,Passa Quatro/MG,0,52,11,3243
1123012,2022-07-20,Passa Quatro/MG,0,52,11,3254
1128609,2022-07-21,Passa Quatro/MG,0,52,8,3262
1134206,2022-07-22,Passa Quatro/MG,0,52,9,3271
1139803,2022-07-23,Passa Quatro/MG,0,52,0,3271
1145400,2022-07-24,Passa Quatro/MG,0,52,0,3271
1150997,2022-07-25,Passa Quatro/MG,0,52,5,3276
1156594,2022-07-26,Passa Quatro/MG,0,52,14,3290
1162191,2022-07-27,Passa Quatro/MG,0,52,4,3294
1167788,2022-07-28,Passa Quatro/MG,0,52,2,3296
1173385,2022-07-29,Passa Quatro/MG,0,52,2,3298
1178982,2022-07-30,Passa Quatro/MG,0,52,0,3298
1184579,2022-07-31,Passa Quatro/MG,0,52,0,3298
1190176,2022-08-01,Passa Quatro/MG,0,52,11,3309
1195773,2022-08-02,Passa Quatro/MG,0,52,5,3314
1201370,2022-08-03,Passa Quatro/MG,0,52,6,3320
1206967,2022-08-04,Passa Quatro/MG,0,52,5,3325
1212564,2022-08-05,Passa Quatro/MG,0,52,1,3326
1218161,2022-08-06,Passa Quatro/MG,0,52,0,3326
1223758,2022-08-07,Passa Quatro/MG,0,52,0,3326
1229355,2022-08-08,Passa Quatro/MG,1,53,3,3329
1234952,2022-08-09,Passa Quatro/MG,0,53,2,3331
1240549,2022-08-10,Passa Quatro/MG,0,53,0,3331
1246146,2022-08-11,Passa Quatro/MG,0,53,3,3334
1251743,2022-08-12,Passa Quatro/MG,0,53,1,3335
1257340,2022-08-13,Passa Quatro/MG,0,53,0,3335
1262937,2022-08-14,Passa Quatro/MG,0,53,0,3335
1268534,2022-08-15,Passa Quatro/MG,0,53,0,3335
1274131,2022-08-16,Passa Quatro/MG,0,53,4,3339
1279728,2022-08-17,Passa Quatro/MG,0,53,4,3343
1285325,2022-08-18,Passa Quatro/MG,0,53,0,3343
1290922,2022-08-19,Passa Quatro/MG,0,53,1,3344
1296519,2022-08-20,Passa Quatro/MG,0,53,0,3344
1302116,2022-08-21,Passa Quatro/MG,0,53,0,3344
1307713,2022-08-22,Passa Quatro/MG,0,53,1,3345
1313310,2022-08-23,Passa Quatro/MG,0,53,0,3345
1318907,2022-08-24,Passa Quatro/MG,0,53,2,3347
1324504,2022-08-25,Passa Quatro/MG,0,53,0,3347
3628,2022-01-01,Passos/MG,0,321,0,11554
9225,2022-01-02,Passos/MG,0,321,0,11554
14822,2022-01-03,Passos/MG,0,321,0,11554
20419,2022-01-04,Passos/MG,1,322,83,11637
26016,2022-01-05,Passos/MG,0,322,0,11637
31613,2022-01-06,Passos/MG,0,322,0,11637
37210,2022-01-07,Passos/MG,0,322,602,12239
42807,2022-01-08,Passos/MG,0,322,337,12576
48404,2022-01-09,Passos/MG,0,322,0,12576
54001,2022-01-10,Passos/MG,0,322,0,12576
59598,2022-01-11,Passos/MG,0,322,400,12976
65195,2022-01-12,Passos/MG,0,322,361,13337
70792,2022-01-13,Passos/MG,0,322,473,13810
76389,2022-01-14,Passos/MG,1,323,427,14237
81986,2022-01-15,Passos/MG,1,324,424,14661
87583,2022-01-16,Passos/MG,0,324,0,14661
93180,2022-01-17,Passos/MG,0,324,0,14661
98777,2022-01-18,Passos/MG,0,324,418,15079
104374,2022-01-19,Passos/MG,0,324,855,15934
109971,2022-01-20,Passos/MG,0,324,557,16491
115568,2022-01-21,Passos/MG,1,325,651,17142
121165,2022-01-22,Passos/MG,0,325,471,17613
126762,2022-01-23,Passos/MG,1,326,0,17613
132359,2022-01-24,Passos/MG,0,326,0,17613
137956,2022-01-25,Passos/MG,0,326,700,18313
143553,2022-01-26,Passos/MG,0,326,380,18693
149150,2022-01-27,Passos/MG,4,330,1020,19713
154747,2022-01-28,Passos/MG,0,330,412,20125
160344,2022-01-29,Passos/MG,3,333,267,20392
165941,2022-01-30,Passos/MG,4,337,0,20392
171538,2022-01-31,Passos/MG,0,337,0,20392
177135,2022-02-01,Passos/MG,0,337,213,20605
182732,2022-02-02,Passos/MG,0,337,220,20825
188329,2022-02-03,Passos/MG,6,343,63,20888
193926,2022-02-04,Passos/MG,2,345,141,21029
199523,2022-02-05,Passos/MG,1,346,90,21119
205120,2022-02-06,Passos/MG,2,348,0,21119
210717,2022-02-07,Passos/MG,0,348,0,21119
216314,2022-02-08,Passos/MG,0,348,135,21254
221911,2022-02-09,Passos/MG,3,351,113,21367
227508,2022-02-10,Passos/MG,2,353,104,21471
233105,2022-02-11,Passos/MG,1,354,182,21653
238702,2022-02-12,Passos/MG,1,355,139,21792
244299,2022-02-13,Passos/MG,-1,354,0,21792
249896,2022-02-14,Passos/MG,3,357,0,21792
255493,2022-02-15,Passos/MG,0,357,55,21847
261090,2022-02-16,Passos/MG,4,361,40,21887
266687,2022-02-17,Passos/MG,3,364,64,21951
272284,2022-02-18,Passos/MG,1,365,117,22068
277881,2022-02-19,Passos/MG,1,366,60,22128
283478,2022-02-20,Passos/MG,0,366,0,22128
289075,2022-02-21,Passos/MG,0,366,0,22128
294672,2022-02-22,Passos/MG,0,366,122,22250
300269,2022-02-23,Passos/MG,1,367,88,22338
305866,2022-02-24,Passos/MG,1,368,87,22425
311463,2022-02-25,Passos/MG,2,370,84,22509
317060,2022-02-26,Passos/MG,0,370,59,22568
322657,2022-02-27,Passos/MG,0,370,0,22568
328254,2022-02-28,Passos/MG,0,370,0,22568
333851,2022-03-01,Passos/MG,0,370,0,22568
339448,2022-03-02,Passos/MG,0,370,0,22568
345045,2022-03-03,Passos/MG,0,370,0,22568
350642,2022-03-04,Passos/MG,0,370,97,22665
356239,2022-03-05,Passos/MG,0,370,51,22716
361836,2022-03-06,Passos/MG,2,372,0,22716
367433,2022-03-07,Passos/MG,0,372,0,22716
373030,2022-03-08,Passos/MG,0,372,63,22779
378627,2022-03-09,Passos/MG,1,373,70,22849
384224,2022-03-10,Passos/MG,2,375,34,22883
389821,2022-03-11,Passos/MG,1,376,39,22922
395418,2022-03-12,Passos/MG,0,376,10,22932
401015,2022-03-13,Passos/MG,0,376,0,22932
406612,2022-03-14,Passos/MG,0,376,0,22932
412209,2022-03-15,Passos/MG,0,376,19,22951
417806,2022-03-16,Passos/MG,0,376,0,22951
423403,2022-03-17,Passos/MG,0,376,38,22989
429000,2022-03-18,Passos/MG,0,376,23,23012
434597,2022-03-19,Passos/MG,0,376,13,23025
440194,2022-03-20,Passos/MG,0,376,0,23025
445791,2022-03-21,Passos/MG,0,376,0,23025
451388,2022-03-22,Passos/MG,0,376,55,23080
456985,2022-03-23,Passos/MG,0,376,2,23082
462582,2022-03-24,Passos/MG,0,376,7,23089
468179,2022-03-25,Passos/MG,0,376,5,23094
473776,2022-03-26,Passos/MG,1,377,1,23095
479373,2022-03-27,Passos/MG,0,377,0,23095
484970,2022-03-28,Passos/MG,0,377,0,23095
490567,2022-03-29,Passos/MG,0,377,10,23105
496164,2022-03-30,Passos/MG,0,377,2,23107
501761,2022-03-31,Passos/MG,0,377,0,23107
507358,2022-04-01,Passos/MG,0,377,0,23107
512955,2022-04-02,Passos/MG,0,377,0,23107
518552,2022-04-03,Passos/MG,0,377,0,23107
524149,2022-04-04,Passos/MG,0,377,15,23122
529746,2022-04-05,Passos/MG,0,377,15,23137
535343,2022-04-06,Passos/MG,0,377,0,23137
540940,2022-04-07,Passos/MG,0,377,1,23138
546537,2022-04-08,Passos/MG,0,377,5,23143
552134,2022-04-09,Passos/MG,0,377,0,23143
557731,2022-04-10,Passos/MG,0,377,0,23143
563328,2022-04-11,Passos/MG,0,377,0,23143
568925,2022-04-12,Passos/MG,0,377,1,23144
574522,2022-04-13,Passos/MG,0,377,1,23145
580119,2022-04-14,Passos/MG,0,377,1,23146
585716,2022-04-15,Passos/MG,0,377,0,23146
591313,2022-04-16,Passos/MG,0,377,0,23146
596910,2022-04-17,Passos/MG,0,377,0,23146
602507,2022-04-18,Passos/MG,0,377,0,23146
608104,2022-04-19,Passos/MG,0,377,1,23147
613701,2022-04-20,Passos/MG,0,377,3,23150
619298,2022-04-21,Passos/MG,0,377,5,23155
624895,2022-04-22,Passos/MG,0,377,0,23155
630492,2022-04-23,Passos/MG,0,377,0,23155
636089,2022-04-24,Passos/MG,0,377,0,23155
641686,2022-04-25,Passos/MG,0,377,0,23155
647283,2022-04-26,Passos/MG,0,377,4,23159
652880,2022-04-27,Passos/MG,0,377,11,23170
658477,2022-04-28,Passos/MG,0,377,1,23171
664074,2022-04-29,Passos/MG,0,377,7,23178
669671,2022-04-30,Passos/MG,0,377,8,23186
675268,2022-05-01,Passos/MG,0,377,0,23186
680865,2022-05-02,Passos/MG,0,377,0,23186
686462,2022-05-03,Passos/MG,0,377,14,23200
692059,2022-05-04,Passos/MG,0,377,3,23203
697656,2022-05-05,Passos/MG,0,377,5,23208
703253,2022-05-06,Passos/MG,0,377,0,23208
708850,2022-05-07,Passos/MG,0,377,0,23208
714447,2022-05-08,Passos/MG,0,377,0,23208
720044,2022-05-09,Passos/MG,0,377,17,23225
725641,2022-05-10,Passos/MG,0,377,16,23241
731238,2022-05-11,Passos/MG,0,377,0,23241
736835,2022-05-12,Passos/MG,0,377,50,23291
742432,2022-05-13,Passos/MG,0,377,41,23332
748029,2022-05-14,Passos/MG,0,377,0,23332
753626,2022-05-15,Passos/MG,0,377,0,23332
759223,2022-05-16,Passos/MG,1,378,32,23364
764820,2022-05-17,Passos/MG,0,378,51,23415
770417,2022-05-18,Passos/MG,0,378,31,23446
776014,2022-05-19,Passos/MG,0,378,71,23517
781611,2022-05-20,Passos/MG,0,378,37,23554
787208,2022-05-21,Passos/MG,0,378,0,23554
792805,2022-05-22,Passos/MG,0,378,0,23554
798402,2022-05-23,Passos/MG,0,378,49,23603
803999,2022-05-24,Passos/MG,0,378,70,23673
809596,2022-05-25,Passos/MG,0,378,63,23736
815193,2022-05-26,Passos/MG,0,378,64,23800
820790,2022-05-27,Passos/MG,0,378,56,23856
826387,2022-05-28,Passos/MG,0,378,0,23856
831984,2022-05-29,Passos/MG,0,378,0,23856
837581,2022-05-30,Passos/MG,0,378,98,23954
843178,2022-05-31,Passos/MG,0,378,98,24052
848775,2022-06-01,Passos/MG,0,378,128,24180
854372,2022-06-02,Passos/MG,0,378,120,24300
859969,2022-06-03,Passos/MG,0,378,151,24451
865566,2022-06-04,Passos/MG,0,378,0,24451
871163,2022-06-05,Passos/MG,0,378,0,24451
876760,2022-06-06,Passos/MG,0,378,124,24575
882357,2022-06-07,Passos/MG,0,378,115,24690
887954,2022-06-08,Passos/MG,3,381,87,24777
893551,2022-06-09,Passos/MG,0,381,94,24871
899148,2022-06-10,Passos/MG,0,381,86,24957
904745,2022-06-11,Passos/MG,0,381,0,24957
910342,2022-06-12,Passos/MG,0,381,0,24957
915939,2022-06-13,Passos/MG,0,381,106,25063
921536,2022-06-14,Passos/MG,0,381,74,25137
927133,2022-06-15,Passos/MG,1,382,79,25216
932730,2022-06-16,Passos/MG,0,382,0,25216
938327,2022-06-17,Passos/MG,0,382,0,25216
943924,2022-06-18,Passos/MG,0,382,0,25216
949521,2022-06-19,Passos/MG,0,382,0,25216
955118,2022-06-20,Passos/MG,0,382,0,25216
960715,2022-06-21,Passos/MG,0,382,157,25373
966312,2022-06-22,Passos/MG,0,382,78,25451
971909,2022-06-23,Passos/MG,0,382,76,25527
977506,2022-06-24,Passos/MG,3,385,71,25598
983103,2022-06-25,Passos/MG,0,385,0,25598
988700,2022-06-26,Passos/MG,0,385,0,25598
994297,2022-06-27,Passos/MG,0,385,73,25671
999894,2022-06-28,Passos/MG,0,385,65,25736
1005491,2022-06-29,Passos/MG,0,385,0,25736
1011088,2022-06-30,Passos/MG,0,385,140,25876
1016685,2022-07-01,Passos/MG,0,385,87,25963
1022282,2022-07-02,Passos/MG,0,385,0,25963
1027879,2022-07-03,Passos/MG,0,385,0,25963
1033476,2022-07-04,Passos/MG,0,385,58,26021
1039073,2022-07-05,Passos/MG,1,386,57,26078
1044670,2022-07-06,Passos/MG,0,386,73,26151
1050267,2022-07-07,Passos/MG,0,386,57,26208
1055864,2022-07-08,Passos/MG,0,386,56,26264
1061461,2022-07-09,Passos/MG,0,386,0,26264
1067058,2022-07-10,Passos/MG,0,386,0,26264
1072655,2022-07-11,Passos/MG,0,386,40,26304
1078252,2022-07-12,Passos/MG,1,387,63,26367
1083849,2022-07-13,Passos/MG,0,387,52,26419
1089446,2022-07-14,Passos/MG,-1,386,64,26483
1095043,2022-07-15,Passos/MG,0,386,53,26536
1100640,2022-07-16,Passos/MG,0,386,0,26536
1106237,2022-07-17,Passos/MG,0,386,0,26536
1111834,2022-07-18,Passos/MG,0,386,55,26591
1117431,2022-07-19,Passos/MG,0,386,56,26647
1123028,2022-07-20,Passos/MG,0,386,0,26647
1128625,2022-07-21,Passos/MG,0,386,92,26739
1134222,2022-07-22,Passos/MG,2,388,38,26777
1139819,2022-07-23,Passos/MG,0,388,0,26777
1145416,2022-07-24,Passos/MG,0,388,0,26777
1151013,2022-07-25,Passos/MG,0,388,45,26822
1156610,2022-07-26,Passos/MG,0,388,51,26873
1162207,2022-07-27,Passos/MG,0,388,49,26922
1167804,2022-07-28,Passos/MG,0,388,40,26962
1173401,2022-07-29,Passos/MG,0,388,37,26999
1178998,2022-07-30,Passos/MG,0,388,0,26999
1184595,2022-07-31,Passos/MG,0,388,0,26999
1190192,2022-08-01,Passos/MG,0,388,0,26999
1195789,2022-08-02,Passos/MG,0,388,38,27037
1201386,2022-08-03,Passos/MG,2,390,54,27091
1206983,2022-08-04,Passos/MG,0,390,25,27116
1212580,2022-08-05,Passos/MG,0,390,25,27141
1218177,2022-08-06,Passos/MG,0,390,0,27141
1223774,2022-08-07,Passos/MG,0,390,0,27141
1229371,2022-08-08,Passos/MG,0,390,34,27175
1234968,2022-08-09,Passos/MG,0,390,10,27185
1240565,2022-08-10,Passos/MG,0,390,41,27226
1246162,2022-08-11,Passos/MG,1,391,0,27226
1251759,2022-08-12,Passos/MG,0,391,17,27243
1257356,2022-08-13,Passos/MG,0,391,0,27243
1262953,2022-08-14,Passos/MG,0,391,0,27243
1268550,2022-08-15,Passos/MG,0,391,0,27243
1274147,2022-08-16,Passos/MG,0,391,22,27265
1279744,2022-08-17,Passos/MG,0,391,12,27277
1285341,2022-08-18,Passos/MG,1,392,5,27282
1290938,2022-08-19,Passos/MG,1,393,25,27307
1296535,2022-08-20,Passos/MG,0,393,0,27307
1302132,2022-08-21,Passos/MG,0,393,0,27307
1307729,2022-08-22,Passos/MG,0,393,19,27326
1313326,2022-08-23,Passos/MG,0,393,10,27336
1318923,2022-08-24,Passos/MG,0,393,28,27364
1324520,2022-08-25,Passos/MG,0,393,11,27375
3968,2022-01-01,Poço Fundo/MG,0,12,0,1714
9565,2022-01-02,Poço Fundo/MG,0,12,0,1714
15162,2022-01-03,Poço Fundo/MG,0,12,0,1714
20759,2022-01-04,Poço Fundo/MG,0,12,0,1714
26356,2022-01-05,Poço Fundo/MG,0,12,12,1726
31953,2022-01-06,Poço Fundo/MG,0,12,31,1757
37550,2022-01-07,Poço Fundo/MG,0,12,0,1757
43147,2022-01-08,Poço Fundo/MG,0,12,0,1757
48744,2022-01-09,Poço Fundo/MG,0,12,0,1757
54341,2022-01-10,Poço Fundo/MG,0,12,0,1757
59938,2022-01-11,Poço Fundo/MG,0,12,0,1757
65535,2022-01-12,Poço Fundo/MG,0,12,58,1815
71132,2022-01-13,Poço Fundo/MG,0,12,26,1841
76729,2022-01-14,Poço Fundo/MG,0,12,33,1874
82326,2022-01-15,Poço Fundo/MG,0,12,21,1895
87923,2022-01-16,Poço Fundo/MG,0,12,0,1895
93520,2022-01-17,Poço Fundo/MG,0,12,0,1895
99117,2022-01-18,Poço Fundo/MG,0,12,26,1921
104714,2022-01-19,Poço Fundo/MG,0,12,0,1921
110311,2022-01-20,Poço Fundo/MG,0,12,108,2029
115908,2022-01-21,Poço Fundo/MG,0,12,0,2029
121505,2022-01-22,Poço Fundo/MG,0,12,47,2076
127102,2022-01-23,Poço Fundo/MG,0,12,0,2076
132699,2022-01-24,Poço Fundo/MG,0,12,0,2076
138296,2022-01-25,Poço Fundo/MG,0,12,43,2119
143893,2022-01-26,Poço Fundo/MG,0,12,239,2358
149490,2022-01-27,Poço Fundo/MG,0,12,68,2426
155087,2022-01-28,Poço Fundo/MG,0,12,0,2426
160684,2022-01-29,Poço Fundo/MG,0,12,140,2566
166281,2022-01-30,Poço Fundo/MG,0,12,67,2633
171878,2022-01-31,Poço Fundo/MG,0,12,0,2633
177475,2022-02-01,Poço Fundo/MG,0,12,0,2633
183072,2022-02-02,Poço Fundo/MG,1,13,156,2789
188669,2022-02-03,Poço Fundo/MG,0,13,61,2850
194266,2022-02-04,Poço Fundo/MG,0,13,64,2914
199863,2022-02-05,Poço Fundo/MG,0,13,39,2953
205460,2022-02-06,Poço Fundo/MG,0,13,0,2953
211057,2022-02-07,Poço Fundo/MG,0,13,0,2953
216654,2022-02-08,Poço Fundo/MG,0,13,50,3003
222251,2022-02-09,Poço Fundo/MG,0,13,101,3104
227848,2022-02-10,Poço Fundo/MG,0,13,27,3131
233445,2022-02-11,Poço Fundo/MG,0,13,30,3161
239042,2022-02-12,Poço Fundo/MG,0,13,34,3195
244639,2022-02-13,Poço Fundo/MG,1,14,0,3195
250236,2022-02-14,Poço Fundo/MG,0,14,0,3195
255833,2022-02-15,Poço Fundo/MG,0,14,48,3243
261430,2022-02-16,Poço Fundo/MG,0,14,114,3357
267027,2022-02-17,Poço Fundo/MG,0,14,0,3357
272624,2022-02-18,Poço Fundo/MG,0,14,66,3423
278221,2022-02-19,Poço Fundo/MG,0,14,48,3471
283818,2022-02-20,Poço Fundo/MG,0,14,0,3471
289415,2022-02-21,Poço Fundo/MG,0,14,0,3471
295012,2022-02-22,Poço Fundo/MG,0,14,27,3498
300609,2022-02-23,Poço Fundo/MG,0,14,51,3549
306206,2022-02-24,Poço Fundo/MG,0,14,15,3564
311803,2022-02-25,Poço Fundo/MG,0,14,0,3564
317400,2022-02-26,Poço Fundo/MG,0,14,30,3594
322997,2022-02-27,Poço Fundo/MG,0,14,0,3594
328594,2022-02-28,Poço Fundo/MG,0,14,0,3594
334191,2022-03-01,Poço Fundo/MG,0,14,0,3594
339788,2022-03-02,Poço Fundo/MG,0,14,0,3594
345385,2022-03-03,Poço Fundo/MG,0,14,18,3612
350982,2022-03-04,Poço Fundo/MG,0,14,22,3634
356579,2022-03-05,Poço Fundo/MG,0,14,11,3645
362176,2022-03-06,Poço Fundo/MG,0,14,0,3645
367773,2022-03-07,Poço Fundo/MG,0,14,0,3645
373370,2022-03-08,Poço Fundo/MG,0,14,9,3654
378967,2022-03-09,Poço Fundo/MG,0,14,10,3664
384564,2022-03-10,Poço Fundo/MG,0,14,7,3671
390161,2022-03-11,Poço Fundo/MG,0,14,0,3671
395758,2022-03-12,Poço Fundo/MG,0,14,3,3674
401355,2022-03-13,Poço Fundo/MG,0,14,0,3674
406952,2022-03-14,Poço Fundo/MG,0,14,0,3674
412549,2022-03-15,Poço Fundo/MG,0,14,3,3677
418146,2022-03-16,Poço Fundo/MG,0,14,0,3677
423743,2022-03-17,Poço Fundo/MG,0,14,6,3683
429340,2022-03-18,Poço Fundo/MG,0,14,0,3683
434937,2022-03-19,Poço Fundo/MG,0,14,6,3689
440534,2022-03-20,Poço Fundo/MG,0,14,0,3689
446131,2022-03-21,Poço Fundo/MG,0,14,0,3689
451728,2022-03-22,Poço Fundo/MG,0,14,0,3689
457325,2022-03-23,Poço Fundo/MG,0,14,4,3693
462922,2022-03-24,Poço Fundo/MG,0,14,0,3693
468519,2022-03-25,Poço Fundo/MG,0,14,0,3693
474116,2022-03-26,Poço Fundo/MG,-1,13,0,3693
479713,2022-03-27,Poço Fundo/MG,0,13,0,3693
485310,2022-03-28,Poço Fundo/MG,0,13,0,3693
490907,2022-03-29,Poço Fundo/MG,0,13,0,3693
496504,2022-03-30,Poço Fundo/MG,0,13,0,3693
502101,2022-03-31,Poço Fundo/MG,0,13,0,3693
507698,2022-04-01,Poço Fundo/MG,0,13,0,3693
513295,2022-04-02,Poço Fundo/MG,0,13,0,3693
518892,2022-04-03,Poço Fundo/MG,0,13,0,3693
524489,2022-04-04,Poço Fundo/MG,0,13,63,3756
530086,2022-04-05,Poço Fundo/MG,0,13,0,3756
535683,2022-04-06,Poço Fundo/MG,0,13,3,3759
541280,2022-04-07,Poço Fundo/MG,0,13,0,3759
546877,2022-04-08,Poço Fundo/MG,0,13,0,3759
552474,2022-04-09,Poço Fundo/MG,0,13,6,3765
558071,2022-04-10,Poço Fundo/MG,0,13,0,3765
563668,2022-04-11,Poço Fundo/MG,0,13,0,3765
569265,2022-04-12,Poço Fundo/MG,0,13,0,3765
574862,2022-04-13,Poço Fundo/MG,0,13,2,3767
580459,2022-04-14,Poço Fundo/MG,0,13,0,3767
586056,2022-04-15,Poço Fundo/MG,0,13,1,3768
591653,2022-04-16,Poço Fundo/MG,0,13,0,3768
597250,2022-04-17,Poço Fundo/MG,0,13,0,3768
602847,2022-04-18,Poço Fundo/MG,0,13,0,3768
608444,2022-04-19,Poço Fundo/MG,0,13,0,3768
614041,2022-04-20,Poço Fundo/MG,0,13,0,3768
619638,2022-04-21,Poço Fundo/MG,0,13,0,3768
625235,2022-04-22,Poço Fundo/MG,0,13,0,3768
630832,2022-04-23,Poço Fundo/MG,0,13,0,3768
636429,2022-04-24,Poço Fundo/MG,0,13,0,3768
642026,2022-04-25,Poço Fundo/MG,0,13,0,3768
647623,2022-04-26,Poço Fundo/MG,0,13,0,3768
653220,2022-04-27,Poço Fundo/MG,0,13,0,3768
658817,2022-04-28,Poço Fundo/MG,0,13,7,3775
664414,2022-04-29,Poço Fundo/MG,0,13,0,3775
670011,2022-04-30,Poço Fundo/MG,0,13,0,3775
675608,2022-05-01,Poço Fundo/MG,0,13,0,3775
681205,2022-05-02,Poço Fundo/MG,0,13,0,3775
686802,2022-05-03,Poço Fundo/MG,0,13,0,3775
692399,2022-05-04,Poço Fundo/MG,0,13,0,3775
697996,2022-05-05,Poço Fundo/MG,0,13,0,3775
703593,2022-05-06,Poço Fundo/MG,0,13,9,3784
709190,2022-05-07,Poço Fundo/MG,0,13,0,3784
714787,2022-05-08,Poço Fundo/MG,0,13,0,3784
720384,2022-05-09,Poço Fundo/MG,0,13,0,3784
725981,2022-05-10,Poço Fundo/MG,0,13,0,3784
731578,2022-05-11,Poço Fundo/MG,0,13,0,3784
737175,2022-05-12,Poço Fundo/MG,0,13,0,3784
742772,2022-05-13,Poço Fundo/MG,0,13,0,3784
748369,2022-05-14,Poço Fundo/MG,0,13,0,3784
753966,2022-05-15,Poço Fundo/MG,0,13,0,3784
759563,2022-05-16,Poço Fundo/MG,0,13,0,3784
765160,2022-05-17,Poço Fundo/MG,0,13,0,3784
770757,2022-05-18,Poço Fundo/MG,0,13,26,3810
776354,2022-05-19,Poço Fundo/MG,0,13,0,3810
781951,2022-05-20,Poço Fundo/MG,0,13,0,3810
787548,2022-05-21,Poço Fundo/MG,0,13,0,3810
793145,2022-05-22,Poço Fundo/MG,0,13,0,3810
798742,2022-05-23,Poço Fundo/MG,0,13,0,3810
804339,2022-05-24,Poço Fundo/MG,0,13,0,3810
809936,2022-05-25,Poço Fundo/MG,0,13,56,3866
815533,2022-05-26,Poço Fundo/MG,0,13,0,3866
821130,2022-05-27,Poço Fundo/MG,0,13,0,3866
826727,2022-05-28,Poço Fundo/MG,0,13,0,3866
832324,2022-05-29,Poço Fundo/MG,0,13,0,3866
837921,2022-05-30,Poço Fundo/MG,0,13,0,3866
843518,2022-05-31,Poço Fundo/MG,0,13,0,3866
849115,2022-06-01,Poço Fundo/MG,0,13,0,3866
854712,2022-06-02,Poço Fundo/MG,0,13,58,3924
860309,2022-06-03,Poço Fundo/MG,0,13,0,3924
865906,2022-06-04,Poço Fundo/MG,0,13,0,3924
871503,2022-06-05,Poço Fundo/MG,0,13,0,3924
877100,2022-06-06,Poço Fundo/MG,0,13,0,3924
882697,2022-06-07,Poço Fundo/MG,0,13,0,3924
888294,2022-06-08,Poço Fundo/MG,2,15,0,3924
893891,2022-06-09,Poço Fundo/MG,0,15,0,3924
899488,2022-06-10,Poço Fundo/MG,0,15,223,4147
905085,2022-06-11,Poço Fundo/MG,0,15,0,4147
910682,2022-06-12,Poço Fundo/MG,0,15,0,4147
916279,2022-06-13,Poço Fundo/MG,0,15,0,4147
921876,2022-06-14,Poço Fundo/MG,3,18,0,4147
927473,2022-06-15,Poço Fundo/MG,0,18,0,4147
933070,2022-06-16,Poço Fundo/MG,0,18,0,4147
938667,2022-06-17,Poço Fundo/MG,0,18,0,4147
944264,2022-06-18,Poço Fundo/MG,0,18,0,4147
949861,2022-06-19,Poço Fundo/MG,0,18,0,4147
955458,2022-06-20,Poço Fundo/MG,1,19,0,4147
961055,2022-06-21,Poço Fundo/MG,0,19,0,4147
966652,2022-06-22,Poço Fundo/MG,0,19,0,4147
972249,2022-06-23,Poço Fundo/MG,0,19,0,4147
977846,2022-06-24,Poço Fundo/MG,1,20,367,4514
983443,2022-06-25,Poço Fundo/MG,0,20,0,4514
989040,2022-06-26,Poço Fundo/MG,0,20,0,4514
994637,2022-06-27,Poço Fundo/MG,0,20,0,4514
1000234,2022-06-28,Poço Fundo/MG,0,20,0,4514
1005831,2022-06-29,Poço Fundo/MG,0,20,0,4514
1011428,2022-06-30,Poço Fundo/MG,0,20,97,4611
1017025,2022-07-01,Poço Fundo/MG,2,22,0,4611
1022622,2022-07-02,Poço Fundo/MG,0,22,0,4611
1028219,2022-07-03,Poço Fundo/MG,0,22,0,4611
1033816,2022-07-04,Poço Fundo/MG,0,22,0,4611
1039413,2022-07-05,Poço Fundo/MG,0,22,0,4611
1045010,2022-07-06,Poço Fundo/MG,0,22,0,4611
1050607,2022-07-07,Poço Fundo/MG,0,22,0,4611
1056204,2022-07-08,Poço Fundo/MG,0,22,64,4675
1061801,2022-07-09,Poço Fundo/MG,0,22,0,4675
1067398,2022-07-10,Poço Fundo/MG,0,22,0,4675
1072995,2022-07-11,Poço Fundo/MG,0,22,0,4675
1078592,2022-07-12,Poço Fundo/MG,0,22,0,4675
1084189,2022-07-13,Poço Fundo/MG,0,22,28,4703
1089786,2022-07-14,Poço Fundo/MG,0,22,0,4703
1095383,2022-07-15,Poço Fundo/MG,0,22,0,4703
1100980,2022-07-16,Poço Fundo/MG,0,22,0,4703
1106577,2022-07-17,Poço Fundo/MG,0,22,0,4703
1112174,2022-07-18,Poço Fundo/MG,0,22,0,4703
1117771,2022-07-19,Poço Fundo/MG,0,22,0,4703
1123368,2022-07-20,Poço Fundo/MG,0,22,0,4703
1128965,2022-07-21,Poço Fundo/MG,0,22,0,4703
1134562,2022-07-22,Poço Fundo/MG,0,22,108,4811
1140159,2022-07-23,Poço Fundo/MG,0,22,0,4811
1145756,2022-07-24,Poço Fundo/MG,0,22,0,4811
1151353,2022-07-25,Poço Fundo/MG,0,22,0,4811
1156950,2022-07-26,Poço Fundo/MG,0,22,0,4811
1162547,2022-07-27,Poço Fundo/MG,0,22,0,4811
1168144,2022-07-28,Poço Fundo/MG,0,22,0,4811
1173741,2022-07-29,Poço Fundo/MG,0,22,11,4822
1179338,2022-07-30,Poço Fundo/MG,0,22,0,4822
1184935,2022-07-31,Poço Fundo/MG,0,22,0,4822
1190532,2022-08-01,Poço Fundo/MG,0,22,0,4822
1196129,2022-08-02,Poço Fundo/MG,0,22,0,4822
1201726,2022-08-03,Poço Fundo/MG,0,22,4,4826
1207323,2022-08-04,Poço Fundo/MG,0,22,0,4826
1212920,2022-08-05,Poço Fundo/MG,0,22,0,4826
1218517,2022-08-06,Poço Fundo/MG,0,22,0,4826
1224114,2022-08-07,Poço Fundo/MG,0,22,0,4826
1229711,2022-08-08,Poço Fundo/MG,0,22,0,4826
1235308,2022-08-09,Poço Fundo/MG,0,22,0,4826
1240905,2022-08-10,Poço Fundo/MG,0,22,0,4826
1246502,2022-08-11,Poço Fundo/MG,0,22,0,4826
1252099,2022-08-12,Poço Fundo/MG,0,22,12,4838
1257696,2022-08-13,Poço Fundo/MG,0,22,0,4838
1263293,2022-08-14,Poço Fundo/MG,0,22,0,4838
1268890,2022-08-15,Poço Fundo/MG,0,22,0,4838
1274487,2022-08-16,Poço Fundo/MG,0,22,0,4838
1280084,2022-08-17,Poço Fundo/MG,0,22,2,4840
1285681,2022-08-18,Poço Fundo/MG,0,22,0,4840
1291278,2022-08-19,Poço Fundo/MG,0,22,0,4840
1296875,2022-08-20,Poço Fundo/MG,0,22,0,4840
1302472,2022-08-21,Poço Fundo/MG,0,22,0,4840
1308069,2022-08-22,Poço Fundo/MG,0,22,0,4840
1313666,2022-08-23,Poço Fundo/MG,0,22,0,4840
1319263,2022-08-24,Poço Fundo/MG,0,22,9,4849
1324860,2022-08-25,Poço Fundo/MG,0,22,0,4849
3974,2022-01-01,Poços de Caldas/MG,0,510,0,14606
9571,2022-01-02,Poços de Caldas/MG,0,510,0,14606
15168,2022-01-03,Poços de Caldas/MG,0,510,0,14606
20765,2022-01-04,Poços de Caldas/MG,0,510,22,14628
26362,2022-01-05,Poços de Caldas/MG,0,510,25,14653
31959,2022-01-06,Poços de Caldas/MG,-1,509,0,14653
37556,2022-01-07,Poços de Caldas/MG,0,509,300,14953
43153,2022-01-08,Poços de Caldas/MG,0,509,181,15134
48750,2022-01-09,Poços de Caldas/MG,0,509,0,15134
54347,2022-01-10,Poços de Caldas/MG,0,509,0,15134
59944,2022-01-11,Poços de Caldas/MG,0,509,174,15308
65541,2022-01-12,Poços de Caldas/MG,0,509,374,15682
71138,2022-01-13,Poços de Caldas/MG,0,509,189,15871
76735,2022-01-14,Poços de Caldas/MG,0,509,58,15929
82332,2022-01-15,Poços de Caldas/MG,1,510,46,15975
87929,2022-01-16,Poços de Caldas/MG,0,510,0,15975
93526,2022-01-17,Poços de Caldas/MG,0,510,0,15975
99123,2022-01-18,Poços de Caldas/MG,0,510,59,16034
104720,2022-01-19,Poços de Caldas/MG,0,510,539,16573
110317,2022-01-20,Poços de Caldas/MG,0,510,360,16933
115914,2022-01-21,Poços de Caldas/MG,0,510,305,17238
121511,2022-01-22,Poços de Caldas/MG,0,510,640,17878
127108,2022-01-23,Poços de Caldas/MG,0,510,0,17878
132705,2022-01-24,Poços de Caldas/MG,0,510,0,17878
138302,2022-01-25,Poços de Caldas/MG,0,510,478,18356
143899,2022-01-26,Poços de Caldas/MG,2,512,848,19204
149496,2022-01-27,Poços de Caldas/MG,2,514,478,19682
155093,2022-01-28,Poços de Caldas/MG,0,514,662,20344
160690,2022-01-29,Poços de Caldas/MG,0,514,298,20642
166287,2022-01-30,Poços de Caldas/MG,1,515,0,20642
171884,2022-01-31,Poços de Caldas/MG,0,515,0,20642
177481,2022-02-01,Poços de Caldas/MG,0,515,273,20915
183078,2022-02-02,Poços de Caldas/MG,2,517,536,21451
188675,2022-02-03,Poços de Caldas/MG,4,521,224,21675
194272,2022-02-04,Poços de Caldas/MG,2,523,225,21900
199869,2022-02-05,Poços de Caldas/MG,1,524,235,22135
205466,2022-02-06,Poços de Caldas/MG,1,525,0,22135
211063,2022-02-07,Poços de Caldas/MG,0,525,0,22135
216660,2022-02-08,Poços de Caldas/MG,1,526,151,22286
222257,2022-02-09,Poços de Caldas/MG,4,530,198,22484
227854,2022-02-10,Poços de Caldas/MG,2,532,46,22530
233451,2022-02-11,Poços de Caldas/MG,1,533,60,22590
239048,2022-02-12,Poços de Caldas/MG,1,534,83,22673
244645,2022-02-13,Poços de Caldas/MG,2,536,0,22673
250242,2022-02-14,Poços de Caldas/MG,0,536,0,22673
255839,2022-02-15,Poços de Caldas/MG,0,536,19,22692
261436,2022-02-16,Poços de Caldas/MG,0,536,170,22862
267033,2022-02-17,Poços de Caldas/MG,1,537,58,22920
272630,2022-02-18,Poços de Caldas/MG,1,538,0,22920
278227,2022-02-19,Poços de Caldas/MG,3,541,117,23037
283824,2022-02-20,Poços de Caldas/MG,1,542,0,23037
289421,2022-02-21,Poços de Caldas/MG,0,542,0,23037
295018,2022-02-22,Poços de Caldas/MG,0,542,56,23093
300615,2022-02-23,Poços de Caldas/MG,3,545,129,23222
306212,2022-02-24,Poços de Caldas/MG,0,545,53,23275
311809,2022-02-25,Poços de Caldas/MG,3,548,58,23333
317406,2022-02-26,Poços de Caldas/MG,1,549,68,23401
323003,2022-02-27,Poços de Caldas/MG,0,549,0,23401
328600,2022-02-28,Poços de Caldas/MG,0,549,0,23401
334197,2022-03-01,Poços de Caldas/MG,0,549,52,23453
339794,2022-03-02,Poços de Caldas/MG,1,550,0,23453
345391,2022-03-03,Poços de Caldas/MG,0,550,111,23564
350988,2022-03-04,Poços de Caldas/MG,1,551,71,23635
356585,2022-03-05,Poços de Caldas/MG,0,551,44,23679
362182,2022-03-06,Poços de Caldas/MG,1,552,0,23679
367779,2022-03-07,Poços de Caldas/MG,0,552,0,23679
373376,2022-03-08,Poços de Caldas/MG,0,552,17,23696
378973,2022-03-09,Poços de Caldas/MG,1,553,37,23733
384570,2022-03-10,Poços de Caldas/MG,0,553,36,23769
390167,2022-03-11,Poços de Caldas/MG,1,554,18,23787
395764,2022-03-12,Poços de Caldas/MG,0,554,17,23804
401361,2022-03-13,Poços de Caldas/MG,0,554,0,23804
406958,2022-03-14,Poços de Caldas/MG,0,554,0,23804
412555,2022-03-15,Poços de Caldas/MG,0,554,22,23826
418152,2022-03-16,Poços de Caldas/MG,0,554,23,23849
423749,2022-03-17,Poços de Caldas/MG,3,557,19,23868
429346,2022-03-18,Poços de Caldas/MG,0,557,16,23884
434943,2022-03-19,Poços de Caldas/MG,0,557,17,23901
440540,2022-03-20,Poços de Caldas/MG,-1,556,0,23901
446137,2022-03-21,Poços de Caldas/MG,0,556,0,23901
451734,2022-03-22,Poços de Caldas/MG,1,557,13,23914
457331,2022-03-23,Poços de Caldas/MG,-1,556,21,23935
462928,2022-03-24,Poços de Caldas/MG,0,556,8,23943
468525,2022-03-25,Poços de Caldas/MG,0,556,0,23943
474122,2022-03-26,Poços de Caldas/MG,1,557,16,23959
479719,2022-03-27,Poços de Caldas/MG,0,557,0,23959
485316,2022-03-28,Poços de Caldas/MG,0,557,0,23959
490913,2022-03-29,Poços de Caldas/MG,0,557,11,23970
496510,2022-03-30,Poços de Caldas/MG,1,558,16,23986
502107,2022-03-31,Poços de Caldas/MG,1,559,6,23992
507704,2022-04-01,Poços de Caldas/MG,0,559,2,23994
513301,2022-04-02,Poços de Caldas/MG,0,559,0,23994
518898,2022-04-03,Poços de Caldas/MG,0,559,0,23994
524495,2022-04-04,Poços de Caldas/MG,0,559,6,24000
530092,2022-04-05,Poços de Caldas/MG,0,559,3,24003
535689,2022-04-06,Poços de Caldas/MG,0,559,7,24010
541286,2022-04-07,Poços de Caldas/MG,0,559,6,24016
546883,2022-04-08,Poços de Caldas/MG,0,559,3,24019
552480,2022-04-09,Poços de Caldas/MG,0,559,5,24024
558077,2022-04-10,Poços de Caldas/MG,0,559,0,24024
563674,2022-04-11,Poços de Caldas/MG,0,559,0,24024
569271,2022-04-12,Poços de Caldas/MG,0,559,1,24025
574868,2022-04-13,Poços de Caldas/MG,0,559,2,24027
580465,2022-04-14,Poços de Caldas/MG,0,559,2,24029
586062,2022-04-15,Poços de Caldas/MG,0,559,0,24029
591659,2022-04-16,Poços de Caldas/MG,0,559,0,24029
597256,2022-04-17,Poços de Caldas/MG,0,559,0,24029
602853,2022-04-18,Poços de Caldas/MG,0,559,0,24029
608450,2022-04-19,Poços de Caldas/MG,0,559,0,24029
614047,2022-04-20,Poços de Caldas/MG,0,559,6,24035
619644,2022-04-21,Poços de Caldas/MG,0,559,4,24039
625241,2022-04-22,Poços de Caldas/MG,0,559,0,24039
630838,2022-04-23,Poços de Caldas/MG,0,559,0,24039
636435,2022-04-24,Poços de Caldas/MG,0,559,0,24039
642032,2022-04-25,Poços de Caldas/MG,0,559,0,24039
647629,2022-04-26,Poços de Caldas/MG,0,559,2,24041
653226,2022-04-27,Poços de Caldas/MG,0,559,3,24044
658823,2022-04-28,Poços de Caldas/MG,0,559,6,24050
664420,2022-04-29,Poços de Caldas/MG,0,559,4,24054
670017,2022-04-30,Poços de Caldas/MG,0,559,6,24060
675614,2022-05-01,Poços de Caldas/MG,0,559,0,24060
681211,2022-05-02,Poços de Caldas/MG,0,559,0,24060
686808,2022-05-03,Poços de Caldas/MG,0,559,8,24068
692405,2022-05-04,Poços de Caldas/MG,0,559,8,24076
698002,2022-05-05,Poços de Caldas/MG,0,559,14,24090
703599,2022-05-06,Poços de Caldas/MG,0,559,15,24105
709196,2022-05-07,Poços de Caldas/MG,0,559,0,24105
714793,2022-05-08,Poços de Caldas/MG,0,559,0,24105
720390,2022-05-09,Poços de Caldas/MG,0,559,11,24116
725987,2022-05-10,Poços de Caldas/MG,0,559,14,24130
731584,2022-05-11,Poços de Caldas/MG,0,559,19,24149
737181,2022-05-12,Poços de Caldas/MG,0,559,35,24184
742778,2022-05-13,Poços de Caldas/MG,0,559,60,24244
748375,2022-05-14,Poços de Caldas/MG,0,559,0,24244
753972,2022-05-15,Poços de Caldas/MG,0,559,0,24244
759569,2022-05-16,Poços de Caldas/MG,0,559,0,24244
765166,2022-05-17,Poços de Caldas/MG,0,559,0,24244
770763,2022-05-18,Poços de Caldas/MG,0,559,0,24244
776360,2022-05-19,Poços de Caldas/MG,0,559,0,24244
781957,2022-05-20,Poços de Caldas/MG,0,559,0,24244
787554,2022-05-21,Poços de Caldas/MG,0,559,0,24244
793151,2022-05-22,Poços de Caldas/MG,0,559,0,24244
798748,2022-05-23,Poços de Caldas/MG,0,559,257,24501
804345,2022-05-24,Poços de Caldas/MG,0,559,47,24548
809942,2022-05-25,Poços de Caldas/MG,1,560,85,24633
815539,2022-05-26,Poços de Caldas/MG,2,562,102,24735
821136,2022-05-27,Poços de Caldas/MG,0,562,105,24840
826733,2022-05-28,Poços de Caldas/MG,0,562,0,24840
832330,2022-05-29,Poços de Caldas/MG,0,562,0,24840
837927,2022-05-30,Poços de Caldas/MG,0,562,73,24913
843524,2022-05-31,Poços de Caldas/MG,0,562,97,25010
849121,2022-06-01,Poços de Caldas/MG,0,562,180,25190
854718,2022-06-02,Poços de Caldas/MG,0,562,74,25264
860315,2022-06-03,Poços de Caldas/MG,0,562,111,25375
865912,2022-06-04,Poços de Caldas/MG,0,562,0,25375
871509,2022-06-05,Poços de Caldas/MG,0,562,0,25375
877106,2022-06-06,Poços de Caldas/MG,0,562,123,25498
882703,2022-06-07,Poços de Caldas/MG,0,562,120,25618
888300,2022-06-08,Poços de Caldas/MG,1,563,213,25831
893897,2022-06-09,Poços de Caldas/MG,0,563,169,26000
899494,2022-06-10,Poços de Caldas/MG,0,563,71,26071
905091,2022-06-11,Poços de Caldas/MG,0,563,0,26071
910688,2022-06-12,Poços de Caldas/MG,0,563,0,26071
916285,2022-06-13,Poços de Caldas/MG,3,566,260,26331
921882,2022-06-14,Poços de Caldas/MG,1,567,67,26398
927479,2022-06-15,Poços de Caldas/MG,1,568,109,26507
933076,2022-06-16,Poços de Caldas/MG,0,568,0,26507
938673,2022-06-17,Poços de Caldas/MG,0,568,0,26507
944270,2022-06-18,Poços de Caldas/MG,0,568,0,26507
949867,2022-06-19,Poços de Caldas/MG,0,568,0,26507
955464,2022-06-20,Poços de Caldas/MG,1,569,50,26557
961061,2022-06-21,Poços de Caldas/MG,0,569,86,26643
966658,2022-06-22,Poços de Caldas/MG,0,569,223,26866
972255,2022-06-23,Poços de Caldas/MG,0,569,0,26866
977852,2022-06-24,Poços de Caldas/MG,4,573,0,26866
983449,2022-06-25,Poços de Caldas/MG,0,573,0,26866
989046,2022-06-26,Poços de Caldas/MG,0,573,0,26866
994643,2022-06-27,Poços de Caldas/MG,2,575,210,27076
1000240,2022-06-28,Poços de Caldas/MG,0,575,101,27177
1005837,2022-06-29,Poços de Caldas/MG,1,576,201,27378
1011434,2022-06-30,Poços de Caldas/MG,0,576,164,27542
1017031,2022-07-01,Poços de Caldas/MG,0,576,119,27661
1022628,2022-07-02,Poços de Caldas/MG,0,576,0,27661
1028225,2022-07-03,Poços de Caldas/MG,0,576,0,27661
1033822,2022-07-04,Poços de Caldas/MG,1,577,81,27742
1039419,2022-07-05,Poços de Caldas/MG,2,579,127,27869
1045016,2022-07-06,Poços de Caldas/MG,0,579,136,28005
1050613,2022-07-07,Poços de Caldas/MG,0,579,94,28099
1056210,2022-07-08,Poços de Caldas/MG,0,579,63,28162
1061807,2022-07-09,Poços de Caldas/MG,0,579,0,28162
1067404,2022-07-10,Poços de Caldas/MG,0,579,0,28162
1073001,2022-07-11,Poços de Caldas/MG,0,579,102,28264
1078598,2022-07-12,Poços de Caldas/MG,1,580,61,28325
1084195,2022-07-13,Poços de Caldas/MG,0,580,196,28521
1089792,2022-07-14,Poços de Caldas/MG,2,582,124,28645
1095389,2022-07-15,Poços de Caldas/MG,0,582,74,28719
1100986,2022-07-16,Poços de Caldas/MG,0,582,0,28719
1106583,2022-07-17,Poços de Caldas/MG,0,582,0,28719
1112180,2022-07-18,Poços de Caldas/MG,1,583,110,28829
1117777,2022-07-19,Poços de Caldas/MG,0,583,73,28902
1123374,2022-07-20,Poços de Caldas/MG,3,586,0,28902
1128971,2022-07-21,Poços de Caldas/MG,0,586,0,28902
1134568,2022-07-22,Poços de Caldas/MG,0,586,295,29197
1140165,2022-07-23,Poços de Caldas/MG,0,586,0,29197
1145762,2022-07-24,Poços de Caldas/MG,0,586,0,29197
1151359,2022-07-25,Poços de Caldas/MG,0,586,182,29379
1156956,2022-07-26,Poços de Caldas/MG,0,586,209,29588
1162553,2022-07-27,Poços de Caldas/MG,1,587,90,29678
1168150,2022-07-28,Poços de Caldas/MG,0,587,127,29805
1173747,2022-07-29,Poços de Caldas/MG,0,587,73,29878
1179344,2022-07-30,Poços de Caldas/MG,0,587,0,29878
1184941,2022-07-31,Poços de Caldas/MG,0,587,0,29878
1190538,2022-08-01,Poços de Caldas/MG,0,587,84,29962
1196135,2022-08-02,Poços de Caldas/MG,0,587,47,30009
1201732,2022-08-03,Poços de Caldas/MG,0,587,63,30072
1207329,2022-08-04,Poços de Caldas/MG,0,587,34,30106
1212926,2022-08-05,Poços de Caldas/MG,0,587,45,30151
1218523,2022-08-06,Poços de Caldas/MG,0,587,0,30151
1224120,2022-08-07,Poços de Caldas/MG,0,587,0,30151
1229717,2022-08-08,Poços de Caldas/MG,2,589,39,30190
1235314,2022-08-09,Poços de Caldas/MG,0,589,22,30212
1240911,2022-08-10,Poços de Caldas/MG,0,589,19,30231
1246508,2022-08-11,Poços de Caldas/MG,2,591,40,30271
1252105,2022-08-12,Poços de Caldas/MG,0,591,22,30293
1257702,2022-08-13,Poços de Caldas/MG,0,591,0,30293
1263299,2022-08-14,Poços de Caldas/MG,0,591,0,30293
1268896,2022-08-15,Poços de Caldas/MG,0,591,0,30293
1274493,2022-08-16,Poços de Caldas/MG,0,591,53,30346
1280090,2022-08-17,Poços de Caldas/MG,1,592,12,30358
1285687,2022-08-18,Poços de Caldas/MG,0,592,21,30379
1291284,2022-08-19,Poços de Caldas/MG,1,593,32,30411
1296881,2022-08-20,Poços de Caldas/MG,0,593,0,30411
1302478,2022-08-21,Poços de Caldas/MG,0,593,0,30411
1308075,2022-08-22,Poços de Caldas/MG,-1,592,18,30429
1313672,2022-08-23,Poços de Caldas/MG,0,592,0,30429
1319269,2022-08-24,Poços de Caldas/MG,0,592,30,30459
1324866,2022-08-25,Poços de Caldas/MG,1,593,11,30470
3960,2022-01-01,Pouso Alegre/MG,0,466,0,24847
9557,2022-01-02,Pouso Alegre/MG,0,466,0,24847
15154,2022-01-03,Pouso Alegre/MG,0,466,0,24847
20751,2022-01-04,Pouso Alegre/MG,0,466,300,25147
26348,2022-01-05,Pouso Alegre/MG,0,466,0,25147
31945,2022-01-06,Pouso Alegre/MG,0,466,0,25147
37542,2022-01-07,Pouso Alegre/MG,0,466,0,25147
43139,2022-01-08,Pouso Alegre/MG,0,466,0,25147
48736,2022-01-09,Pouso Alegre/MG,0,466,0,25147
54333,2022-01-10,Pouso Alegre/MG,0,466,0,25147
59930,2022-01-11,Pouso Alegre/MG,0,466,0,25147
65527,2022-01-12,Pouso Alegre/MG,0,466,0,25147
71124,2022-01-13,Pouso Alegre/MG,0,466,0,25147
76721,2022-01-14,Pouso Alegre/MG,0,466,0,25147
82318,2022-01-15,Pouso Alegre/MG,0,466,0,25147
87915,2022-01-16,Pouso Alegre/MG,0,466,0,25147
93512,2022-01-17,Pouso Alegre/MG,0,466,0,25147
99109,2022-01-18,Pouso Alegre/MG,0,466,0,25147
104706,2022-01-19,Pouso Alegre/MG,0,466,0,25147
110303,2022-01-20,Pouso Alegre/MG,0,466,0,25147
115900,2022-01-21,Pouso Alegre/MG,0,466,0,25147
121497,2022-01-22,Pouso Alegre/MG,0,466,0,25147
127094,2022-01-23,Pouso Alegre/MG,0,466,0,25147
132691,2022-01-24,Pouso Alegre/MG,0,466,0,25147
138288,2022-01-25,Pouso Alegre/MG,0,466,0,25147
143885,2022-01-26,Pouso Alegre/MG,0,466,0,25147
149482,2022-01-27,Pouso Alegre/MG,0,466,0,25147
155079,2022-01-28,Pouso Alegre/MG,0,466,4875,30022
160676,2022-01-29,Pouso Alegre/MG,0,466,1173,31195
166273,2022-01-30,Pouso Alegre/MG,2,468,0,31195
171870,2022-01-31,Pouso Alegre/MG,0,468,767,31962
177467,2022-02-01,Pouso Alegre/MG,0,468,0,31962
183064,2022-02-02,Pouso Alegre/MG,2,470,0,31962
188661,2022-02-03,Pouso Alegre/MG,1,471,0,31962
194258,2022-02-04,Pouso Alegre/MG,1,472,687,32649
199855,2022-02-05,Pouso Alegre/MG,3,475,0,32649
205452,2022-02-06,Pouso Alegre/MG,2,477,0,32649
211049,2022-02-07,Pouso Alegre/MG,0,477,0,32649
216646,2022-02-08,Pouso Alegre/MG,0,477,0,32649
222243,2022-02-09,Pouso Alegre/MG,2,479,335,32984
227840,2022-02-10,Pouso Alegre/MG,0,479,0,32984
233437,2022-02-11,Pouso Alegre/MG,0,479,0,32984
239034,2022-02-12,Pouso Alegre/MG,1,480,892,33876
244631,2022-02-13,Pouso Alegre/MG,1,481,0,33876
250228,2022-02-14,Pouso Alegre/MG,0,481,0,33876
255825,2022-02-15,Pouso Alegre/MG,0,481,0,33876
261422,2022-02-16,Pouso Alegre/MG,0,481,0,33876
267019,2022-02-17,Pouso Alegre/MG,2,483,612,34488
272616,2022-02-18,Pouso Alegre/MG,0,483,0,34488
278213,2022-02-19,Pouso Alegre/MG,1,484,0,34488
283810,2022-02-20,Pouso Alegre/MG,0,484,0,34488
289407,2022-02-21,Pouso Alegre/MG,0,484,0,34488
295004,2022-02-22,Pouso Alegre/MG,0,484,0,34488
300601,2022-02-23,Pouso Alegre/MG,1,485,664,35152
306198,2022-02-24,Pouso Alegre/MG,0,485,0,35152
311795,2022-02-25,Pouso Alegre/MG,1,486,0,35152
317392,2022-02-26,Pouso Alegre/MG,0,486,0,35152
322989,2022-02-27,Pouso Alegre/MG,2,488,0,35152
328586,2022-02-28,Pouso Alegre/MG,0,488,0,35152
334183,2022-03-01,Pouso Alegre/MG,0,488,549,35701
339780,2022-03-02,Pouso Alegre/MG,1,489,0,35701
345377,2022-03-03,Pouso Alegre/MG,0,489,0,35701
350974,2022-03-04,Pouso Alegre/MG,0,489,0,35701
356571,2022-03-05,Pouso Alegre/MG,0,489,0,35701
362168,2022-03-06,Pouso Alegre/MG,1,490,0,35701
367765,2022-03-07,Pouso Alegre/MG,0,490,0,35701
373362,2022-03-08,Pouso Alegre/MG,1,491,0,35701
378959,2022-03-09,Pouso Alegre/MG,0,491,388,36089
384556,2022-03-10,Pouso Alegre/MG,0,491,0,36089
390153,2022-03-11,Pouso Alegre/MG,0,491,0,36089
395750,2022-03-12,Pouso Alegre/MG,0,491,0,36089
401347,2022-03-13,Pouso Alegre/MG,0,491,0,36089
406944,2022-03-14,Pouso Alegre/MG,0,491,0,36089
412541,2022-03-15,Pouso Alegre/MG,1,492,0,36089
418138,2022-03-16,Pouso Alegre/MG,0,492,0,36089
423735,2022-03-17,Pouso Alegre/MG,0,492,0,36089
429332,2022-03-18,Pouso Alegre/MG,0,492,0,36089
434929,2022-03-19,Pouso Alegre/MG,0,492,0,36089
440526,2022-03-20,Pouso Alegre/MG,0,492,0,36089
446123,2022-03-21,Pouso Alegre/MG,0,492,0,36089
451720,2022-03-22,Pouso Alegre/MG,1,493,0,36089
457317,2022-03-23,Pouso Alegre/MG,0,493,357,36446
462914,2022-03-24,Pouso Alegre/MG,0,493,0,36446
468511,2022-03-25,Pouso Alegre/MG,0,493,0,36446
474108,2022-03-26,Pouso Alegre/MG,0,493,0,36446
479705,2022-03-27,Pouso Alegre/MG,0,493,0,36446
485302,2022-03-28,Pouso Alegre/MG,0,493,0,36446
490899,2022-03-29,Pouso Alegre/MG,0,493,0,36446
496496,2022-03-30,Pouso Alegre/MG,0,493,110,36556
502093,2022-03-31,Pouso Alegre/MG,0,493,0,36556
507690,2022-04-01,Pouso Alegre/MG,0,493,0,36556
513287,2022-04-02,Pouso Alegre/MG,0,493,0,36556
518884,2022-04-03,Pouso Alegre/MG,0,493,0,36556
524481,2022-04-04,Pouso Alegre/MG,0,493,0,36556
530078,2022-04-05,Pouso Alegre/MG,0,493,0,36556
535675,2022-04-06,Pouso Alegre/MG,0,493,0,36556
541272,2022-04-07,Pouso Alegre/MG,0,493,0,36556
546869,2022-04-08,Pouso Alegre/MG,0,493,0,36556
552466,2022-04-09,Pouso Alegre/MG,0,493,117,36673
558063,2022-04-10,Pouso Alegre/MG,0,493,0,36673
563660,2022-04-11,Pouso Alegre/MG,0,493,0,36673
569257,2022-04-12,Pouso Alegre/MG,0,493,0,36673
574854,2022-04-13,Pouso Alegre/MG,0,493,0,36673
580451,2022-04-14,Pouso Alegre/MG,0,493,0,36673
586048,2022-04-15,Pouso Alegre/MG,0,493,0,36673
591645,2022-04-16,Pouso Alegre/MG,0,493,0,36673
597242,2022-04-17,Pouso Alegre/MG,0,493,0,36673
602839,2022-04-18,Pouso Alegre/MG,0,493,0,36673
608436,2022-04-19,Pouso Alegre/MG,0,493,0,36673
614033,2022-04-20,Pouso Alegre/MG,0,493,28,36701
619630,2022-04-21,Pouso Alegre/MG,0,493,0,36701
625227,2022-04-22,Pouso Alegre/MG,0,493,0,36701
630824,2022-04-23,Pouso Alegre/MG,0,493,0,36701
636421,2022-04-24,Pouso Alegre/MG,0,493,0,36701
642018,2022-04-25,Pouso Alegre/MG,0,493,0,36701
647615,2022-04-26,Pouso Alegre/MG,0,493,0,36701
653212,2022-04-27,Pouso Alegre/MG,0,493,0,36701
658809,2022-04-28,Pouso Alegre/MG,0,493,0,36701
664406,2022-04-29,Pouso Alegre/MG,0,493,0,36701
670003,2022-04-30,Pouso Alegre/MG,0,493,0,36701
675600,2022-05-01,Pouso Alegre/MG,0,493,0,36701
681197,2022-05-02,Pouso Alegre/MG,0,493,0,36701
686794,2022-05-03,Pouso Alegre/MG,0,493,0,36701
692391,2022-05-04,Pouso Alegre/MG,0,493,0,36701
697988,2022-05-05,Pouso Alegre/MG,0,493,0,36701
703585,2022-05-06,Pouso Alegre/MG,0,493,0,36701
709182,2022-05-07,Pouso Alegre/MG,0,493,0,36701
714779,2022-05-08,Pouso Alegre/MG,0,493,0,36701
720376,2022-05-09,Pouso Alegre/MG,0,493,132,36833
725973,2022-05-10,Pouso Alegre/MG,0,493,0,36833
731570,2022-05-11,Pouso Alegre/MG,0,493,0,36833
737167,2022-05-12,Pouso Alegre/MG,0,493,0,36833
742764,2022-05-13,Pouso Alegre/MG,0,493,0,36833
748361,2022-05-14,Pouso Alegre/MG,0,493,0,36833
753958,2022-05-15,Pouso Alegre/MG,0,493,0,36833
759555,2022-05-16,Pouso Alegre/MG,0,493,0,36833
765152,2022-05-17,Pouso Alegre/MG,0,493,0,36833
770749,2022-05-18,Pouso Alegre/MG,0,493,0,36833
776346,2022-05-19,Pouso Alegre/MG,0,493,0,36833
781943,2022-05-20,Pouso Alegre/MG,0,493,0,36833
787540,2022-05-21,Pouso Alegre/MG,0,493,0,36833
793137,2022-05-22,Pouso Alegre/MG,0,493,0,36833
798734,2022-05-23,Pouso Alegre/MG,0,493,0,36833
804331,2022-05-24,Pouso Alegre/MG,1,494,0,36833
809928,2022-05-25,Pouso Alegre/MG,0,494,0,36833
815525,2022-05-26,Pouso Alegre/MG,0,494,0,36833
821122,2022-05-27,Pouso Alegre/MG,0,494,0,36833
826719,2022-05-28,Pouso Alegre/MG,0,494,0,36833
832316,2022-05-29,Pouso Alegre/MG,0,494,0,36833
837913,2022-05-30,Pouso Alegre/MG,0,494,363,37196
843510,2022-05-31,Pouso Alegre/MG,0,494,0,37196
849107,2022-06-01,Pouso Alegre/MG,0,494,0,37196
854704,2022-06-02,Pouso Alegre/MG,0,494,1232,38428
860301,2022-06-03,Pouso Alegre/MG,0,494,0,38428
865898,2022-06-04,Pouso Alegre/MG,0,494,0,38428
871495,2022-06-05,Pouso Alegre/MG,0,494,0,38428
877092,2022-06-06,Pouso Alegre/MG,0,494,0,38428
882689,2022-06-07,Pouso Alegre/MG,0,494,837,39265
888286,2022-06-08,Pouso Alegre/MG,3,497,0,39265
893883,2022-06-09,Pouso Alegre/MG,0,497,0,39265
899480,2022-06-10,Pouso Alegre/MG,0,497,0,39265
905077,2022-06-11,Pouso Alegre/MG,0,497,0,39265
910674,2022-06-12,Pouso Alegre/MG,0,497,0,39265
916271,2022-06-13,Pouso Alegre/MG,0,497,0,39265
921868,2022-06-14,Pouso Alegre/MG,2,499,0,39265
927465,2022-06-15,Pouso Alegre/MG,0,499,0,39265
933062,2022-06-16,Pouso Alegre/MG,0,499,0,39265
938659,2022-06-17,Pouso Alegre/MG,0,499,0,39265
944256,2022-06-18,Pouso Alegre/MG,0,499,0,39265
949853,2022-06-19,Pouso Alegre/MG,0,499,0,39265
955450,2022-06-20,Pouso Alegre/MG,1,500,0,39265
961047,2022-06-21,Pouso Alegre/MG,0,500,0,39265
966644,2022-06-22,Pouso Alegre/MG,0,500,1697,40962
972241,2022-06-23,Pouso Alegre/MG,0,500,285,41247
977838,2022-06-24,Pouso Alegre/MG,0,500,0,41247
983435,2022-06-25,Pouso Alegre/MG,0,500,0,41247
989032,2022-06-26,Pouso Alegre/MG,0,500,0,41247
994629,2022-06-27,Pouso Alegre/MG,3,503,316,41563
1000226,2022-06-28,Pouso Alegre/MG,0,503,0,41563
1005823,2022-06-29,Pouso Alegre/MG,0,503,0,41563
1011420,2022-06-30,Pouso Alegre/MG,0,503,0,41563
1017017,2022-07-01,Pouso Alegre/MG,0,503,0,41563
1022614,2022-07-02,Pouso Alegre/MG,0,503,0,41563
1028211,2022-07-03,Pouso Alegre/MG,0,503,0,41563
1033808,2022-07-04,Pouso Alegre/MG,0,503,294,41857
1039405,2022-07-05,Pouso Alegre/MG,0,503,0,41857
1045002,2022-07-06,Pouso Alegre/MG,1,504,0,41857
1050599,2022-07-07,Pouso Alegre/MG,0,504,0,41857
1056196,2022-07-08,Pouso Alegre/MG,0,504,0,41857
1061793,2022-07-09,Pouso Alegre/MG,0,504,0,41857
1067390,2022-07-10,Pouso Alegre/MG,0,504,0,41857
1072987,2022-07-11,Pouso Alegre/MG,0,504,0,41857
1078584,2022-07-12,Pouso Alegre/MG,0,504,0,41857
1084181,2022-07-13,Pouso Alegre/MG,0,504,156,42013
1089778,2022-07-14,Pouso Alegre/MG,0,504,0,42013
1095375,2022-07-15,Pouso Alegre/MG,0,504,0,42013
1100972,2022-07-16,Pouso Alegre/MG,0,504,0,42013
1106569,2022-07-17,Pouso Alegre/MG,0,504,0,42013
1112166,2022-07-18,Pouso Alegre/MG,0,504,0,42013
1117763,2022-07-19,Pouso Alegre/MG,0,504,0,42013
1123360,2022-07-20,Pouso Alegre/MG,0,504,0,42013
1128957,2022-07-21,Pouso Alegre/MG,0,504,0,42013
1134554,2022-07-22,Pouso Alegre/MG,0,504,0,42013
1140151,2022-07-23,Pouso Alegre/MG,0,504,0,42013
1145748,2022-07-24,Pouso Alegre/MG,0,504,0,42013
1151345,2022-07-25,Pouso Alegre/MG,0,504,0,42013
1156942,2022-07-26,Pouso Alegre/MG,0,504,0,42013
1162539,2022-07-27,Pouso Alegre/MG,0,504,0,42013
1168136,2022-07-28,Pouso Alegre/MG,0,504,0,42013
1173733,2022-07-29,Pouso Alegre/MG,0,504,188,42201
1179330,2022-07-30,Pouso Alegre/MG,0,504,0,42201
1184927,2022-07-31,Pouso Alegre/MG,0,504,0,42201
1190524,2022-08-01,Pouso Alegre/MG,0,504,0,42201
1196121,2022-08-02,Pouso Alegre/MG,0,504,0,42201
1201718,2022-08-03,Pouso Alegre/MG,0,504,55,42256
1207315,2022-08-04,Pouso Alegre/MG,0,504,0,42256
1212912,2022-08-05,Pouso Alegre/MG,0,504,0,42256
1218509,2022-08-06,Pouso Alegre/MG,0,504,0,42256
1224106,2022-08-07,Pouso Alegre/MG,0,504,0,42256
1229703,2022-08-08,Pouso Alegre/MG,0,504,0,42256
1235300,2022-08-09,Pouso Alegre/MG,1,505,0,42256
1240897,2022-08-10,Pouso Alegre/MG,0,505,0,42256
1246494,2022-08-11,Pouso Alegre/MG,0,505,0,42256
1252091,2022-08-12,Pouso Alegre/MG,0,505,0,42256
1257688,2022-08-13,Pouso Alegre/MG,0,505,0,42256
1263285,2022-08-14,Pouso Alegre/MG,0,505,0,42256
1268882,2022-08-15,Pouso Alegre/MG,0,505,0,42256
1274479,2022-08-16,Pouso Alegre/MG,0,505,0,42256
1280076,2022-08-17,Pouso Alegre/MG,0,505,74,42330
1285673,2022-08-18,Pouso Alegre/MG,0,505,0,42330
1291270,2022-08-19,Pouso Alegre/MG,0,505,0,42330
1296867,2022-08-20,Pouso Alegre/MG,0,505,0,42330
1302464,2022-08-21,Pouso Alegre/MG,0,505,0,42330
1308061,2022-08-22,Pouso Alegre/MG,0,505,0,42330
1313658,2022-08-23,Pouso Alegre/MG,0,505,0,42330
1319255,2022-08-24,Pouso Alegre/MG,0,505,0,42330
1324852,2022-08-25,Pouso Alegre/MG,0,505,0,42330
4450,2022-01-01,Santa Rita do Sapucaí/MG,0,82,0,4447
10047,2022-01-02,Santa Rita do Sapucaí/MG,0,82,0,4447
15644,2022-01-03,Santa Rita do Sapucaí/MG,0,82,0,4447
21241,2022-01-04,Santa Rita do Sapucaí/MG,0,82,0,4447
26838,2022-01-05,Santa Rita do Sapucaí/MG,0,82,0,4447
32435,2022-01-06,Santa Rita do Sapucaí/MG,0,82,0,4447
38032,2022-01-07,Santa Rita do Sapucaí/MG,0,82,0,4447
43629,2022-01-08,Santa Rita do Sapucaí/MG,0,82,0,4447
49226,2022-01-09,Santa Rita do Sapucaí/MG,0,82,0,4447
54823,2022-01-10,Santa Rita do Sapucaí/MG,0,82,0,4447
60420,2022-01-11,Santa Rita do Sapucaí/MG,0,82,0,4447
66017,2022-01-12,Santa Rita do Sapucaí/MG,0,82,0,4447
71614,2022-01-13,Santa Rita do Sapucaí/MG,0,82,0,4447
77211,2022-01-14,Santa Rita do Sapucaí/MG,0,82,0,4447
82808,2022-01-15,Santa Rita do Sapucaí/MG,0,82,0,4447
88405,2022-01-16,Santa Rita do Sapucaí/MG,0,82,0,4447
94002,2022-01-17,Santa Rita do Sapucaí/MG,0,82,0,4447
99599,2022-01-18,Santa Rita do Sapucaí/MG,0,82,786,5233
105196,2022-01-19,Santa Rita do Sapucaí/MG,0,82,0,5233
110793,2022-01-20,Santa Rita do Sapucaí/MG,0,82,0,5233
116390,2022-01-21,Santa Rita do Sapucaí/MG,0,82,0,5233
121987,2022-01-22,Santa Rita do Sapucaí/MG,0,82,258,5491
127584,2022-01-23,Santa Rita do Sapucaí/MG,0,82,0,5491
133181,2022-01-24,Santa Rita do Sapucaí/MG,0,82,0,5491
138778,2022-01-25,Santa Rita do Sapucaí/MG,0,82,0,5491
144375,2022-01-26,Santa Rita do Sapucaí/MG,0,82,0,5491
149972,2022-01-27,Santa Rita do Sapucaí/MG,0,82,0,5491
155569,2022-01-28,Santa Rita do Sapucaí/MG,0,82,0,5491
161166,2022-01-29,Santa Rita do Sapucaí/MG,0,82,419,5910
166763,2022-01-30,Santa Rita do Sapucaí/MG,1,83,0,5910
172360,2022-01-31,Santa Rita do Sapucaí/MG,0,83,0,5910
177957,2022-02-01,Santa Rita do Sapucaí/MG,0,83,204,6114
183554,2022-02-02,Santa Rita do Sapucaí/MG,2,85,0,6114
189151,2022-02-03,Santa Rita do Sapucaí/MG,1,86,0,6114
194748,2022-02-04,Santa Rita do Sapucaí/MG,0,86,232,6346
200345,2022-02-05,Santa Rita do Sapucaí/MG,0,86,72,6418
205942,2022-02-06,Santa Rita do Sapucaí/MG,0,86,0,6418
211539,2022-02-07,Santa Rita do Sapucaí/MG,0,86,0,6418
217136,2022-02-08,Santa Rita do Sapucaí/MG,0,86,0,6418
222733,2022-02-09,Santa Rita do Sapucaí/MG,0,86,85,6503
228330,2022-02-10,Santa Rita do Sapucaí/MG,0,86,0,6503
233927,2022-02-11,Santa Rita do Sapucaí/MG,0,86,0,6503
239524,2022-02-12,Santa Rita do Sapucaí/MG,0,86,0,6503
245121,2022-02-13,Santa Rita do Sapucaí/MG,0,86,172,6675
250718,2022-02-14,Santa Rita do Sapucaí/MG,0,86,0,6675
256315,2022-02-15,Santa Rita do Sapucaí/MG,0,86,0,6675
261912,2022-02-16,Santa Rita do Sapucaí/MG,0,86,74,6749
267509,2022-02-17,Santa Rita do Sapucaí/MG,0,86,0,6749
273106,2022-02-18,Santa Rita do Sapucaí/MG,0,86,0,6749
278703,2022-02-19,Santa Rita do Sapucaí/MG,0,86,0,6749
284300,2022-02-20,Santa Rita do Sapucaí/MG,0,86,0,6749
289897,2022-02-21,Santa Rita do Sapucaí/MG,0,86,0,6749
295494,2022-02-22,Santa Rita do Sapucaí/MG,0,86,119,6868
301091,2022-02-23,Santa Rita do Sapucaí/MG,0,86,15,6883
306688,2022-02-24,Santa Rita do Sapucaí/MG,0,86,0,6883
312285,2022-02-25,Santa Rita do Sapucaí/MG,0,86,29,6912
317882,2022-02-26,Santa Rita do Sapucaí/MG,0,86,14,6926
323479,2022-02-27,Santa Rita do Sapucaí/MG,0,86,0,6926
329076,2022-02-28,Santa Rita do Sapucaí/MG,0,86,0,6926
334673,2022-03-01,Santa Rita do Sapucaí/MG,0,86,0,6926
340270,2022-03-02,Santa Rita do Sapucaí/MG,0,86,0,6926
345867,2022-03-03,Santa Rita do Sapucaí/MG,0,86,55,6981
351464,2022-03-04,Santa Rita do Sapucaí/MG,0,86,0,6981
357061,2022-03-05,Santa Rita do Sapucaí/MG,0,86,0,6981
362658,2022-03-06,Santa Rita do Sapucaí/MG,0,86,0,6981
368255,2022-03-07,Santa Rita do Sapucaí/MG,0,86,0,6981
373852,2022-03-08,Santa Rita do Sapucaí/MG,0,86,0,6981
379449,2022-03-09,Santa Rita do Sapucaí/MG,0,86,30,7011
385046,2022-03-10,Santa Rita do Sapucaí/MG,0,86,1,7012
390643,2022-03-11,Santa Rita do Sapucaí/MG,0,86,2,7014
396240,2022-03-12,Santa Rita do Sapucaí/MG,0,86,8,7022
401837,2022-03-13,Santa Rita do Sapucaí/MG,0,86,0,7022
407434,2022-03-14,Santa Rita do Sapucaí/MG,0,86,0,7022
413031,2022-03-15,Santa Rita do Sapucaí/MG,0,86,11,7033
418628,2022-03-16,Santa Rita do Sapucaí/MG,0,86,5,7038
424225,2022-03-17,Santa Rita do Sapucaí/MG,0,86,5,7043
429822,2022-03-18,Santa Rita do Sapucaí/MG,0,86,0,7043
435419,2022-03-19,Santa Rita do Sapucaí/MG,0,86,0,7043
441016,2022-03-20,Santa Rita do Sapucaí/MG,0,86,0,7043
446613,2022-03-21,Santa Rita do Sapucaí/MG,0,86,0,7043
452210,2022-03-22,Santa Rita do Sapucaí/MG,0,86,0,7043
457807,2022-03-23,Santa Rita do Sapucaí/MG,0,86,2,7045
463404,2022-03-24,Santa Rita do Sapucaí/MG,0,86,0,7045
469001,2022-03-25,Santa Rita do Sapucaí/MG,0,86,1,7046
474598,2022-03-26,Santa Rita do Sapucaí/MG,0,86,0,7046
480195,2022-03-27,Santa Rita do Sapucaí/MG,0,86,0,7046
485792,2022-03-28,Santa Rita do Sapucaí/MG,0,86,0,7046
491389,2022-03-29,Santa Rita do Sapucaí/MG,0,86,0,7046
496986,2022-03-30,Santa Rita do Sapucaí/MG,0,86,4,7050
502583,2022-03-31,Santa Rita do Sapucaí/MG,0,86,0,7050
508180,2022-04-01,Santa Rita do Sapucaí/MG,0,86,0,7050
513777,2022-04-02,Santa Rita do Sapucaí/MG,0,86,0,7050
519374,2022-04-03,Santa Rita do Sapucaí/MG,0,86,0,7050
524971,2022-04-04,Santa Rita do Sapucaí/MG,0,86,0,7050
530568,2022-04-05,Santa Rita do Sapucaí/MG,0,86,0,7050
536165,2022-04-06,Santa Rita do Sapucaí/MG,0,86,2,7052
541762,2022-04-07,Santa Rita do Sapucaí/MG,0,86,0,7052
547359,2022-04-08,Santa Rita do Sapucaí/MG,0,86,0,7052
552956,2022-04-09,Santa Rita do Sapucaí/MG,0,86,1,7053
558553,2022-04-10,Santa Rita do Sapucaí/MG,0,86,0,7053
564150,2022-04-11,Santa Rita do Sapucaí/MG,0,86,0,7053
569747,2022-04-12,Santa Rita do Sapucaí/MG,0,86,0,7053
575344,2022-04-13,Santa Rita do Sapucaí/MG,0,86,1,7054
580941,2022-04-14,Santa Rita do Sapucaí/MG,0,86,1,7055
586538,2022-04-15,Santa Rita do Sapucaí/MG,0,86,0,7055
592135,2022-04-16,Santa Rita do Sapucaí/MG,0,86,0,7055
597732,2022-04-17,Santa Rita do Sapucaí/MG,0,86,0,7055
603329,2022-04-18,Santa Rita do Sapucaí/MG,0,86,0,7055
608926,2022-04-19,Santa Rita do Sapucaí/MG,0,86,1,7056
614523,2022-04-20,Santa Rita do Sapucaí/MG,0,86,0,7056
620120,2022-04-21,Santa Rita do Sapucaí/MG,0,86,2,7058
625717,2022-04-22,Santa Rita do Sapucaí/MG,0,86,0,7058
631314,2022-04-23,Santa Rita do Sapucaí/MG,0,86,0,7058
636911,2022-04-24,Santa Rita do Sapucaí/MG,0,86,0,7058
642508,2022-04-25,Santa Rita do Sapucaí/MG,0,86,0,7058
648105,2022-04-26,Santa Rita do Sapucaí/MG,0,86,2,7060
653702,2022-04-27,Santa Rita do Sapucaí/MG,1,87,2,7062
659299,2022-04-28,Santa Rita do Sapucaí/MG,0,87,0,7062
664896,2022-04-29,Santa Rita do Sapucaí/MG,0,87,1,7063
670493,2022-04-30,Santa Rita do Sapucaí/MG,0,87,0,7063
676090,2022-05-01,Santa Rita do Sapucaí/MG,0,87,0,7063
681687,2022-05-02,Santa Rita do Sapucaí/MG,0,87,0,7063
687284,2022-05-03,Santa Rita do Sapucaí/MG,0,87,2,7065
692881,2022-05-04,Santa Rita do Sapucaí/MG,0,87,3,7068
698478,2022-05-05,Santa Rita do Sapucaí/MG,0,87,1,7069
704075,2022-05-06,Santa Rita do Sapucaí/MG,0,87,2,7071
709672,2022-05-07,Santa Rita do Sapucaí/MG,0,87,0,7071
715269,2022-05-08,Santa Rita do Sapucaí/MG,0,87,0,7071
720866,2022-05-09,Santa Rita do Sapucaí/MG,0,87,1,7072
726463,2022-05-10,Santa Rita do Sapucaí/MG,0,87,4,7076
732060,2022-05-11,Santa Rita do Sapucaí/MG,0,87,7,7083
737657,2022-05-12,Santa Rita do Sapucaí/MG,0,87,9,7092
743254,2022-05-13,Santa Rita do Sapucaí/MG,0,87,4,7096
748851,2022-05-14,Santa Rita do Sapucaí/MG,0,87,0,7096
754448,2022-05-15,Santa Rita do Sapucaí/MG,0,87,0,7096
760045,2022-05-16,Santa Rita do Sapucaí/MG,0,87,4,7100
765642,2022-05-17,Santa Rita do Sapucaí/MG,0,87,12,7112
771239,2022-05-18,Santa Rita do Sapucaí/MG,0,87,16,7128
776836,2022-05-19,Santa Rita do Sapucaí/MG,0,87,8,7136
782433,2022-05-20,Santa Rita do Sapucaí/MG,0,87,12,7148
788030,2022-05-21,Santa Rita do Sapucaí/MG,0,87,0,7148
793627,2022-05-22,Santa Rita do Sapucaí/MG,0,87,0,7148
799224,2022-05-23,Santa Rita do Sapucaí/MG,0,87,8,7156
804821,2022-05-24,Santa Rita do Sapucaí/MG,0,87,0,7156
810418,2022-05-25,Santa Rita do Sapucaí/MG,0,87,0,7156
816015,2022-05-26,Santa Rita do Sapucaí/MG,0,87,0,7156
821612,2022-05-27,Santa Rita do Sapucaí/MG,0,87,27,7183
827209,2022-05-28,Santa Rita do Sapucaí/MG,0,87,0,7183
832806,2022-05-29,Santa Rita do Sapucaí/MG,0,87,0,7183
838403,2022-05-30,Santa Rita do Sapucaí/MG,0,87,17,7200
844000,2022-05-31,Santa Rita do Sapucaí/MG,0,87,31,7231
849597,2022-06-01,Santa Rita do Sapucaí/MG,-1,86,42,7273
855194,2022-06-02,Santa Rita do Sapucaí/MG,0,86,42,7315
860791,2022-06-03,Santa Rita do Sapucaí/MG,0,86,0,7315
866388,2022-06-04,Santa Rita do Sapucaí/MG,0,86,0,7315
871985,2022-06-05,Santa Rita do Sapucaí/MG,0,86,0,7315
877582,2022-06-06,Santa Rita do Sapucaí/MG,0,86,49,7364
883179,2022-06-07,Santa Rita do Sapucaí/MG,0,86,0,7364
888776,2022-06-08,Santa Rita do Sapucaí/MG,0,86,185,7549
894373,2022-06-09,Santa Rita do Sapucaí/MG,0,86,0,7549
899970,2022-06-10,Santa Rita do Sapucaí/MG,0,86,216,7765
905567,2022-06-11,Santa Rita do Sapucaí/MG,0,86,0,7765
911164,2022-06-12,Santa Rita do Sapucaí/MG,0,86,0,7765
916761,2022-06-13,Santa Rita do Sapucaí/MG,0,86,0,7765
922358,2022-06-14,Santa Rita do Sapucaí/MG,0,86,123,7888
927955,2022-06-15,Santa Rita do Sapucaí/MG,0,86,0,7888
933552,2022-06-16,Santa Rita do Sapucaí/MG,0,86,0,7888
939149,2022-06-17,Santa Rita do Sapucaí/MG,0,86,0,7888
944746,2022-06-18,Santa Rita do Sapucaí/MG,0,86,0,7888
950343,2022-06-19,Santa Rita do Sapucaí/MG,0,86,0,7888
955940,2022-06-20,Santa Rita do Sapucaí/MG,0,86,0,7888
961537,2022-06-21,Santa Rita do Sapucaí/MG,0,86,143,8031
967134,2022-06-22,Santa Rita do Sapucaí/MG,0,86,0,8031
972731,2022-06-23,Santa Rita do Sapucaí/MG,0,86,52,8083
978328,2022-06-24,Santa Rita do Sapucaí/MG,0,86,0,8083
983925,2022-06-25,Santa Rita do Sapucaí/MG,0,86,0,8083
989522,2022-06-26,Santa Rita do Sapucaí/MG,0,86,0,8083
995119,2022-06-27,Santa Rita do Sapucaí/MG,0,86,27,8110
1000716,2022-06-28,Santa Rita do Sapucaí/MG,0,86,15,8125
1006313,2022-06-29,Santa Rita do Sapucaí/MG,0,86,5,8130
1011910,2022-06-30,Santa Rita do Sapucaí/MG,0,86,0,8130
1017507,2022-07-01,Santa Rita do Sapucaí/MG,0,86,0,8130
1023104,2022-07-02,Santa Rita do Sapucaí/MG,0,86,0,8130
1028701,2022-07-03,Santa Rita do Sapucaí/MG,0,86,0,8130
1034298,2022-07-04,Santa Rita do Sapucaí/MG,0,86,43,8173
1039895,2022-07-05,Santa Rita do Sapucaí/MG,0,86,19,8192
1045492,2022-07-06,Santa Rita do Sapucaí/MG,0,86,6,8198
1051089,2022-07-07,Santa Rita do Sapucaí/MG,0,86,10,8208
1056686,2022-07-08,Santa Rita do Sapucaí/MG,0,86,0,8208
1062283,2022-07-09,Santa Rita do Sapucaí/MG,0,86,0,8208
1067880,2022-07-10,Santa Rita do Sapucaí/MG,0,86,0,8208
1073477,2022-07-11,Santa Rita do Sapucaí/MG,0,86,0,8208
1079074,2022-07-12,Santa Rita do Sapucaí/MG,0,86,26,8234
1084671,2022-07-13,Santa Rita do Sapucaí/MG,0,86,0,8234
1090268,2022-07-14,Santa Rita do Sapucaí/MG,0,86,9,8243
1095865,2022-07-15,Santa Rita do Sapucaí/MG,0,86,0,8243
1101462,2022-07-16,Santa Rita do Sapucaí/MG,0,86,0,8243
1107059,2022-07-17,Santa Rita do Sapucaí/MG,0,86,0,8243
1112656,2022-07-18,Santa Rita do Sapucaí/MG,0,86,0,8243
1118253,2022-07-19,Santa Rita do Sapucaí/MG,0,86,19,8262
1123850,2022-07-20,Santa Rita do Sapucaí/MG,0,86,8,8270
1129447,2022-07-21,Santa Rita do Sapucaí/MG,0,86,0,8270
1135044,2022-07-22,Santa Rita do Sapucaí/MG,0,86,0,8270
1140641,2022-07-23,Santa Rita do Sapucaí/MG,0,86,0,8270
1146238,2022-07-24,Santa Rita do Sapucaí/MG,0,86,0,8270
1151835,2022-07-25,Santa Rita do Sapucaí/MG,0,86,11,8281
1157432,2022-07-26,Santa Rita do Sapucaí/MG,0,86,6,8287
1163029,2022-07-27,Santa Rita do Sapucaí/MG,0,86,0,8287
1168626,2022-07-28,Santa Rita do Sapucaí/MG,0,86,1,8288
1174223,2022-07-29,Santa Rita do Sapucaí/MG,0,86,0,8288
1179820,2022-07-30,Santa Rita do Sapucaí/MG,0,86,0,8288
1185417,2022-07-31,Santa Rita do Sapucaí/MG,0,86,0,8288
1191014,2022-08-01,Santa Rita do Sapucaí/MG,0,86,0,8288
1196611,2022-08-02,Santa Rita do Sapucaí/MG,0,86,5,8293
1202208,2022-08-03,Santa Rita do Sapucaí/MG,0,86,1,8294
1207805,2022-08-04,Santa Rita do Sapucaí/MG,0,86,6,8300
1213402,2022-08-05,Santa Rita do Sapucaí/MG,0,86,0,8300
1218999,2022-08-06,Santa Rita do Sapucaí/MG,0,86,0,8300
1224596,2022-08-07,Santa Rita do Sapucaí/MG,0,86,0,8300
1230193,2022-08-08,Santa Rita do Sapucaí/MG,0,86,6,8306
1235790,2022-08-09,Santa Rita do Sapucaí/MG,0,86,0,8306
1241387,2022-08-10,Santa Rita do Sapucaí/MG,0,86,0,8306
1246984,2022-08-11,Santa Rita do Sapucaí/MG,0,86,2,8308
1252581,2022-08-12,Santa Rita do Sapucaí/MG,0,86,0,8308
1258178,2022-08-13,Santa Rita do Sapucaí/MG,0,86,0,8308
1263775,2022-08-14,Santa Rita do Sapucaí/MG,0,86,0,8308
1269372,2022-08-15,Santa Rita do Sapucaí/MG,0,86,0,8308
1274969,2022-08-16,Santa Rita do Sapucaí/MG,0,86,0,8308
1280566,2022-08-17,Santa Rita do Sapucaí/MG,0,86,4,8312
1286163,2022-08-18,Santa Rita do Sapucaí/MG,0,86,0,8312
1291760,2022-08-19,Santa Rita do Sapucaí/MG,0,86,0,8312
1297357,2022-08-20,Santa Rita do Sapucaí/MG,0,86,0,8312
1302954,2022-08-21,Santa Rita do Sapucaí/MG,0,86,0,8312
1308551,2022-08-22,Santa Rita do Sapucaí/MG,0,86,0,8312
1314148,2022-08-23,Santa Rita do Sapucaí/MG,0,86,0,8312
1319745,2022-08-24,Santa Rita do Sapucaí/MG,0,86,0,8312
1325342,2022-08-25,Santa Rita do Sapucaí/MG,0,86,0,8312
4837,2022-01-01,São Gonçalo do Sapucaí/MG,0,62,0,2792
10434,2022-01-02,São Gonçalo do Sapucaí/MG,0,62,0,2792
16031,2022-01-03,São Gonçalo do Sapucaí/MG,0,62,0,2792
21628,2022-01-04,São Gonçalo do Sapucaí/MG,0,62,0,2792
27225,2022-01-05,São Gonçalo do Sapucaí/MG,0,62,0,2792
32822,2022-01-06,São Gonçalo do Sapucaí/MG,0,62,0,2792
38419,2022-01-07,São Gonçalo do Sapucaí/MG,0,62,182,2974
44016,2022-01-08,São Gonçalo do Sapucaí/MG,1,63,67,3041
49613,2022-01-09,São Gonçalo do Sapucaí/MG,0,63,0,3041
55210,2022-01-10,São Gonçalo do Sapucaí/MG,0,63,0,3041
60807,2022-01-11,São Gonçalo do Sapucaí/MG,0,63,0,3041
66404,2022-01-12,São Gonçalo do Sapucaí/MG,0,63,105,3146
72001,2022-01-13,São Gonçalo do Sapucaí/MG,0,63,0,3146
77598,2022-01-14,São Gonçalo do Sapucaí/MG,0,63,94,3240
83195,2022-01-15,São Gonçalo do Sapucaí/MG,0,63,68,3308
88792,2022-01-16,São Gonçalo do Sapucaí/MG,0,63,0,3308
94389,2022-01-17,São Gonçalo do Sapucaí/MG,0,63,0,3308
99986,2022-01-18,São Gonçalo do Sapucaí/MG,0,63,0,3308
105583,2022-01-19,São Gonçalo do Sapucaí/MG,0,63,0,3308
111180,2022-01-20,São Gonçalo do Sapucaí/MG,0,63,265,3573
116777,2022-01-21,São Gonçalo do Sapucaí/MG,0,63,57,3630
122374,2022-01-22,São Gonçalo do Sapucaí/MG,1,64,59,3689
127971,2022-01-23,São Gonçalo do Sapucaí/MG,0,64,0,3689
133568,2022-01-24,São Gonçalo do Sapucaí/MG,0,64,0,3689
139165,2022-01-25,São Gonçalo do Sapucaí/MG,0,64,0,3689
144762,2022-01-26,São Gonçalo do Sapucaí/MG,0,64,0,3689
150359,2022-01-27,São Gonçalo do Sapucaí/MG,0,64,237,3926
155956,2022-01-28,São Gonçalo do Sapucaí/MG,0,64,57,3983
161553,2022-01-29,São Gonçalo do Sapucaí/MG,0,64,0,3983
167150,2022-01-30,São Gonçalo do Sapucaí/MG,0,64,0,3983
172747,2022-01-31,São Gonçalo do Sapucaí/MG,0,64,0,3983
178344,2022-02-01,São Gonçalo do Sapucaí/MG,0,64,74,4057
183941,2022-02-02,São Gonçalo do Sapucaí/MG,0,64,71,4128
189538,2022-02-03,São Gonçalo do Sapucaí/MG,0,64,32,4160
195135,2022-02-04,São Gonçalo do Sapucaí/MG,1,65,34,4194
200732,2022-02-05,São Gonçalo do Sapucaí/MG,1,66,29,4223
206329,2022-02-06,São Gonçalo do Sapucaí/MG,0,66,0,4223
211926,2022-02-07,São Gonçalo do Sapucaí/MG,0,66,0,4223
217523,2022-02-08,São Gonçalo do Sapucaí/MG,0,66,124,4347
223120,2022-02-09,São Gonçalo do Sapucaí/MG,1,67,42,4389
228717,2022-02-10,São Gonçalo do Sapucaí/MG,1,68,25,4414
234314,2022-02-11,São Gonçalo do Sapucaí/MG,0,68,25,4439
239911,2022-02-12,São Gonçalo do Sapucaí/MG,0,68,0,4439
245508,2022-02-13,São Gonçalo do Sapucaí/MG,0,68,0,4439
251105,2022-02-14,São Gonçalo do Sapucaí/MG,0,68,0,4439
256702,2022-02-15,São Gonçalo do Sapucaí/MG,0,68,0,4439
262299,2022-02-16,São Gonçalo do Sapucaí/MG,0,68,0,4439
267896,2022-02-17,São Gonçalo do Sapucaí/MG,0,68,108,4547
273493,2022-02-18,São Gonçalo do Sapucaí/MG,1,69,11,4558
279090,2022-02-19,São Gonçalo do Sapucaí/MG,0,69,15,4573
284687,2022-02-20,São Gonçalo do Sapucaí/MG,0,69,0,4573
290284,2022-02-21,São Gonçalo do Sapucaí/MG,0,69,0,4573
295881,2022-02-22,São Gonçalo do Sapucaí/MG,0,69,14,4587
301478,2022-02-23,São Gonçalo do Sapucaí/MG,0,69,22,4609
307075,2022-02-24,São Gonçalo do Sapucaí/MG,0,69,5,4614
312672,2022-02-25,São Gonçalo do Sapucaí/MG,0,69,10,4624
318269,2022-02-26,São Gonçalo do Sapucaí/MG,0,69,0,4624
323866,2022-02-27,São Gonçalo do Sapucaí/MG,0,69,0,4624
329463,2022-02-28,São Gonçalo do Sapucaí/MG,0,69,0,4624
335060,2022-03-01,São Gonçalo do Sapucaí/MG,0,69,0,4624
340657,2022-03-02,São Gonçalo do Sapucaí/MG,0,69,0,4624
346254,2022-03-03,São Gonçalo do Sapucaí/MG,0,69,0,4624
351851,2022-03-04,São Gonçalo do Sapucaí/MG,0,69,22,4646
357448,2022-03-05,São Gonçalo do Sapucaí/MG,0,69,2,4648
363045,2022-03-06,São Gonçalo do Sapucaí/MG,2,71,0,4648
368642,2022-03-07,São Gonçalo do Sapucaí/MG,0,71,0,4648
374239,2022-03-08,São Gonçalo do Sapucaí/MG,0,71,0,4648
379836,2022-03-09,São Gonçalo do Sapucaí/MG,1,72,11,4659
385433,2022-03-10,São Gonçalo do Sapucaí/MG,0,72,0,4659
391030,2022-03-11,São Gonçalo do Sapucaí/MG,0,72,7,4666
396627,2022-03-12,São Gonçalo do Sapucaí/MG,0,72,6,4672
402224,2022-03-13,São Gonçalo do Sapucaí/MG,0,72,0,4672
407821,2022-03-14,São Gonçalo do Sapucaí/MG,0,72,0,4672
413418,2022-03-15,São Gonçalo do Sapucaí/MG,0,72,5,4677
419015,2022-03-16,São Gonçalo do Sapucaí/MG,0,72,1,4678
424612,2022-03-17,São Gonçalo do Sapucaí/MG,1,73,0,4678
430209,2022-03-18,São Gonçalo do Sapucaí/MG,0,73,4,4682
435806,2022-03-19,São Gonçalo do Sapucaí/MG,0,73,0,4682
441403,2022-03-20,São Gonçalo do Sapucaí/MG,0,73,0,4682
447000,2022-03-21,São Gonçalo do Sapucaí/MG,0,73,0,4682
452597,2022-03-22,São Gonçalo do Sapucaí/MG,0,73,0,4682
458194,2022-03-23,São Gonçalo do Sapucaí/MG,0,73,0,4682
463791,2022-03-24,São Gonçalo do Sapucaí/MG,0,73,3,4685
469388,2022-03-25,São Gonçalo do Sapucaí/MG,0,73,0,4685
474985,2022-03-26,São Gonçalo do Sapucaí/MG,0,73,0,4685
480582,2022-03-27,São Gonçalo do Sapucaí/MG,0,73,0,4685
486179,2022-03-28,São Gonçalo do Sapucaí/MG,0,73,0,4685
491776,2022-03-29,São Gonçalo do Sapucaí/MG,0,73,0,4685
497373,2022-03-30,São Gonçalo do Sapucaí/MG,0,73,0,4685
502970,2022-03-31,São Gonçalo do Sapucaí/MG,0,73,0,4685
508567,2022-04-01,São Gonçalo do Sapucaí/MG,0,73,0,4685
514164,2022-04-02,São Gonçalo do Sapucaí/MG,0,73,0,4685
519761,2022-04-03,São Gonçalo do Sapucaí/MG,0,73,0,4685
525358,2022-04-04,São Gonçalo do Sapucaí/MG,0,73,2,4687
530955,2022-04-05,São Gonçalo do Sapucaí/MG,0,73,0,4687
536552,2022-04-06,São Gonçalo do Sapucaí/MG,0,73,5,4692
542149,2022-04-07,São Gonçalo do Sapucaí/MG,0,73,0,4692
547746,2022-04-08,São Gonçalo do Sapucaí/MG,0,73,1,4693
553343,2022-04-09,São Gonçalo do Sapucaí/MG,0,73,1,4694
558940,2022-04-10,São Gonçalo do Sapucaí/MG,0,73,0,4694
564537,2022-04-11,São Gonçalo do Sapucaí/MG,0,73,0,4694
570134,2022-04-12,São Gonçalo do Sapucaí/MG,0,73,0,4694
575731,2022-04-13,São Gonçalo do Sapucaí/MG,0,73,3,4697
581328,2022-04-14,São Gonçalo do Sapucaí/MG,0,73,0,4697
586925,2022-04-15,São Gonçalo do Sapucaí/MG,0,73,1,4698
592522,2022-04-16,São Gonçalo do Sapucaí/MG,0,73,0,4698
598119,2022-04-17,São Gonçalo do Sapucaí/MG,0,73,0,4698
603716,2022-04-18,São Gonçalo do Sapucaí/MG,0,73,0,4698
609313,2022-04-19,São Gonçalo do Sapucaí/MG,0,73,0,4698
614910,2022-04-20,São Gonçalo do Sapucaí/MG,0,73,0,4698
620507,2022-04-21,São Gonçalo do Sapucaí/MG,0,73,0,4698
626104,2022-04-22,São Gonçalo do Sapucaí/MG,0,73,0,4698
631701,2022-04-23,São Gonçalo do Sapucaí/MG,0,73,0,4698
637298,2022-04-24,São Gonçalo do Sapucaí/MG,0,73,0,4698
642895,2022-04-25,São Gonçalo do Sapucaí/MG,0,73,0,4698
648492,2022-04-26,São Gonçalo do Sapucaí/MG,0,73,0,4698
654089,2022-04-27,São Gonçalo do Sapucaí/MG,0,73,3,4701
659686,2022-04-28,São Gonçalo do Sapucaí/MG,0,73,1,4702
665283,2022-04-29,São Gonçalo do Sapucaí/MG,0,73,0,4702
670880,2022-04-30,São Gonçalo do Sapucaí/MG,0,73,0,4702
676477,2022-05-01,São Gonçalo do Sapucaí/MG,0,73,0,4702
682074,2022-05-02,São Gonçalo do Sapucaí/MG,0,73,0,4702
687671,2022-05-03,São Gonçalo do Sapucaí/MG,0,73,2,4704
693268,2022-05-04,São Gonçalo do Sapucaí/MG,0,73,1,4705
698865,2022-05-05,São Gonçalo do Sapucaí/MG,0,73,0,4705
704462,2022-05-06,São Gonçalo do Sapucaí/MG,0,73,0,4705
710059,2022-05-07,São Gonçalo do Sapucaí/MG,0,73,0,4705
715656,2022-05-08,São Gonçalo do Sapucaí/MG,0,73,0,4705
721253,2022-05-09,São Gonçalo do Sapucaí/MG,0,73,2,4707
726850,2022-05-10,São Gonçalo do Sapucaí/MG,0,73,0,4707
732447,2022-05-11,São Gonçalo do Sapucaí/MG,0,73,0,4707
738044,2022-05-12,São Gonçalo do Sapucaí/MG,0,73,4,4711
743641,2022-05-13,São Gonçalo do Sapucaí/MG,0,73,3,4714
749238,2022-05-14,São Gonçalo do Sapucaí/MG,0,73,0,4714
754835,2022-05-15,São Gonçalo do Sapucaí/MG,0,73,0,4714
760432,2022-05-16,São Gonçalo do Sapucaí/MG,0,73,0,4714
766029,2022-05-17,São Gonçalo do Sapucaí/MG,0,73,3,4717
771626,2022-05-18,São Gonçalo do Sapucaí/MG,0,73,0,4717
777223,2022-05-19,São Gonçalo do Sapucaí/MG,0,73,16,4733
782820,2022-05-20,São Gonçalo do Sapucaí/MG,0,73,7,4740
788417,2022-05-21,São Gonçalo do Sapucaí/MG,0,73,0,4740
794014,2022-05-22,São Gonçalo do Sapucaí/MG,0,73,0,4740
799611,2022-05-23,São Gonçalo do Sapucaí/MG,0,73,13,4753
805208,2022-05-24,São Gonçalo do Sapucaí/MG,0,73,0,4753
810805,2022-05-25,São Gonçalo do Sapucaí/MG,0,73,21,4774
816402,2022-05-26,São Gonçalo do Sapucaí/MG,0,73,10,4784
821999,2022-05-27,São Gonçalo do Sapucaí/MG,0,73,12,4796
827596,2022-05-28,São Gonçalo do Sapucaí/MG,0,73,0,4796
833193,2022-05-29,São Gonçalo do Sapucaí/MG,0,73,0,4796
838790,2022-05-30,São Gonçalo do Sapucaí/MG,1,74,15,4811
844387,2022-05-31,São Gonçalo do Sapucaí/MG,0,74,43,4854
849984,2022-06-01,São Gonçalo do Sapucaí/MG,0,74,34,4888
855581,2022-06-02,São Gonçalo do Sapucaí/MG,0,74,0,4888
861178,2022-06-03,São Gonçalo do Sapucaí/MG,0,74,0,4888
866775,2022-06-04,São Gonçalo do Sapucaí/MG,0,74,0,4888
872372,2022-06-05,São Gonçalo do Sapucaí/MG,0,74,0,4888
877969,2022-06-06,São Gonçalo do Sapucaí/MG,0,74,81,4969
883566,2022-06-07,São Gonçalo do Sapucaí/MG,0,74,0,4969
889163,2022-06-08,São Gonçalo do Sapucaí/MG,1,75,0,4969
894760,2022-06-09,São Gonçalo do Sapucaí/MG,0,75,50,5019
900357,2022-06-10,São Gonçalo do Sapucaí/MG,0,75,0,5019
905954,2022-06-11,São Gonçalo do Sapucaí/MG,0,75,0,5019
911551,2022-06-12,São Gonçalo do Sapucaí/MG,0,75,0,5019
917148,2022-06-13,São Gonçalo do Sapucaí/MG,0,75,0,5019
922745,2022-06-14,São Gonçalo do Sapucaí/MG,0,75,0,5019
928342,2022-06-15,São Gonçalo do Sapucaí/MG,0,75,265,5284
933939,2022-06-16,São Gonçalo do Sapucaí/MG,0,75,0,5284
939536,2022-06-17,São Gonçalo do Sapucaí/MG,0,75,0,5284
945133,2022-06-18,São Gonçalo do Sapucaí/MG,0,75,0,5284
950730,2022-06-19,São Gonçalo do Sapucaí/MG,0,75,0,5284
956327,2022-06-20,São Gonçalo do Sapucaí/MG,0,75,150,5434
961924,2022-06-21,São Gonçalo do Sapucaí/MG,0,75,0,5434
967521,2022-06-22,São Gonçalo do Sapucaí/MG,0,75,105,5539
973118,2022-06-23,São Gonçalo do Sapucaí/MG,0,75,0,5539
978715,2022-06-24,São Gonçalo do Sapucaí/MG,0,75,62,5601
984312,2022-06-25,São Gonçalo do Sapucaí/MG,0,75,0,5601
989909,2022-06-26,São Gonçalo do Sapucaí/MG,0,75,0,5601
995506,2022-06-27,São Gonçalo do Sapucaí/MG,0,75,19,5620
1001103,2022-06-28,São Gonçalo do Sapucaí/MG,0,75,0,5620
1006700,2022-06-29,São Gonçalo do Sapucaí/MG,0,75,0,5620
1012297,2022-06-30,São Gonçalo do Sapucaí/MG,0,75,0,5620
1017894,2022-07-01,São Gonçalo do Sapucaí/MG,0,75,84,5704
1023491,2022-07-02,São Gonçalo do Sapucaí/MG,0,75,0,5704
1029088,2022-07-03,São Gonçalo do Sapucaí/MG,0,75,0,5704
1034685,2022-07-04,São Gonçalo do Sapucaí/MG,0,75,0,5704
1040282,2022-07-05,São Gonçalo do Sapucaí/MG,0,75,22,5726
1045879,2022-07-06,São Gonçalo do Sapucaí/MG,0,75,0,5726
1051476,2022-07-07,São Gonçalo do Sapucaí/MG,0,75,0,5726
1057073,2022-07-08,São Gonçalo do Sapucaí/MG,0,75,32,5758
1062670,2022-07-09,São Gonçalo do Sapucaí/MG,0,75,0,5758
1068267,2022-07-10,São Gonçalo do Sapucaí/MG,0,75,0,5758
1073864,2022-07-11,São Gonçalo do Sapucaí/MG,0,75,1,5759
1079461,2022-07-12,São Gonçalo do Sapucaí/MG,0,75,0,5759
1085058,2022-07-13,São Gonçalo do Sapucaí/MG,0,75,13,5772
1090655,2022-07-14,São Gonçalo do Sapucaí/MG,0,75,0,5772
1096252,2022-07-15,São Gonçalo do Sapucaí/MG,0,75,2,5774
1101849,2022-07-16,São Gonçalo do Sapucaí/MG,0,75,0,5774
1107446,2022-07-17,São Gonçalo do Sapucaí/MG,0,75,0,5774
1113043,2022-07-18,São Gonçalo do Sapucaí/MG,0,75,0,5774
1118640,2022-07-19,São Gonçalo do Sapucaí/MG,0,75,6,5780
1124237,2022-07-20,São Gonçalo do Sapucaí/MG,0,75,0,5780
1129834,2022-07-21,São Gonçalo do Sapucaí/MG,0,75,27,5807
1135431,2022-07-22,São Gonçalo do Sapucaí/MG,0,75,0,5807
1141028,2022-07-23,São Gonçalo do Sapucaí/MG,0,75,0,5807
1146625,2022-07-24,São Gonçalo do Sapucaí/MG,0,75,0,5807
1152222,2022-07-25,São Gonçalo do Sapucaí/MG,0,75,0,5807
1157819,2022-07-26,São Gonçalo do Sapucaí/MG,0,75,0,5807
1163416,2022-07-27,São Gonçalo do Sapucaí/MG,0,75,0,5807
1169013,2022-07-28,São Gonçalo do Sapucaí/MG,0,75,0,5807
1174610,2022-07-29,São Gonçalo do Sapucaí/MG,0,75,0,5807
1180207,2022-07-30,São Gonçalo do Sapucaí/MG,0,75,0,5807
1185804,2022-07-31,São Gonçalo do Sapucaí/MG,0,75,0,5807
1191401,2022-08-01,São Gonçalo do Sapucaí/MG,0,75,63,5870
1196998,2022-08-02,São Gonçalo do Sapucaí/MG,0,75,1,5871
1202595,2022-08-03,São Gonçalo do Sapucaí/MG,0,75,1,5872
1208192,2022-08-04,São Gonçalo do Sapucaí/MG,0,75,17,5889
1213789,2022-08-05,São Gonçalo do Sapucaí/MG,0,75,0,5889
1219386,2022-08-06,São Gonçalo do Sapucaí/MG,0,75,0,5889
1224983,2022-08-07,São Gonçalo do Sapucaí/MG,0,75,0,5889
1230580,2022-08-08,São Gonçalo do Sapucaí/MG,0,75,0,5889
1236177,2022-08-09,São Gonçalo do Sapucaí/MG,0,75,0,5889
1241774,2022-08-10,São Gonçalo do Sapucaí/MG,0,75,0,5889
1247371,2022-08-11,São Gonçalo do Sapucaí/MG,0,75,0,5889
1252968,2022-08-12,São Gonçalo do Sapucaí/MG,0,75,0,5889
1258565,2022-08-13,São Gonçalo do Sapucaí/MG,0,75,0,5889
1264162,2022-08-14,São Gonçalo do Sapucaí/MG,0,75,0,5889
1269759,2022-08-15,São Gonçalo do Sapucaí/MG,0,75,0,5889
1275356,2022-08-16,São Gonçalo do Sapucaí/MG,0,75,0,5889
1280953,2022-08-17,São Gonçalo do Sapucaí/MG,0,75,1,5890
1286550,2022-08-18,São Gonçalo do Sapucaí/MG,1,76,0,5890
1292147,2022-08-19,São Gonçalo do Sapucaí/MG,0,76,0,5890
1297744,2022-08-20,São Gonçalo do Sapucaí/MG,0,76,0,5890
1303341,2022-08-21,São Gonçalo do Sapucaí/MG,0,76,0,5890
1308938,2022-08-22,São Gonçalo do Sapucaí/MG,0,76,0,5890
1314535,2022-08-23,São Gonçalo do Sapucaí/MG,0,76,0,5890
1320132,2022-08-24,São Gonçalo do Sapucaí/MG,0,76,0,5890
1325729,2022-08-25,São Gonçalo do Sapucaí/MG,0,76,0,5890
4970,2022-01-01,São Lourenço/MG,0,157,24,6344
10567,2022-01-02,São Lourenço/MG,0,157,0,6344
16164,2022-01-03,São Lourenço/MG,0,157,0,6344
21761,2022-01-04,São Lourenço/MG,0,157,0,6344
27358,2022-01-05,São Lourenço/MG,0,157,27,6371
32955,2022-01-06,São Lourenço/MG,0,157,39,6410
38552,2022-01-07,São Lourenço/MG,1,158,29,6439
44149,2022-01-08,São Lourenço/MG,0,158,40,6479
49746,2022-01-09,São Lourenço/MG,0,158,0,6479
55343,2022-01-10,São Lourenço/MG,0,158,80,6559
60940,2022-01-11,São Lourenço/MG,0,158,0,6559
66537,2022-01-12,São Lourenço/MG,0,158,52,6611
72134,2022-01-13,São Lourenço/MG,0,158,53,6664
77731,2022-01-14,São Lourenço/MG,0,158,94,6758
83328,2022-01-15,São Lourenço/MG,0,158,0,6758
88925,2022-01-16,São Lourenço/MG,0,158,0,6758
94522,2022-01-17,São Lourenço/MG,0,158,56,6814
100119,2022-01-18,São Lourenço/MG,0,158,200,7014
105716,2022-01-19,São Lourenço/MG,0,158,89,7103
111313,2022-01-20,São Lourenço/MG,1,159,99,7202
116910,2022-01-21,São Lourenço/MG,0,159,98,7300
122507,2022-01-22,São Lourenço/MG,0,159,124,7424
128104,2022-01-23,São Lourenço/MG,0,159,136,7560
133701,2022-01-24,São Lourenço/MG,0,159,0,7560
139298,2022-01-25,São Lourenço/MG,0,159,258,7818
144895,2022-01-26,São Lourenço/MG,3,162,0,7818
150492,2022-01-27,São Lourenço/MG,0,162,222,8040
156089,2022-01-28,São Lourenço/MG,0,162,149,8189
161686,2022-01-29,São Lourenço/MG,2,164,117,8306
167283,2022-01-30,São Lourenço/MG,1,165,113,8419
172880,2022-01-31,São Lourenço/MG,0,165,0,8419
178477,2022-02-01,São Lourenço/MG,0,165,96,8515
184074,2022-02-02,São Lourenço/MG,-1,164,68,8583
189671,2022-02-03,São Lourenço/MG,0,164,88,8671
195268,2022-02-04,São Lourenço/MG,0,164,81,8752
200865,2022-02-05,São Lourenço/MG,0,164,0,8752
206462,2022-02-06,São Lourenço/MG,0,164,185,8937
212059,2022-02-07,São Lourenço/MG,0,164,0,8937
217656,2022-02-08,São Lourenço/MG,0,164,92,9029
223253,2022-02-09,São Lourenço/MG,0,164,0,9029
228850,2022-02-10,São Lourenço/MG,0,164,83,9112
234447,2022-02-11,São Lourenço/MG,1,165,45,9157
240044,2022-02-12,São Lourenço/MG,0,165,46,9203
245641,2022-02-13,São Lourenço/MG,0,165,41,9244
251238,2022-02-14,São Lourenço/MG,-3,162,0,9244
256835,2022-02-15,São Lourenço/MG,0,162,0,9244
262432,2022-02-16,São Lourenço/MG,-1,161,120,9364
268029,2022-02-17,São Lourenço/MG,2,163,48,9412
273626,2022-02-18,São Lourenço/MG,0,163,16,9428
279223,2022-02-19,São Lourenço/MG,0,163,0,9428
284820,2022-02-20,São Lourenço/MG,1,164,81,9509
290417,2022-02-21,São Lourenço/MG,0,164,0,9509
296014,2022-02-22,São Lourenço/MG,0,164,0,9509
301611,2022-02-23,São Lourenço/MG,2,166,64,9573
307208,2022-02-24,São Lourenço/MG,2,168,55,9628
312805,2022-02-25,São Lourenço/MG,0,168,32,9660
318402,2022-02-26,São Lourenço/MG,1,169,23,9683
323999,2022-02-27,São Lourenço/MG,1,170,70,9753
329596,2022-02-28,São Lourenço/MG,0,170,0,9753
335193,2022-03-01,São Lourenço/MG,0,170,0,9753
340790,2022-03-02,São Lourenço/MG,0,170,0,9753
346387,2022-03-03,São Lourenço/MG,0,170,0,9753
351984,2022-03-04,São Lourenço/MG,0,170,75,9828
357581,2022-03-05,São Lourenço/MG,0,170,14,9842
363178,2022-03-06,São Lourenço/MG,0,170,21,9863
368775,2022-03-07,São Lourenço/MG,0,170,0,9863
374372,2022-03-08,São Lourenço/MG,0,170,0,9863
379969,2022-03-09,São Lourenço/MG,0,170,44,9907
385566,2022-03-10,São Lourenço/MG,0,170,25,9932
391163,2022-03-11,São Lourenço/MG,0,170,13,9945
396760,2022-03-12,São Lourenço/MG,0,170,18,9963
402357,2022-03-13,São Lourenço/MG,0,170,26,9989
407954,2022-03-14,São Lourenço/MG,0,170,0,9989
413551,2022-03-15,São Lourenço/MG,0,170,1,9990
419148,2022-03-16,São Lourenço/MG,0,170,27,10017
424745,2022-03-17,São Lourenço/MG,0,170,5,10022
430342,2022-03-18,São Lourenço/MG,0,170,0,10022
435939,2022-03-19,São Lourenço/MG,0,170,0,10022
441536,2022-03-20,São Lourenço/MG,0,170,29,10051
447133,2022-03-21,São Lourenço/MG,0,170,0,10051
452730,2022-03-22,São Lourenço/MG,0,170,0,10051
458327,2022-03-23,São Lourenço/MG,0,170,22,10073
463924,2022-03-24,São Lourenço/MG,0,170,0,10073
469521,2022-03-25,São Lourenço/MG,0,170,11,10084
475118,2022-03-26,São Lourenço/MG,0,170,12,10096
480715,2022-03-27,São Lourenço/MG,0,170,9,10105
486312,2022-03-28,São Lourenço/MG,0,170,0,10105
491909,2022-03-29,São Lourenço/MG,0,170,0,10105
497506,2022-03-30,São Lourenço/MG,0,170,18,10123
503103,2022-03-31,São Lourenço/MG,0,170,4,10127
508700,2022-04-01,São Lourenço/MG,0,170,0,10127
514297,2022-04-02,São Lourenço/MG,0,170,0,10127
519894,2022-04-03,São Lourenço/MG,0,170,0,10127
525491,2022-04-04,São Lourenço/MG,0,170,22,10149
531088,2022-04-05,São Lourenço/MG,0,170,0,10149
536685,2022-04-06,São Lourenço/MG,0,170,9,10158
542282,2022-04-07,São Lourenço/MG,0,170,3,10161
547879,2022-04-08,São Lourenço/MG,0,170,6,10167
553476,2022-04-09,São Lourenço/MG,0,170,2,10169
559073,2022-04-10,São Lourenço/MG,0,170,3,10172
564670,2022-04-11,São Lourenço/MG,0,170,0,10172
570267,2022-04-12,São Lourenço/MG,0,170,0,10172
575864,2022-04-13,São Lourenço/MG,0,170,9,10181
581461,2022-04-14,São Lourenço/MG,0,170,22,10203
587058,2022-04-15,São Lourenço/MG,0,170,0,10203
592655,2022-04-16,São Lourenço/MG,0,170,1,10204
598252,2022-04-17,São Lourenço/MG,0,170,0,10204
603849,2022-04-18,São Lourenço/MG,0,170,0,10204
609446,2022-04-19,São Lourenço/MG,0,170,0,10204
615043,2022-04-20,São Lourenço/MG,0,170,20,10224
620640,2022-04-21,São Lourenço/MG,-2,168,1,10225
626237,2022-04-22,São Lourenço/MG,0,168,0,10225
631834,2022-04-23,São Lourenço/MG,0,168,3,10228
637431,2022-04-24,São Lourenço/MG,0,168,0,10228
643028,2022-04-25,São Lourenço/MG,0,168,0,10228
648625,2022-04-26,São Lourenço/MG,0,168,0,10228
654222,2022-04-27,São Lourenço/MG,0,168,7,10235
659819,2022-04-28,São Lourenço/MG,0,168,4,10239
665416,2022-04-29,São Lourenço/MG,0,168,3,10242
671013,2022-04-30,São Lourenço/MG,0,168,5,10247
676610,2022-05-01,São Lourenço/MG,0,168,10,10257
682207,2022-05-02,São Lourenço/MG,0,168,0,10257
687804,2022-05-03,São Lourenço/MG,0,168,0,10257
693401,2022-05-04,São Lourenço/MG,0,168,11,10268
698998,2022-05-05,São Lourenço/MG,0,168,0,10268
704595,2022-05-06,São Lourenço/MG,0,168,1,10269
710192,2022-05-07,São Lourenço/MG,0,168,0,10269
715789,2022-05-08,São Lourenço/MG,0,168,0,10269
721386,2022-05-09,São Lourenço/MG,0,168,3,10272
726983,2022-05-10,São Lourenço/MG,0,168,0,10272
732580,2022-05-11,São Lourenço/MG,1,169,13,10285
738177,2022-05-12,São Lourenço/MG,0,169,6,10291
743774,2022-05-13,São Lourenço/MG,0,169,0,10291
749371,2022-05-14,São Lourenço/MG,0,169,0,10291
754968,2022-05-15,São Lourenço/MG,0,169,0,10291
760565,2022-05-16,São Lourenço/MG,-1,168,4,10295
766162,2022-05-17,São Lourenço/MG,0,168,0,10295
771759,2022-05-18,São Lourenço/MG,0,168,8,10303
777356,2022-05-19,São Lourenço/MG,0,168,12,10315
782953,2022-05-20,São Lourenço/MG,0,168,21,10336
788550,2022-05-21,São Lourenço/MG,0,168,0,10336
794147,2022-05-22,São Lourenço/MG,0,168,0,10336
799744,2022-05-23,São Lourenço/MG,1,169,25,10361
805341,2022-05-24,São Lourenço/MG,0,169,0,10361
810938,2022-05-25,São Lourenço/MG,0,169,12,10373
816535,2022-05-26,São Lourenço/MG,0,169,0,10373
822132,2022-05-27,São Lourenço/MG,0,169,41,10414
827729,2022-05-28,São Lourenço/MG,0,169,0,10414
833326,2022-05-29,São Lourenço/MG,0,169,0,10414
838923,2022-05-30,São Lourenço/MG,0,169,41,10455
844520,2022-05-31,São Lourenço/MG,0,169,0,10455
850117,2022-06-01,São Lourenço/MG,0,169,34,10489
855714,2022-06-02,São Lourenço/MG,0,169,0,10489
861311,2022-06-03,São Lourenço/MG,0,169,55,10544
866908,2022-06-04,São Lourenço/MG,0,169,0,10544
872505,2022-06-05,São Lourenço/MG,0,169,0,10544
878102,2022-06-06,São Lourenço/MG,0,169,91,10635
883699,2022-06-07,São Lourenço/MG,0,169,0,10635
889296,2022-06-08,São Lourenço/MG,0,169,59,10694
894893,2022-06-09,São Lourenço/MG,0,169,40,10734
900490,2022-06-10,São Lourenço/MG,0,169,32,10766
906087,2022-06-11,São Lourenço/MG,0,169,0,10766
911684,2022-06-12,São Lourenço/MG,0,169,0,10766
917281,2022-06-13,São Lourenço/MG,0,169,81,10847
922878,2022-06-14,São Lourenço/MG,0,169,0,10847
928475,2022-06-15,São Lourenço/MG,0,169,53,10900
934072,2022-06-16,São Lourenço/MG,0,169,0,10900
939669,2022-06-17,São Lourenço/MG,0,169,0,10900
945266,2022-06-18,São Lourenço/MG,0,169,0,10900
950863,2022-06-19,São Lourenço/MG,0,169,0,10900
956460,2022-06-20,São Lourenço/MG,0,169,105,11005
962057,2022-06-21,São Lourenço/MG,0,169,0,11005
967654,2022-06-22,São Lourenço/MG,0,169,0,11005
973251,2022-06-23,São Lourenço/MG,0,169,211,11216
978848,2022-06-24,São Lourenço/MG,0,169,60,11276
984445,2022-06-25,São Lourenço/MG,0,169,0,11276
990042,2022-06-26,São Lourenço/MG,0,169,0,11276
995639,2022-06-27,São Lourenço/MG,0,169,72,11348
1001236,2022-06-28,São Lourenço/MG,0,169,0,11348
1006833,2022-06-29,São Lourenço/MG,0,169,187,11535
1012430,2022-06-30,São Lourenço/MG,0,169,59,11594
1018027,2022-07-01,São Lourenço/MG,0,169,99,11693
1023624,2022-07-02,São Lourenço/MG,0,169,0,11693
1029221,2022-07-03,São Lourenço/MG,0,169,0,11693
1034818,2022-07-04,São Lourenço/MG,0,169,81,11774
1040415,2022-07-05,São Lourenço/MG,0,169,69,11843
1046012,2022-07-06,São Lourenço/MG,0,169,96,11939
1051609,2022-07-07,São Lourenço/MG,2,171,0,11939
1057206,2022-07-08,São Lourenço/MG,0,171,110,12049
1062803,2022-07-09,São Lourenço/MG,0,171,0,12049
1068400,2022-07-10,São Lourenço/MG,0,171,0,12049
1073997,2022-07-11,São Lourenço/MG,0,171,76,12125
1079594,2022-07-12,São Lourenço/MG,0,171,0,12125
1085191,2022-07-13,São Lourenço/MG,0,171,0,12125
1090788,2022-07-14,São Lourenço/MG,0,171,114,12239
1096385,2022-07-15,São Lourenço/MG,0,171,33,12272
1101982,2022-07-16,São Lourenço/MG,0,171,0,12272
1107579,2022-07-17,São Lourenço/MG,0,171,0,12272
1113176,2022-07-18,São Lourenço/MG,0,171,45,12317
1118773,2022-07-19,São Lourenço/MG,0,171,0,12317
1124370,2022-07-20,São Lourenço/MG,0,171,25,12342
1129967,2022-07-21,São Lourenço/MG,0,171,0,12342
1135564,2022-07-22,São Lourenço/MG,0,171,51,12393
1141161,2022-07-23,São Lourenço/MG,0,171,0,12393
1146758,2022-07-24,São Lourenço/MG,0,171,0,12393
1152355,2022-07-25,São Lourenço/MG,0,171,13,12406
1157952,2022-07-26,São Lourenço/MG,0,171,0,12406
1163549,2022-07-27,São Lourenço/MG,0,171,78,12484
1169146,2022-07-28,São Lourenço/MG,0,171,11,12495
1174743,2022-07-29,São Lourenço/MG,0,171,6,12501
1180340,2022-07-30,São Lourenço/MG,0,171,0,12501
1185937,2022-07-31,São Lourenço/MG,0,171,0,12501
1191534,2022-08-01,São Lourenço/MG,0,171,4,12505
1197131,2022-08-02,São Lourenço/MG,0,171,0,12505
1202728,2022-08-03,São Lourenço/MG,0,171,8,12513
1208325,2022-08-04,São Lourenço/MG,3,174,2,12515
1213922,2022-08-05,São Lourenço/MG,1,175,2,12517
1219519,2022-08-06,São Lourenço/MG,0,175,0,12517
1225116,2022-08-07,São Lourenço/MG,0,175,0,12517
1230713,2022-08-08,São Lourenço/MG,0,175,6,12523
1236310,2022-08-09,São Lourenço/MG,0,175,0,12523
1241907,2022-08-10,São Lourenço/MG,0,175,12,12535
1247504,2022-08-11,São Lourenço/MG,0,175,0,12535
1253101,2022-08-12,São Lourenço/MG,0,175,0,12535
1258698,2022-08-13,São Lourenço/MG,0,175,0,12535
1264295,2022-08-14,São Lourenço/MG,0,175,0,12535
1269892,2022-08-15,São Lourenço/MG,0,175,0,12535
1275489,2022-08-16,São Lourenço/MG,0,175,0,12535
1281086,2022-08-17,São Lourenço/MG,0,175,25,12560
1286683,2022-08-18,São Lourenço/MG,0,175,0,12560
1292280,2022-08-19,São Lourenço/MG,0,175,15,12575
1297877,2022-08-20,São Lourenço/MG,0,175,0,12575
1303474,2022-08-21,São Lourenço/MG,0,175,0,12575
1309071,2022-08-22,São Lourenço/MG,0,175,0,12575
1314668,2022-08-23,São Lourenço/MG,0,175,16,12591
1320265,2022-08-24,São Lourenço/MG,0,175,0,12591
1325862,2022-08-25,São Lourenço/MG,0,175,0,12591
5059,2022-01-01,São Sebastião do Paraíso/MG,0,281,14,7351
10656,2022-01-02,São Sebastião do Paraíso/MG,0,281,0,7351
16253,2022-01-03,São Sebastião do Paraíso/MG,0,281,19,7370
21850,2022-01-04,São Sebastião do Paraíso/MG,0,281,0,7370
27447,2022-01-05,São Sebastião do Paraíso/MG,0,281,50,7420
33044,2022-01-06,São Sebastião do Paraíso/MG,0,281,35,7455
38641,2022-01-07,São Sebastião do Paraíso/MG,0,281,26,7481
44238,2022-01-08,São Sebastião do Paraíso/MG,0,281,51,7532
49835,2022-01-09,São Sebastião do Paraíso/MG,0,281,25,7557
55432,2022-01-10,São Sebastião do Paraíso/MG,0,281,35,7592
61029,2022-01-11,São Sebastião do Paraíso/MG,0,281,0,7592
66626,2022-01-12,São Sebastião do Paraíso/MG,0,281,35,7627
72223,2022-01-13,São Sebastião do Paraíso/MG,0,281,60,7687
77820,2022-01-14,São Sebastião do Paraíso/MG,0,281,71,7758
83417,2022-01-15,São Sebastião do Paraíso/MG,0,281,84,7842
89014,2022-01-16,São Sebastião do Paraíso/MG,0,281,0,7842
94611,2022-01-17,São Sebastião do Paraíso/MG,0,281,42,7884
100208,2022-01-18,São Sebastião do Paraíso/MG,0,281,52,7936
105805,2022-01-19,São Sebastião do Paraíso/MG,0,281,90,8026
111402,2022-01-20,São Sebastião do Paraíso/MG,0,281,78,8104
116999,2022-01-21,São Sebastião do Paraíso/MG,0,281,131,8235
122596,2022-01-22,São Sebastião do Paraíso/MG,0,281,0,8235
128193,2022-01-23,São Sebastião do Paraíso/MG,0,281,389,8624
133790,2022-01-24,São Sebastião do Paraíso/MG,0,281,0,8624
139387,2022-01-25,São Sebastião do Paraíso/MG,0,281,40,8664
144984,2022-01-26,São Sebastião do Paraíso/MG,0,281,127,8791
150581,2022-01-27,São Sebastião do Paraíso/MG,0,281,285,9076
156178,2022-01-28,São Sebastião do Paraíso/MG,0,281,103,9179
161775,2022-01-29,São Sebastião do Paraíso/MG,0,281,214,9393
167372,2022-01-30,São Sebastião do Paraíso/MG,0,281,201,9594
172969,2022-01-31,São Sebastião do Paraíso/MG,0,281,56,9650
178566,2022-02-01,São Sebastião do Paraíso/MG,0,281,0,9650
184163,2022-02-02,São Sebastião do Paraíso/MG,0,281,0,9650
189760,2022-02-03,São Sebastião do Paraíso/MG,0,281,234,9884
195357,2022-02-04,São Sebastião do Paraíso/MG,0,281,151,10035
200954,2022-02-05,São Sebastião do Paraíso/MG,0,281,51,10086
206551,2022-02-06,São Sebastião do Paraíso/MG,6,287,180,10266
212148,2022-02-07,São Sebastião do Paraíso/MG,0,287,0,10266
217745,2022-02-08,São Sebastião do Paraíso/MG,0,287,44,10310
223342,2022-02-09,São Sebastião do Paraíso/MG,0,287,94,10404
228939,2022-02-10,São Sebastião do Paraíso/MG,2,289,101,10505
234536,2022-02-11,São Sebastião do Paraíso/MG,1,290,45,10550
240133,2022-02-12,São Sebastião do Paraíso/MG,3,293,95,10645
245730,2022-02-13,São Sebastião do Paraíso/MG,1,294,56,10701
251327,2022-02-14,São Sebastião do Paraíso/MG,0,294,24,10725
256924,2022-02-15,São Sebastião do Paraíso/MG,0,294,0,10725
262521,2022-02-16,São Sebastião do Paraíso/MG,5,299,52,10777
268118,2022-02-17,São Sebastião do Paraíso/MG,0,299,48,10825
273715,2022-02-18,São Sebastião do Paraíso/MG,1,300,43,10868
279312,2022-02-19,São Sebastião do Paraíso/MG,0,300,37,10905
284909,2022-02-20,São Sebastião do Paraíso/MG,4,304,35,10940
290506,2022-02-21,São Sebastião do Paraíso/MG,0,304,6,10946
296103,2022-02-22,São Sebastião do Paraíso/MG,0,304,0,10946
301700,2022-02-23,São Sebastião do Paraíso/MG,0,304,51,10997
307297,2022-02-24,São Sebastião do Paraíso/MG,0,304,27,11024
312894,2022-02-25,São Sebastião do Paraíso/MG,0,304,40,11064
318491,2022-02-26,São Sebastião do Paraíso/MG,2,306,15,11079
324088,2022-02-27,São Sebastião do Paraíso/MG,0,306,23,11102
329685,2022-02-28,São Sebastião do Paraíso/MG,0,306,3,11105
335282,2022-03-01,São Sebastião do Paraíso/MG,0,306,0,11105
340879,2022-03-02,São Sebastião do Paraíso/MG,0,306,0,11105
346476,2022-03-03,São Sebastião do Paraíso/MG,0,306,2,11107
352073,2022-03-04,São Sebastião do Paraíso/MG,0,306,16,11123
357670,2022-03-05,São Sebastião do Paraíso/MG,0,306,14,11137
363267,2022-03-06,São Sebastião do Paraíso/MG,1,307,7,11144
368864,2022-03-07,São Sebastião do Paraíso/MG,0,307,2,11146
374461,2022-03-08,São Sebastião do Paraíso/MG,0,307,0,11146
380058,2022-03-09,São Sebastião do Paraíso/MG,0,307,20,11166
385655,2022-03-10,São Sebastião do Paraíso/MG,1,308,8,11174
391252,2022-03-11,São Sebastião do Paraíso/MG,1,309,7,11181
396849,2022-03-12,São Sebastião do Paraíso/MG,0,309,7,11188
402446,2022-03-13,São Sebastião do Paraíso/MG,1,310,8,11196
408043,2022-03-14,São Sebastião do Paraíso/MG,0,310,2,11198
413640,2022-03-15,São Sebastião do Paraíso/MG,0,310,0,11198
419237,2022-03-16,São Sebastião do Paraíso/MG,0,310,3,11201
424834,2022-03-17,São Sebastião do Paraíso/MG,1,311,6,11207
430431,2022-03-18,São Sebastião do Paraíso/MG,1,312,4,11211
436028,2022-03-19,São Sebastião do Paraíso/MG,0,312,3,11214
441625,2022-03-20,São Sebastião do Paraíso/MG,0,312,4,11218
447222,2022-03-21,São Sebastião do Paraíso/MG,0,312,0,11218
452819,2022-03-22,São Sebastião do Paraíso/MG,0,312,0,11218
458416,2022-03-23,São Sebastião do Paraíso/MG,0,312,0,11218
464013,2022-03-24,São Sebastião do Paraíso/MG,0,312,3,11221
469610,2022-03-25,São Sebastião do Paraíso/MG,0,312,4,11225
475207,2022-03-26,São Sebastião do Paraíso/MG,0,312,8,11233
480804,2022-03-27,São Sebastião do Paraíso/MG,0,312,7,11240
486401,2022-03-28,São Sebastião do Paraíso/MG,0,312,1,11241
491998,2022-03-29,São Sebastião do Paraíso/MG,0,312,0,11241
497595,2022-03-30,São Sebastião do Paraíso/MG,0,312,5,11246
503192,2022-03-31,São Sebastião do Paraíso/MG,0,312,6,11252
508789,2022-04-01,São Sebastião do Paraíso/MG,0,312,4,11256
514386,2022-04-02,São Sebastião do Paraíso/MG,0,312,0,11256
519983,2022-04-03,São Sebastião do Paraíso/MG,0,312,0,11256
525580,2022-04-04,São Sebastião do Paraíso/MG,1,313,10,11266
531177,2022-04-05,São Sebastião do Paraíso/MG,0,313,0,11266
536774,2022-04-06,São Sebastião do Paraíso/MG,0,313,4,11270
542371,2022-04-07,São Sebastião do Paraíso/MG,0,313,6,11276
547968,2022-04-08,São Sebastião do Paraíso/MG,0,313,5,11281
553565,2022-04-09,São Sebastião do Paraíso/MG,0,313,6,11287
559162,2022-04-10,São Sebastião do Paraíso/MG,0,313,2,11289
564759,2022-04-11,São Sebastião do Paraíso/MG,0,313,1,11290
570356,2022-04-12,São Sebastião do Paraíso/MG,0,313,0,11290
575953,2022-04-13,São Sebastião do Paraíso/MG,0,313,2,11292
581550,2022-04-14,São Sebastião do Paraíso/MG,0,313,3,11295
587147,2022-04-15,São Sebastião do Paraíso/MG,0,313,1,11296
592744,2022-04-16,São Sebastião do Paraíso/MG,0,313,2,11298
598341,2022-04-17,São Sebastião do Paraíso/MG,0,313,0,11298
603938,2022-04-18,São Sebastião do Paraíso/MG,0,313,0,11298
609535,2022-04-19,São Sebastião do Paraíso/MG,0,313,0,11298
615132,2022-04-20,São Sebastião do Paraíso/MG,0,313,3,11301
620729,2022-04-21,São Sebastião do Paraíso/MG,0,313,4,11305
626326,2022-04-22,São Sebastião do Paraíso/MG,0,313,3,11308
631923,2022-04-23,São Sebastião do Paraíso/MG,0,313,0,11308
637520,2022-04-24,São Sebastião do Paraíso/MG,0,313,0,11308
643117,2022-04-25,São Sebastião do Paraíso/MG,0,313,0,11308
648714,2022-04-26,São Sebastião do Paraíso/MG,0,313,0,11308
654311,2022-04-27,São Sebastião do Paraíso/MG,0,313,2,11310
659908,2022-04-28,São Sebastião do Paraíso/MG,0,313,1,11311
665505,2022-04-29,São Sebastião do Paraíso/MG,0,313,6,11317
671102,2022-04-30,São Sebastião do Paraíso/MG,0,313,5,11322
676699,2022-05-01,São Sebastião do Paraíso/MG,0,313,6,11328
682296,2022-05-02,São Sebastião do Paraíso/MG,0,313,1,11329
687893,2022-05-03,São Sebastião do Paraíso/MG,0,313,0,11329
693490,2022-05-04,São Sebastião do Paraíso/MG,0,313,2,11331
699087,2022-05-05,São Sebastião do Paraíso/MG,0,313,2,11333
704684,2022-05-06,São Sebastião do Paraíso/MG,0,313,4,11337
710281,2022-05-07,São Sebastião do Paraíso/MG,0,313,0,11337
715878,2022-05-08,São Sebastião do Paraíso/MG,0,313,0,11337
721475,2022-05-09,São Sebastião do Paraíso/MG,0,313,8,11345
727072,2022-05-10,São Sebastião do Paraíso/MG,0,313,0,11345
732669,2022-05-11,São Sebastião do Paraíso/MG,0,313,1,11346
738266,2022-05-12,São Sebastião do Paraíso/MG,0,313,7,11353
743863,2022-05-13,São Sebastião do Paraíso/MG,0,313,7,11360
749460,2022-05-14,São Sebastião do Paraíso/MG,0,313,0,11360
755057,2022-05-15,São Sebastião do Paraíso/MG,0,313,0,11360
760654,2022-05-16,São Sebastião do Paraíso/MG,0,313,23,11383
766251,2022-05-17,São Sebastião do Paraíso/MG,0,313,3,11386
771848,2022-05-18,São Sebastião do Paraíso/MG,0,313,0,11386
777445,2022-05-19,São Sebastião do Paraíso/MG,0,313,0,11386
783042,2022-05-20,São Sebastião do Paraíso/MG,0,313,38,11424
788639,2022-05-21,São Sebastião do Paraíso/MG,0,313,0,11424
794236,2022-05-22,São Sebastião do Paraíso/MG,0,313,0,11424
799833,2022-05-23,São Sebastião do Paraíso/MG,0,313,19,11443
805430,2022-05-24,São Sebastião do Paraíso/MG,0,313,3,11446
811027,2022-05-25,São Sebastião do Paraíso/MG,0,313,17,11463
816624,2022-05-26,São Sebastião do Paraíso/MG,0,313,34,11497
822221,2022-05-27,São Sebastião do Paraíso/MG,0,313,30,11527
827818,2022-05-28,São Sebastião do Paraíso/MG,0,313,0,11527
833415,2022-05-29,São Sebastião do Paraíso/MG,0,313,0,11527
839012,2022-05-30,São Sebastião do Paraíso/MG,0,313,52,11579
844609,2022-05-31,São Sebastião do Paraíso/MG,0,313,55,11634
850206,2022-06-01,São Sebastião do Paraíso/MG,0,313,64,11698
855803,2022-06-02,São Sebastião do Paraíso/MG,0,313,93,11791
861400,2022-06-03,São Sebastião do Paraíso/MG,0,313,68,11859
866997,2022-06-04,São Sebastião do Paraíso/MG,0,313,0,11859
872594,2022-06-05,São Sebastião do Paraíso/MG,0,313,0,11859
878191,2022-06-06,São Sebastião do Paraíso/MG,0,313,153,12012
883788,2022-06-07,São Sebastião do Paraíso/MG,0,313,53,12065
889385,2022-06-08,São Sebastião do Paraíso/MG,0,313,58,12123
894982,2022-06-09,São Sebastião do Paraíso/MG,0,313,92,12215
900579,2022-06-10,São Sebastião do Paraíso/MG,0,313,69,12284
906176,2022-06-11,São Sebastião do Paraíso/MG,0,313,0,12284
911773,2022-06-12,São Sebastião do Paraíso/MG,0,313,0,12284
917370,2022-06-13,São Sebastião do Paraíso/MG,0,313,142,12426
922967,2022-06-14,São Sebastião do Paraíso/MG,0,313,0,12426
928564,2022-06-15,São Sebastião do Paraíso/MG,3,316,91,12517
934161,2022-06-16,São Sebastião do Paraíso/MG,0,316,0,12517
939758,2022-06-17,São Sebastião do Paraíso/MG,0,316,0,12517
945355,2022-06-18,São Sebastião do Paraíso/MG,0,316,0,12517
950952,2022-06-19,São Sebastião do Paraíso/MG,0,316,0,12517
956549,2022-06-20,São Sebastião do Paraíso/MG,0,316,167,12684
962146,2022-06-21,São Sebastião do Paraíso/MG,0,316,0,12684
967743,2022-06-22,São Sebastião do Paraíso/MG,0,316,62,12746
973340,2022-06-23,São Sebastião do Paraíso/MG,0,316,86,12832
978937,2022-06-24,São Sebastião do Paraíso/MG,1,317,54,12886
984534,2022-06-25,São Sebastião do Paraíso/MG,0,317,0,12886
990131,2022-06-26,São Sebastião do Paraíso/MG,0,317,0,12886
995728,2022-06-27,São Sebastião do Paraíso/MG,0,317,107,12993
1001325,2022-06-28,São Sebastião do Paraíso/MG,0,317,0,12993
1006922,2022-06-29,São Sebastião do Paraíso/MG,0,317,0,12993
1012519,2022-06-30,São Sebastião do Paraíso/MG,0,317,112,13105
1018116,2022-07-01,São Sebastião do Paraíso/MG,0,317,92,13197
1023713,2022-07-02,São Sebastião do Paraíso/MG,0,317,0,13197
1029310,2022-07-03,São Sebastião do Paraíso/MG,0,317,0,13197
1034907,2022-07-04,São Sebastião do Paraíso/MG,1,318,67,13264
1040504,2022-07-05,São Sebastião do Paraíso/MG,0,318,0,13264
1046101,2022-07-06,São Sebastião do Paraíso/MG,0,318,74,13338
1051698,2022-07-07,São Sebastião do Paraíso/MG,0,318,41,13379
1057295,2022-07-08,São Sebastião do Paraíso/MG,0,318,36,13415
1062892,2022-07-09,São Sebastião do Paraíso/MG,0,318,0,13415
1068489,2022-07-10,São Sebastião do Paraíso/MG,0,318,0,13415
1074086,2022-07-11,São Sebastião do Paraíso/MG,0,318,53,13468
1079683,2022-07-12,São Sebastião do Paraíso/MG,0,318,9,13477
1085280,2022-07-13,São Sebastião do Paraíso/MG,0,318,61,13538
1090877,2022-07-14,São Sebastião do Paraíso/MG,0,318,9,13547
1096474,2022-07-15,São Sebastião do Paraíso/MG,0,318,16,13563
1102071,2022-07-16,São Sebastião do Paraíso/MG,0,318,0,13563
1107668,2022-07-17,São Sebastião do Paraíso/MG,0,318,0,13563
1113265,2022-07-18,São Sebastião do Paraíso/MG,0,318,51,13614
1118862,2022-07-19,São Sebastião do Paraíso/MG,0,318,0,13614
1124459,2022-07-20,São Sebastião do Paraíso/MG,0,318,27,13641
1130056,2022-07-21,São Sebastião do Paraíso/MG,0,318,20,13661
1135653,2022-07-22,São Sebastião do Paraíso/MG,0,318,20,13681
1141250,2022-07-23,São Sebastião do Paraíso/MG,0,318,0,13681
1146847,2022-07-24,São Sebastião do Paraíso/MG,0,318,0,13681
1152444,2022-07-25,São Sebastião do Paraíso/MG,0,318,24,13705
1158041,2022-07-26,São Sebastião do Paraíso/MG,0,318,3,13708
1163638,2022-07-27,São Sebastião do Paraíso/MG,0,318,13,13721
1169235,2022-07-28,São Sebastião do Paraíso/MG,0,318,9,13730
1174832,2022-07-29,São Sebastião do Paraíso/MG,0,318,14,13744
1180429,2022-07-30,São Sebastião do Paraíso/MG,0,318,0,13744
1186026,2022-07-31,São Sebastião do Paraíso/MG,0,318,0,13744
1191623,2022-08-01,São Sebastião do Paraíso/MG,0,318,31,13775
1197220,2022-08-02,São Sebastião do Paraíso/MG,1,319,0,13775
1202817,2022-08-03,São Sebastião do Paraíso/MG,0,319,8,13783
1208414,2022-08-04,São Sebastião do Paraíso/MG,0,319,12,13795
1214011,2022-08-05,São Sebastião do Paraíso/MG,0,319,6,13801
1219608,2022-08-06,São Sebastião do Paraíso/MG,0,319,0,13801
1225205,2022-08-07,São Sebastião do Paraíso/MG,0,319,0,13801
1230802,2022-08-08,São Sebastião do Paraíso/MG,0,319,17,13818
1236399,2022-08-09,São Sebastião do Paraíso/MG,0,319,0,13818
1241996,2022-08-10,São Sebastião do Paraíso/MG,0,319,20,13838
1247593,2022-08-11,São Sebastião do Paraíso/MG,0,319,0,13838
1253190,2022-08-12,São Sebastião do Paraíso/MG,0,319,3,13841
1258787,2022-08-13,São Sebastião do Paraíso/MG,0,319,0,13841
1264384,2022-08-14,São Sebastião do Paraíso/MG,0,319,0,13841
1269981,2022-08-15,São Sebastião do Paraíso/MG,0,319,0,13841
1275578,2022-08-16,São Sebastião do Paraíso/MG,0,319,6,13847
1281175,2022-08-17,São Sebastião do Paraíso/MG,2,321,8,13855
1286772,2022-08-18,São Sebastião do Paraíso/MG,0,321,0,13855
1292369,2022-08-19,São Sebastião do Paraíso/MG,0,321,3,13858
1297966,2022-08-20,São Sebastião do Paraíso/MG,0,321,0,13858
1303563,2022-08-21,São Sebastião do Paraíso/MG,0,321,0,13858
1309160,2022-08-22,São Sebastião do Paraíso/MG,0,321,2,13860
1314757,2022-08-23,São Sebastião do Paraíso/MG,0,321,0,13860
1320354,2022-08-24,São Sebastião do Paraíso/MG,0,321,8,13868
1325951,2022-08-25,São Sebastião do Paraíso/MG,0,321,5,13873
4657,2022-01-01,Serrania/MG,0,23,0,783
10254,2022-01-02,Serrania/MG,0,23,0,783
15851,2022-01-03,Serrania/MG,0,23,3,786
21448,2022-01-04,Serrania/MG,0,23,0,786
27045,2022-01-05,Serrania/MG,0,23,1,787
32642,2022-01-06,Serrania/MG,0,23,0,787
38239,2022-01-07,Serrania/MG,0,23,0,787
43836,2022-01-08,Serrania/MG,0,23,22,809
49433,2022-01-09,Serrania/MG,0,23,0,809
55030,2022-01-10,Serrania/MG,0,23,14,823
60627,2022-01-11,Serrania/MG,0,23,0,823
66224,2022-01-12,Serrania/MG,0,23,0,823
71821,2022-01-13,Serrania/MG,0,23,30,853
77418,2022-01-14,Serrania/MG,0,23,0,853
83015,2022-01-15,Serrania/MG,0,23,11,864
88612,2022-01-16,Serrania/MG,0,23,0,864
94209,2022-01-17,Serrania/MG,0,23,9,873
99806,2022-01-18,Serrania/MG,0,23,0,873
105403,2022-01-19,Serrania/MG,0,23,0,873
111000,2022-01-20,Serrania/MG,0,23,12,885
116597,2022-01-21,Serrania/MG,0,23,0,885
122194,2022-01-22,Serrania/MG,0,23,0,885
127791,2022-01-23,Serrania/MG,0,23,0,885
133388,2022-01-24,Serrania/MG,0,23,0,885
138985,2022-01-25,Serrania/MG,0,23,18,903
144582,2022-01-26,Serrania/MG,0,23,5,908
150179,2022-01-27,Serrania/MG,0,23,18,926
155776,2022-01-28,Serrania/MG,0,23,9,935
161373,2022-01-29,Serrania/MG,0,23,0,935
166970,2022-01-30,Serrania/MG,0,23,0,935
172567,2022-01-31,Serrania/MG,0,23,0,935
178164,2022-02-01,Serrania/MG,0,23,24,959
183761,2022-02-02,Serrania/MG,0,23,17,976
189358,2022-02-03,Serrania/MG,0,23,10,986
194955,2022-02-04,Serrania/MG,0,23,0,986
200552,2022-02-05,Serrania/MG,0,23,0,986
206149,2022-02-06,Serrania/MG,0,23,0,986
211746,2022-02-07,Serrania/MG,0,23,0,986
217343,2022-02-08,Serrania/MG,0,23,0,986
222940,2022-02-09,Serrania/MG,0,23,62,1048
228537,2022-02-10,Serrania/MG,0,23,0,1048
234134,2022-02-11,Serrania/MG,0,23,26,1074
239731,2022-02-12,Serrania/MG,0,23,17,1091
245328,2022-02-13,Serrania/MG,0,23,0,1091
250925,2022-02-14,Serrania/MG,0,23,0,1091
256522,2022-02-15,Serrania/MG,0,23,15,1106
262119,2022-02-16,Serrania/MG,0,23,0,1106
267716,2022-02-17,Serrania/MG,0,23,19,1125
273313,2022-02-18,Serrania/MG,0,23,0,1125
278910,2022-02-19,Serrania/MG,0,23,27,1152
284507,2022-02-20,Serrania/MG,0,23,0,1152
290104,2022-02-21,Serrania/MG,0,23,0,1152
295701,2022-02-22,Serrania/MG,0,23,19,1171
301298,2022-02-23,Serrania/MG,0,23,0,1171
306895,2022-02-24,Serrania/MG,0,23,16,1187
312492,2022-02-25,Serrania/MG,0,23,4,1191
318089,2022-02-26,Serrania/MG,0,23,5,1196
323686,2022-02-27,Serrania/MG,0,23,0,1196
329283,2022-02-28,Serrania/MG,0,23,0,1196
334880,2022-03-01,Serrania/MG,0,23,0,1196
340477,2022-03-02,Serrania/MG,0,23,0,1196
346074,2022-03-03,Serrania/MG,0,23,14,1210
351671,2022-03-04,Serrania/MG,0,23,0,1210
357268,2022-03-05,Serrania/MG,0,23,12,1222
362865,2022-03-06,Serrania/MG,0,23,0,1222
368462,2022-03-07,Serrania/MG,0,23,0,1222
374059,2022-03-08,Serrania/MG,0,23,0,1222
379656,2022-03-09,Serrania/MG,3,26,8,1230
385253,2022-03-10,Serrania/MG,0,26,0,1230
390850,2022-03-11,Serrania/MG,0,26,0,1230
396447,2022-03-12,Serrania/MG,0,26,0,1230
402044,2022-03-13,Serrania/MG,0,26,0,1230
407641,2022-03-14,Serrania/MG,0,26,0,1230
413238,2022-03-15,Serrania/MG,0,26,2,1232
418835,2022-03-16,Serrania/MG,0,26,0,1232
424432,2022-03-17,Serrania/MG,0,26,0,1232
430029,2022-03-18,Serrania/MG,0,26,0,1232
435626,2022-03-19,Serrania/MG,0,26,0,1232
441223,2022-03-20,Serrania/MG,0,26,0,1232
446820,2022-03-21,Serrania/MG,0,26,0,1232
452417,2022-03-22,Serrania/MG,0,26,0,1232
458014,2022-03-23,Serrania/MG,0,26,0,1232
463611,2022-03-24,Serrania/MG,0,26,0,1232
469208,2022-03-25,Serrania/MG,0,26,0,1232
474805,2022-03-26,Serrania/MG,0,26,0,1232
480402,2022-03-27,Serrania/MG,0,26,0,1232
485999,2022-03-28,Serrania/MG,0,26,0,1232
491596,2022-03-29,Serrania/MG,0,26,3,1235
497193,2022-03-30,Serrania/MG,0,26,0,1235
502790,2022-03-31,Serrania/MG,0,26,0,1235
508387,2022-04-01,Serrania/MG,0,26,0,1235
513984,2022-04-02,Serrania/MG,0,26,0,1235
519581,2022-04-03,Serrania/MG,0,26,0,1235
525178,2022-04-04,Serrania/MG,0,26,0,1235
530775,2022-04-05,Serrania/MG,0,26,0,1235
536372,2022-04-06,Serrania/MG,0,26,0,1235
541969,2022-04-07,Serrania/MG,0,26,0,1235
547566,2022-04-08,Serrania/MG,0,26,0,1235
553163,2022-04-09,Serrania/MG,0,26,0,1235
558760,2022-04-10,Serrania/MG,0,26,0,1235
564357,2022-04-11,Serrania/MG,0,26,0,1235
569954,2022-04-12,Serrania/MG,0,26,1,1236
575551,2022-04-13,Serrania/MG,0,26,0,1236
581148,2022-04-14,Serrania/MG,0,26,0,1236
586745,2022-04-15,Serrania/MG,0,26,0,1236
592342,2022-04-16,Serrania/MG,0,26,0,1236
597939,2022-04-17,Serrania/MG,0,26,0,1236
603536,2022-04-18,Serrania/MG,0,26,0,1236
609133,2022-04-19,Serrania/MG,0,26,-1,1235
614730,2022-04-20,Serrania/MG,0,26,0,1235
620327,2022-04-21,Serrania/MG,0,26,0,1235
625924,2022-04-22,Serrania/MG,0,26,0,1235
631521,2022-04-23,Serrania/MG,0,26,0,1235
637118,2022-04-24,Serrania/MG,0,26,0,1235
642715,2022-04-25,Serrania/MG,0,26,0,1235
648312,2022-04-26,Serrania/MG,0,26,0,1235
653909,2022-04-27,Serrania/MG,0,26,0,1235
659506,2022-04-28,Serrania/MG,0,26,0,1235
665103,2022-04-29,Serrania/MG,0,26,0,1235
670700,2022-04-30,Serrania/MG,0,26,0,1235
676297,2022-05-01,Serrania/MG,0,26,0,1235
681894,2022-05-02,Serrania/MG,0,26,0,1235
687491,2022-05-03,Serrania/MG,0,26,0,1235
693088,2022-05-04,Serrania/MG,0,26,0,1235
698685,2022-05-05,Serrania/MG,0,26,0,1235
704282,2022-05-06,Serrania/MG,0,26,0,1235
709879,2022-05-07,Serrania/MG,0,26,0,1235
715476,2022-05-08,Serrania/MG,0,26,0,1235
721073,2022-05-09,Serrania/MG,0,26,0,1235
726670,2022-05-10,Serrania/MG,0,26,0,1235
732267,2022-05-11,Serrania/MG,0,26,2,1237
737864,2022-05-12,Serrania/MG,0,26,0,1237
743461,2022-05-13,Serrania/MG,0,26,0,1237
749058,2022-05-14,Serrania/MG,0,26,0,1237
754655,2022-05-15,Serrania/MG,0,26,0,1237
760252,2022-05-16,Serrania/MG,0,26,0,1237
765849,2022-05-17,Serrania/MG,0,26,9,1246
771446,2022-05-18,Serrania/MG,0,26,0,1246
777043,2022-05-19,Serrania/MG,0,26,0,1246
782640,2022-05-20,Serrania/MG,0,26,0,1246
788237,2022-05-21,Serrania/MG,0,26,0,1246
793834,2022-05-22,Serrania/MG,0,26,0,1246
799431,2022-05-23,Serrania/MG,0,26,1,1247
805028,2022-05-24,Serrania/MG,0,26,14,1261
810625,2022-05-25,Serrania/MG,0,26,0,1261
816222,2022-05-26,Serrania/MG,0,26,1,1262
821819,2022-05-27,Serrania/MG,0,26,12,1274
827416,2022-05-28,Serrania/MG,0,26,0,1274
833013,2022-05-29,Serrania/MG,0,26,0,1274
838610,2022-05-30,Serrania/MG,0,26,0,1274
844207,2022-05-31,Serrania/MG,0,26,4,1278
849804,2022-06-01,Serrania/MG,0,26,0,1278
855401,2022-06-02,Serrania/MG,0,26,0,1278
860998,2022-06-03,Serrania/MG,0,26,2,1280
866595,2022-06-04,Serrania/MG,0,26,0,1280
872192,2022-06-05,Serrania/MG,0,26,0,1280
877789,2022-06-06,Serrania/MG,0,26,10,1290
883386,2022-06-07,Serrania/MG,0,26,0,1290
888983,2022-06-08,Serrania/MG,0,26,5,1295
894580,2022-06-09,Serrania/MG,0,26,0,1295
900177,2022-06-10,Serrania/MG,0,26,7,1302
905774,2022-06-11,Serrania/MG,0,26,0,1302
911371,2022-06-12,Serrania/MG,0,26,0,1302
916968,2022-06-13,Serrania/MG,0,26,23,1325
922565,2022-06-14,Serrania/MG,0,26,0,1325
928162,2022-06-15,Serrania/MG,0,26,0,1325
933759,2022-06-16,Serrania/MG,0,26,0,1325
939356,2022-06-17,Serrania/MG,0,26,0,1325
944953,2022-06-18,Serrania/MG,0,26,0,1325
950550,2022-06-19,Serrania/MG,0,26,0,1325
956147,2022-06-20,Serrania/MG,0,26,0,1325
961744,2022-06-21,Serrania/MG,0,26,21,1346
967341,2022-06-22,Serrania/MG,0,26,20,1366
972938,2022-06-23,Serrania/MG,0,26,0,1366
978535,2022-06-24,Serrania/MG,0,26,7,1373
984132,2022-06-25,Serrania/MG,0,26,0,1373
989729,2022-06-26,Serrania/MG,0,26,0,1373
995326,2022-06-27,Serrania/MG,0,26,4,1377
1000923,2022-06-28,Serrania/MG,0,26,2,1379
1006520,2022-06-29,Serrania/MG,0,26,5,1384
1012117,2022-06-30,Serrania/MG,0,26,0,1384
1017714,2022-07-01,Serrania/MG,0,26,7,1391
1023311,2022-07-02,Serrania/MG,0,26,0,1391
1028908,2022-07-03,Serrania/MG,0,26,0,1391
1034505,2022-07-04,Serrania/MG,0,26,0,1391
1040102,2022-07-05,Serrania/MG,0,26,0,1391
1045699,2022-07-06,Serrania/MG,0,26,3,1394
1051296,2022-07-07,Serrania/MG,0,26,0,1394
1056893,2022-07-08,Serrania/MG,0,26,0,1394
1062490,2022-07-09,Serrania/MG,0,26,0,1394
1068087,2022-07-10,Serrania/MG,0,26,0,1394
1073684,2022-07-11,Serrania/MG,0,26,8,1402
1079281,2022-07-12,Serrania/MG,0,26,0,1402
1084878,2022-07-13,Serrania/MG,0,26,0,1402
1090475,2022-07-14,Serrania/MG,0,26,0,1402
1096072,2022-07-15,Serrania/MG,0,26,0,1402
1101669,2022-07-16,Serrania/MG,0,26,0,1402
1107266,2022-07-17,Serrania/MG,0,26,0,1402
1112863,2022-07-18,Serrania/MG,0,26,0,1402
1118460,2022-07-19,Serrania/MG,0,26,0,1402
1124057,2022-07-20,Serrania/MG,0,26,0,1402
1129654,2022-07-21,Serrania/MG,0,26,0,1402
1135251,2022-07-22,Serrania/MG,0,26,0,1402
1140848,2022-07-23,Serrania/MG,0,26,0,1402
1146445,2022-07-24,Serrania/MG,0,26,0,1402
1152042,2022-07-25,Serrania/MG,0,26,0,1402
1157639,2022-07-26,Serrania/MG,0,26,0,1402
1163236,2022-07-27,Serrania/MG,0,26,0,1402
1168833,2022-07-28,Serrania/MG,0,26,0,1402
1174430,2022-07-29,Serrania/MG,0,26,0,1402
1180027,2022-07-30,Serrania/MG,0,26,0,1402
1185624,2022-07-31,Serrania/MG,0,26,0,1402
1191221,2022-08-01,Serrania/MG,0,26,0,1402
1196818,2022-08-02,Serrania/MG,0,26,0,1402
1202415,2022-08-03,Serrania/MG,0,26,0,1402
1208012,2022-08-04,Serrania/MG,0,26,0,1402
1213609,2022-08-05,Serrania/MG,0,26,0,1402
1219206,2022-08-06,Serrania/MG,0,26,0,1402
1224803,2022-08-07,Serrania/MG,0,26,0,1402
1230400,2022-08-08,Serrania/MG,0,26,0,1402
1235997,2022-08-09,Serrania/MG,0,26,0,1402
1241594,2022-08-10,Serrania/MG,0,26,0,1402
1247191,2022-08-11,Serrania/MG,0,26,0,1402
1252788,2022-08-12,Serrania/MG,0,26,0,1402
1258385,2022-08-13,Serrania/MG,0,26,0,1402
1263982,2022-08-14,Serrania/MG,0,26,0,1402
1269579,2022-08-15,Serrania/MG,0,26,0,1402
1275176,2022-08-16,Serrania/MG,0,26,0,1402
1280773,2022-08-17,Serrania/MG,0,26,0,1402
1286370,2022-08-18,Serrania/MG,0,26,0,1402
1291967,2022-08-19,Serrania/MG,0,26,0,1402
1297564,2022-08-20,Serrania/MG,0,26,0,1402
1303161,2022-08-21,Serrania/MG,0,26,0,1402
1308758,2022-08-22,Serrania/MG,0,26,0,1402
1314355,2022-08-23,Serrania/MG,0,26,0,1402
1319952,2022-08-24,Serrania/MG,0,26,0,1402
1325549,2022-08-25,Serrania/MG,0,26,0,1402
5284,2022-01-01,Três Corações/MG,0,268,15,9526
10881,2022-01-02,Três Corações/MG,0,268,0,9526
16478,2022-01-03,Três Corações/MG,0,268,7,9533
22075,2022-01-04,Três Corações/MG,0,268,0,9533
27672,2022-01-05,Três Corações/MG,0,268,37,9570
33269,2022-01-06,Três Corações/MG,0,268,57,9627
38866,2022-01-07,Três Corações/MG,0,268,104,9731
44463,2022-01-08,Três Corações/MG,0,268,130,9861
50060,2022-01-09,Três Corações/MG,0,268,146,10007
55657,2022-01-10,Três Corações/MG,0,268,0,10007
61254,2022-01-11,Três Corações/MG,0,268,0,10007
66851,2022-01-12,Três Corações/MG,0,268,148,10155
72448,2022-01-13,Três Corações/MG,0,268,87,10242
78045,2022-01-14,Três Corações/MG,0,268,0,10242
83642,2022-01-15,Três Corações/MG,0,268,184,10426
89239,2022-01-16,Três Corações/MG,0,268,0,10426
94836,2022-01-17,Três Corações/MG,0,268,127,10553
100433,2022-01-18,Três Corações/MG,0,268,0,10553
106030,2022-01-19,Três Corações/MG,0,268,319,10872
111627,2022-01-20,Três Corações/MG,0,268,183,11055
117224,2022-01-21,Três Corações/MG,0,268,113,11168
122821,2022-01-22,Três Corações/MG,0,268,126,11294
128418,2022-01-23,Três Corações/MG,0,268,0,11294
134015,2022-01-24,Três Corações/MG,0,268,181,11475
139612,2022-01-25,Três Corações/MG,0,268,0,11475
145209,2022-01-26,Três Corações/MG,0,268,463,11938
150806,2022-01-27,Três Corações/MG,0,268,185,12123
156403,2022-01-28,Três Corações/MG,0,268,203,12326
162000,2022-01-29,Três Corações/MG,0,268,238,12564
167597,2022-01-30,Três Corações/MG,0,268,226,12790
173194,2022-01-31,Três Corações/MG,2,270,0,12790
178791,2022-02-01,Três Corações/MG,0,270,0,12790
184388,2022-02-02,Três Corações/MG,1,271,247,13037
189985,2022-02-03,Três Corações/MG,3,274,245,13282
195582,2022-02-04,Três Corações/MG,0,274,107,13389
201179,2022-02-05,Três Corações/MG,2,276,172,13561
206776,2022-02-06,Três Corações/MG,1,277,174,13735
212373,2022-02-07,Três Corações/MG,0,277,0,13735
217970,2022-02-08,Três Corações/MG,0,277,0,13735
223567,2022-02-09,Três Corações/MG,3,280,238,13973
229164,2022-02-10,Três Corações/MG,2,282,138,14111
234761,2022-02-11,Três Corações/MG,0,282,121,14232
240358,2022-02-12,Três Corações/MG,0,282,103,14335
245955,2022-02-13,Três Corações/MG,0,282,180,14515
251552,2022-02-14,Três Corações/MG,0,282,0,14515
257149,2022-02-15,Três Corações/MG,0,282,0,14515
262746,2022-02-16,Três Corações/MG,0,282,193,14708
268343,2022-02-17,Três Corações/MG,2,284,83,14791
273940,2022-02-18,Três Corações/MG,0,284,125,14916
279537,2022-02-19,Três Corações/MG,1,285,67,14983
285134,2022-02-20,Três Corações/MG,0,285,124,15107
290731,2022-02-21,Três Corações/MG,0,285,0,15107
296328,2022-02-22,Três Corações/MG,0,285,0,15107
301925,2022-02-23,Três Corações/MG,1,286,144,15251
307522,2022-02-24,Três Corações/MG,1,287,51,15302
313119,2022-02-25,Três Corações/MG,0,287,64,15366
318716,2022-02-26,Três Corações/MG,0,287,41,15407
324313,2022-02-27,Três Corações/MG,0,287,55,15462
329910,2022-02-28,Três Corações/MG,0,287,0,15462
335507,2022-03-01,Três Corações/MG,0,287,0,15462
341104,2022-03-02,Três Corações/MG,0,287,0,15462
346701,2022-03-03,Três Corações/MG,0,287,0,15462
352298,2022-03-04,Três Corações/MG,0,287,0,15462
357895,2022-03-05,Três Corações/MG,0,287,68,15530
363492,2022-03-06,Três Corações/MG,0,287,27,15557
369089,2022-03-07,Três Corações/MG,0,287,0,15557
374686,2022-03-08,Três Corações/MG,0,287,0,15557
380283,2022-03-09,Três Corações/MG,0,287,27,15584
385880,2022-03-10,Três Corações/MG,4,291,10,15594
391477,2022-03-11,Três Corações/MG,1,292,17,15611
397074,2022-03-12,Três Corações/MG,0,292,9,15620
402671,2022-03-13,Três Corações/MG,0,292,13,15633
408268,2022-03-14,Três Corações/MG,0,292,0,15633
413865,2022-03-15,Três Corações/MG,0,292,0,15633
419462,2022-03-16,Três Corações/MG,1,293,8,15641
425059,2022-03-17,Três Corações/MG,0,293,11,15652
430656,2022-03-18,Três Corações/MG,0,293,6,15658
436253,2022-03-19,Três Corações/MG,0,293,7,15665
441850,2022-03-20,Três Corações/MG,0,293,4,15669
447447,2022-03-21,Três Corações/MG,0,293,0,15669
453044,2022-03-22,Três Corações/MG,0,293,0,15669
458641,2022-03-23,Três Corações/MG,1,294,6,15675
464238,2022-03-24,Três Corações/MG,0,294,1,15676
469835,2022-03-25,Três Corações/MG,0,294,4,15680
475432,2022-03-26,Três Corações/MG,0,294,2,15682
481029,2022-03-27,Três Corações/MG,0,294,0,15682
486626,2022-03-28,Três Corações/MG,0,294,10,15692
492223,2022-03-29,Três Corações/MG,0,294,0,15692
497820,2022-03-30,Três Corações/MG,0,294,11,15703
503417,2022-03-31,Três Corações/MG,0,294,2,15705
509014,2022-04-01,Três Corações/MG,0,294,1,15706
514611,2022-04-02,Três Corações/MG,0,294,0,15706
520208,2022-04-03,Três Corações/MG,0,294,0,15706
525805,2022-04-04,Três Corações/MG,0,294,6,15712
531402,2022-04-05,Três Corações/MG,0,294,0,15712
536999,2022-04-06,Três Corações/MG,0,294,5,15717
542596,2022-04-07,Três Corações/MG,0,294,5,15722
548193,2022-04-08,Três Corações/MG,0,294,0,15722
553790,2022-04-09,Três Corações/MG,0,294,2,15724
559387,2022-04-10,Três Corações/MG,0,294,3,15727
564984,2022-04-11,Três Corações/MG,0,294,0,15727
570581,2022-04-12,Três Corações/MG,0,294,0,15727
576178,2022-04-13,Três Corações/MG,0,294,10,15737
581775,2022-04-14,Três Corações/MG,1,295,8,15745
587372,2022-04-15,Três Corações/MG,0,295,5,15750
592969,2022-04-16,Três Corações/MG,0,295,0,15750
598566,2022-04-17,Três Corações/MG,0,295,0,15750
604163,2022-04-18,Três Corações/MG,0,295,0,15750
609760,2022-04-19,Três Corações/MG,0,295,0,15750
615357,2022-04-20,Três Corações/MG,0,295,11,15761
620954,2022-04-21,Três Corações/MG,0,295,2,15763
626551,2022-04-22,Três Corações/MG,0,295,4,15767
632148,2022-04-23,Três Corações/MG,0,295,0,15767
637745,2022-04-24,Três Corações/MG,0,295,0,15767
643342,2022-04-25,Três Corações/MG,0,295,0,15767
648939,2022-04-26,Três Corações/MG,0,295,0,15767
654536,2022-04-27,Três Corações/MG,0,295,4,15771
660133,2022-04-28,Três Corações/MG,0,295,2,15773
665730,2022-04-29,Três Corações/MG,0,295,18,15791
671327,2022-04-30,Três Corações/MG,0,295,8,15799
676924,2022-05-01,Três Corações/MG,0,295,6,15805
682521,2022-05-02,Três Corações/MG,0,295,0,15805
688118,2022-05-03,Três Corações/MG,0,295,0,15805
693715,2022-05-04,Três Corações/MG,0,295,6,15811
699312,2022-05-05,Três Corações/MG,0,295,4,15815
704909,2022-05-06,Três Corações/MG,0,295,13,15828
710506,2022-05-07,Três Corações/MG,0,295,0,15828
716103,2022-05-08,Três Corações/MG,0,295,0,15828
721700,2022-05-09,Três Corações/MG,0,295,23,15851
727297,2022-05-10,Três Corações/MG,0,295,0,15851
732894,2022-05-11,Três Corações/MG,0,295,13,15864
738491,2022-05-12,Três Corações/MG,0,295,6,15870
744088,2022-05-13,Três Corações/MG,0,295,5,15875
749685,2022-05-14,Três Corações/MG,0,295,0,15875
755282,2022-05-15,Três Corações/MG,0,295,0,15875
760879,2022-05-16,Três Corações/MG,0,295,41,15916
766476,2022-05-17,Três Corações/MG,0,295,0,15916
772073,2022-05-18,Três Corações/MG,0,295,27,15943
777670,2022-05-19,Três Corações/MG,0,295,29,15972
783267,2022-05-20,Três Corações/MG,0,295,40,16012
788864,2022-05-21,Três Corações/MG,0,295,0,16012
794461,2022-05-22,Três Corações/MG,0,295,0,16012
800058,2022-05-23,Três Corações/MG,0,295,51,16063
805655,2022-05-24,Três Corações/MG,0,295,0,16063
811252,2022-05-25,Três Corações/MG,0,295,45,16108
816849,2022-05-26,Três Corações/MG,0,295,58,16166
822446,2022-05-27,Três Corações/MG,0,295,52,16218
828043,2022-05-28,Três Corações/MG,0,295,0,16218
833640,2022-05-29,Três Corações/MG,0,295,0,16218
839237,2022-05-30,Três Corações/MG,0,295,110,16328
844834,2022-05-31,Três Corações/MG,0,295,0,16328
850431,2022-06-01,Três Corações/MG,0,295,69,16397
856028,2022-06-02,Três Corações/MG,0,295,69,16466
861625,2022-06-03,Três Corações/MG,0,295,52,16518
867222,2022-06-04,Três Corações/MG,0,295,0,16518
872819,2022-06-05,Três Corações/MG,0,295,0,16518
878416,2022-06-06,Três Corações/MG,0,295,124,16642
884013,2022-06-07,Três Corações/MG,0,295,0,16642
889610,2022-06-08,Três Corações/MG,0,295,54,16696
895207,2022-06-09,Três Corações/MG,0,295,30,16726
900804,2022-06-10,Três Corações/MG,0,295,30,16756
906401,2022-06-11,Três Corações/MG,0,295,0,16756
911998,2022-06-12,Três Corações/MG,0,295,0,16756
917595,2022-06-13,Três Corações/MG,0,295,116,16872
923192,2022-06-14,Três Corações/MG,0,295,0,16872
928789,2022-06-15,Três Corações/MG,1,296,0,16872
934386,2022-06-16,Três Corações/MG,0,296,0,16872
939983,2022-06-17,Três Corações/MG,0,296,0,16872
945580,2022-06-18,Três Corações/MG,0,296,0,16872
951177,2022-06-19,Três Corações/MG,0,296,0,16872
956774,2022-06-20,Três Corações/MG,1,297,161,17033
962371,2022-06-21,Três Corações/MG,0,297,0,17033
967968,2022-06-22,Três Corações/MG,0,297,158,17191
973565,2022-06-23,Três Corações/MG,0,297,63,17254
979162,2022-06-24,Três Corações/MG,1,298,77,17331
984759,2022-06-25,Três Corações/MG,0,298,0,17331
990356,2022-06-26,Três Corações/MG,0,298,0,17331
995953,2022-06-27,Três Corações/MG,0,298,134,17465
1001550,2022-06-28,Três Corações/MG,0,298,0,17465
1007147,2022-06-29,Três Corações/MG,0,298,97,17562
1012744,2022-06-30,Três Corações/MG,1,299,49,17611
1018341,2022-07-01,Três Corações/MG,0,299,86,17697
1023938,2022-07-02,Três Corações/MG,0,299,0,17697
1029535,2022-07-03,Três Corações/MG,0,299,0,17697
1035132,2022-07-04,Três Corações/MG,0,299,157,17854
1040729,2022-07-05,Três Corações/MG,0,299,0,17854
1046326,2022-07-06,Três Corações/MG,0,299,84,17938
1051923,2022-07-07,Três Corações/MG,0,299,67,18005
1057520,2022-07-08,Três Corações/MG,0,299,69,18074
1063117,2022-07-09,Três Corações/MG,0,299,0,18074
1068714,2022-07-10,Três Corações/MG,0,299,0,18074
1074311,2022-07-11,Três Corações/MG,0,299,144,18218
1079908,2022-07-12,Três Corações/MG,0,299,0,18218
1085505,2022-07-13,Três Corações/MG,0,299,88,18306
1091102,2022-07-14,Três Corações/MG,0,299,52,18358
1096699,2022-07-15,Três Corações/MG,0,299,40,18398
1102296,2022-07-16,Três Corações/MG,0,299,0,18398
1107893,2022-07-17,Três Corações/MG,0,299,0,18398
1113490,2022-07-18,Três Corações/MG,0,299,109,18507
1119087,2022-07-19,Três Corações/MG,0,299,0,18507
1124684,2022-07-20,Três Corações/MG,0,299,0,18507
1130281,2022-07-21,Três Corações/MG,1,300,0,18507
1135878,2022-07-22,Três Corações/MG,1,301,101,18608
1141475,2022-07-23,Três Corações/MG,0,301,0,18608
1147072,2022-07-24,Três Corações/MG,0,301,0,18608
1152669,2022-07-25,Três Corações/MG,0,301,65,18673
1158266,2022-07-26,Três Corações/MG,0,301,0,18673
1163863,2022-07-27,Três Corações/MG,0,301,58,18731
1169460,2022-07-28,Três Corações/MG,0,301,34,18765
1175057,2022-07-29,Três Corações/MG,0,301,16,18781
1180654,2022-07-30,Três Corações/MG,0,301,0,18781
1186251,2022-07-31,Três Corações/MG,0,301,0,18781
1191848,2022-08-01,Três Corações/MG,1,302,9,18790
1197445,2022-08-02,Três Corações/MG,0,302,0,18790
1203042,2022-08-03,Três Corações/MG,0,302,34,18824
1208639,2022-08-04,Três Corações/MG,0,302,14,18838
1214236,2022-08-05,Três Corações/MG,0,302,5,18843
1219833,2022-08-06,Três Corações/MG,0,302,0,18843
1225430,2022-08-07,Três Corações/MG,0,302,0,18843
1231027,2022-08-08,Três Corações/MG,0,302,19,18862
1236624,2022-08-09,Três Corações/MG,0,302,0,18862
1242221,2022-08-10,Três Corações/MG,0,302,1,18863
1247818,2022-08-11,Três Corações/MG,1,303,6,18869
1253415,2022-08-12,Três Corações/MG,0,303,4,18873
1259012,2022-08-13,Três Corações/MG,0,303,0,18873
1264609,2022-08-14,Três Corações/MG,0,303,0,18873
1270206,2022-08-15,Três Corações/MG,0,303,0,18873
1275803,2022-08-16,Três Corações/MG,0,303,8,18881
1281400,2022-08-17,Três Corações/MG,0,303,5,18886
1286997,2022-08-18,Três Corações/MG,0,303,3,18889
1292594,2022-08-19,Três Corações/MG,0,303,0,18889
1298191,2022-08-20,Três Corações/MG,0,303,0,18889
1303788,2022-08-21,Três Corações/MG,0,303,0,18889
1309385,2022-08-22,Três Corações/MG,0,303,7,18896
1314982,2022-08-23,Três Corações/MG,0,303,0,18896
1320579,2022-08-24,Três Corações/MG,0,303,4,18900
1326176,2022-08-25,Três Corações/MG,0,303,2,18902
5292,2022-01-01,Três Pontas/MG,0,167,0,7299
10889,2022-01-02,Três Pontas/MG,0,167,0,7299
16486,2022-01-03,Três Pontas/MG,0,167,0,7299
22083,2022-01-04,Três Pontas/MG,0,167,4,7303
27680,2022-01-05,Três Pontas/MG,0,167,0,7303
33277,2022-01-06,Três Pontas/MG,0,167,0,7303
38874,2022-01-07,Três Pontas/MG,0,167,120,7423
44471,2022-01-08,Três Pontas/MG,0,167,121,7544
50068,2022-01-09,Três Pontas/MG,0,167,0,7544
55665,2022-01-10,Três Pontas/MG,0,167,0,7544
61262,2022-01-11,Três Pontas/MG,0,167,58,7602
66859,2022-01-12,Três Pontas/MG,0,167,116,7718
72456,2022-01-13,Três Pontas/MG,0,167,0,7718
78053,2022-01-14,Três Pontas/MG,0,167,84,7802
83650,2022-01-15,Três Pontas/MG,1,168,85,7887
89247,2022-01-16,Três Pontas/MG,0,168,0,7887
94844,2022-01-17,Três Pontas/MG,0,168,15,7902
100441,2022-01-18,Três Pontas/MG,0,168,79,7981
106038,2022-01-19,Três Pontas/MG,0,168,121,8102
111635,2022-01-20,Três Pontas/MG,0,168,159,8261
117232,2022-01-21,Três Pontas/MG,0,168,201,8462
122829,2022-01-22,Três Pontas/MG,0,168,50,8512
128426,2022-01-23,Três Pontas/MG,0,168,61,8573
134023,2022-01-24,Três Pontas/MG,0,168,23,8596
139620,2022-01-25,Três Pontas/MG,0,168,4,8600
145217,2022-01-26,Três Pontas/MG,1,169,201,8801
150814,2022-01-27,Três Pontas/MG,0,169,109,8910
156411,2022-01-28,Três Pontas/MG,0,169,243,9153
162008,2022-01-29,Três Pontas/MG,0,169,113,9266
167605,2022-01-30,Três Pontas/MG,0,169,90,9356
173202,2022-01-31,Três Pontas/MG,0,169,19,9375
178799,2022-02-01,Três Pontas/MG,0,169,0,9375
184396,2022-02-02,Três Pontas/MG,0,169,199,9574
189993,2022-02-03,Três Pontas/MG,0,169,133,9707
195590,2022-02-04,Três Pontas/MG,0,169,88,9795
201187,2022-02-05,Três Pontas/MG,0,169,33,9828
206784,2022-02-06,Três Pontas/MG,5,174,0,9828
212381,2022-02-07,Três Pontas/MG,0,174,0,9828
217978,2022-02-08,Três Pontas/MG,0,174,101,9929
223575,2022-02-09,Três Pontas/MG,0,174,94,10023
229172,2022-02-10,Três Pontas/MG,0,174,41,10064
234769,2022-02-11,Três Pontas/MG,2,176,52,10116
240366,2022-02-12,Três Pontas/MG,1,177,70,10186
245963,2022-02-13,Três Pontas/MG,1,178,0,10186
251560,2022-02-14,Três Pontas/MG,0,178,0,10186
257157,2022-02-15,Três Pontas/MG,0,178,77,10263
262754,2022-02-16,Três Pontas/MG,1,179,10,10273
268351,2022-02-17,Três Pontas/MG,0,179,40,10313
273948,2022-02-18,Três Pontas/MG,0,179,7,10320
279545,2022-02-19,Três Pontas/MG,0,179,28,10348
285142,2022-02-20,Três Pontas/MG,0,179,0,10348
290739,2022-02-21,Três Pontas/MG,0,179,0,10348
296336,2022-02-22,Três Pontas/MG,0,179,81,10429
301933,2022-02-23,Três Pontas/MG,3,182,47,10476
307530,2022-02-24,Três Pontas/MG,0,182,26,10502
313127,2022-02-25,Três Pontas/MG,0,182,17,10519
318724,2022-02-26,Três Pontas/MG,0,182,25,10544
324321,2022-02-27,Três Pontas/MG,0,182,0,10544
329918,2022-02-28,Três Pontas/MG,0,182,0,10544
335515,2022-03-01,Três Pontas/MG,0,182,0,10544
341112,2022-03-02,Três Pontas/MG,0,182,0,10544
346709,2022-03-03,Três Pontas/MG,1,183,0,10544
352306,2022-03-04,Três Pontas/MG,0,183,86,10630
357903,2022-03-05,Três Pontas/MG,0,183,25,10655
363500,2022-03-06,Três Pontas/MG,0,183,0,10655
369097,2022-03-07,Três Pontas/MG,0,183,0,10655
374694,2022-03-08,Três Pontas/MG,0,183,16,10671
380291,2022-03-09,Três Pontas/MG,0,183,7,10678
385888,2022-03-10,Três Pontas/MG,0,183,6,10684
391485,2022-03-11,Três Pontas/MG,1,184,5,10689
397082,2022-03-12,Três Pontas/MG,1,185,8,10697
402679,2022-03-13,Três Pontas/MG,0,185,0,10697
408276,2022-03-14,Três Pontas/MG,0,185,0,10697
413873,2022-03-15,Três Pontas/MG,0,185,8,10705
419470,2022-03-16,Três Pontas/MG,0,185,14,10719
425067,2022-03-17,Três Pontas/MG,0,185,1,10720
430664,2022-03-18,Três Pontas/MG,0,185,5,10725
436261,2022-03-19,Três Pontas/MG,0,185,4,10729
441858,2022-03-20,Três Pontas/MG,0,185,0,10729
447455,2022-03-21,Três Pontas/MG,0,185,0,10729
453052,2022-03-22,Três Pontas/MG,0,185,5,10734
458649,2022-03-23,Três Pontas/MG,0,185,0,10734
464246,2022-03-24,Três Pontas/MG,0,185,0,10734
469843,2022-03-25,Três Pontas/MG,0,185,0,10734
475440,2022-03-26,Três Pontas/MG,0,185,0,10734
481037,2022-03-27,Três Pontas/MG,0,185,0,10734
486634,2022-03-28,Três Pontas/MG,0,185,0,10734
492231,2022-03-29,Três Pontas/MG,0,185,5,10739
497828,2022-03-30,Três Pontas/MG,0,185,0,10739
503425,2022-03-31,Três Pontas/MG,0,185,2,10741
509022,2022-04-01,Três Pontas/MG,0,185,1,10742
514619,2022-04-02,Três Pontas/MG,0,185,0,10742
520216,2022-04-03,Três Pontas/MG,0,185,0,10742
525813,2022-04-04,Três Pontas/MG,0,185,0,10742
531410,2022-04-05,Três Pontas/MG,0,185,1,10743
537007,2022-04-06,Três Pontas/MG,0,185,0,10743
542604,2022-04-07,Três Pontas/MG,0,185,0,10743
548201,2022-04-08,Três Pontas/MG,0,185,3,10746
553798,2022-04-09,Três Pontas/MG,0,185,1,10747
559395,2022-04-10,Três Pontas/MG,0,185,0,10747
564992,2022-04-11,Três Pontas/MG,0,185,0,10747
570589,2022-04-12,Três Pontas/MG,0,185,0,10747
576186,2022-04-13,Três Pontas/MG,1,186,0,10747
581783,2022-04-14,Três Pontas/MG,0,186,0,10747
587380,2022-04-15,Três Pontas/MG,0,186,0,10747
592977,2022-04-16,Três Pontas/MG,0,186,0,10747
598574,2022-04-17,Três Pontas/MG,0,186,0,10747
604171,2022-04-18,Três Pontas/MG,0,186,0,10747
609768,2022-04-19,Três Pontas/MG,0,186,1,10748
615365,2022-04-20,Três Pontas/MG,0,186,0,10748
620962,2022-04-21,Três Pontas/MG,0,186,0,10748
626559,2022-04-22,Três Pontas/MG,0,186,0,10748
632156,2022-04-23,Três Pontas/MG,0,186,0,10748
637753,2022-04-24,Três Pontas/MG,0,186,0,10748
643350,2022-04-25,Três Pontas/MG,0,186,0,10748
648947,2022-04-26,Três Pontas/MG,0,186,0,10748
654544,2022-04-27,Três Pontas/MG,0,186,0,10748
660141,2022-04-28,Três Pontas/MG,0,186,0,10748
665738,2022-04-29,Três Pontas/MG,0,186,0,10748
671335,2022-04-30,Três Pontas/MG,0,186,0,10748
676932,2022-05-01,Três Pontas/MG,0,186,0,10748
682529,2022-05-02,Três Pontas/MG,0,186,0,10748
688126,2022-05-03,Três Pontas/MG,0,186,3,10751
693723,2022-05-04,Três Pontas/MG,0,186,0,10751
699320,2022-05-05,Três Pontas/MG,0,186,0,10751
704917,2022-05-06,Três Pontas/MG,0,186,0,10751
710514,2022-05-07,Três Pontas/MG,0,186,0,10751
716111,2022-05-08,Três Pontas/MG,0,186,0,10751
721708,2022-05-09,Três Pontas/MG,0,186,0,10751
727305,2022-05-10,Três Pontas/MG,0,186,17,10768
732902,2022-05-11,Três Pontas/MG,0,186,0,10768
738499,2022-05-12,Três Pontas/MG,0,186,0,10768
744096,2022-05-13,Três Pontas/MG,0,186,0,10768
749693,2022-05-14,Três Pontas/MG,0,186,0,10768
755290,2022-05-15,Três Pontas/MG,0,186,0,10768
760887,2022-05-16,Três Pontas/MG,0,186,0,10768
766484,2022-05-17,Três Pontas/MG,0,186,42,10810
772081,2022-05-18,Três Pontas/MG,0,186,0,10810
777678,2022-05-19,Três Pontas/MG,0,186,0,10810
783275,2022-05-20,Três Pontas/MG,0,186,0,10810
788872,2022-05-21,Três Pontas/MG,0,186,0,10810
794469,2022-05-22,Três Pontas/MG,0,186,0,10810
800066,2022-05-23,Três Pontas/MG,0,186,32,10842
805663,2022-05-24,Três Pontas/MG,0,186,31,10873
811260,2022-05-25,Três Pontas/MG,0,186,0,10873
816857,2022-05-26,Três Pontas/MG,0,186,0,10873
822454,2022-05-27,Três Pontas/MG,0,186,74,10947
828051,2022-05-28,Três Pontas/MG,0,186,0,10947
833648,2022-05-29,Três Pontas/MG,0,186,0,10947
839245,2022-05-30,Três Pontas/MG,0,186,40,10987
844842,2022-05-31,Três Pontas/MG,0,186,58,11045
850439,2022-06-01,Três Pontas/MG,0,186,50,11095
856036,2022-06-02,Três Pontas/MG,0,186,30,11125
861633,2022-06-03,Três Pontas/MG,0,186,41,11166
867230,2022-06-04,Três Pontas/MG,0,186,0,11166
872827,2022-06-05,Três Pontas/MG,0,186,0,11166
878424,2022-06-06,Três Pontas/MG,0,186,35,11201
884021,2022-06-07,Três Pontas/MG,0,186,7,11208
889618,2022-06-08,Três Pontas/MG,0,186,85,11293
895215,2022-06-09,Três Pontas/MG,0,186,39,11332
900812,2022-06-10,Três Pontas/MG,0,186,46,11378
906409,2022-06-11,Três Pontas/MG,0,186,0,11378
912006,2022-06-12,Três Pontas/MG,0,186,0,11378
917603,2022-06-13,Três Pontas/MG,0,186,23,11401
923200,2022-06-14,Três Pontas/MG,0,186,42,11443
928797,2022-06-15,Três Pontas/MG,0,186,7,11450
934394,2022-06-16,Três Pontas/MG,0,186,0,11450
939991,2022-06-17,Três Pontas/MG,0,186,0,11450
945588,2022-06-18,Três Pontas/MG,0,186,0,11450
951185,2022-06-19,Três Pontas/MG,0,186,0,11450
956782,2022-06-20,Três Pontas/MG,0,186,39,11489
962379,2022-06-21,Três Pontas/MG,0,186,81,11570
967976,2022-06-22,Três Pontas/MG,0,186,17,11587
973573,2022-06-23,Três Pontas/MG,0,186,49,11636
979170,2022-06-24,Três Pontas/MG,0,186,9,11645
984767,2022-06-25,Três Pontas/MG,0,186,0,11645
990364,2022-06-26,Três Pontas/MG,0,186,0,11645
995961,2022-06-27,Três Pontas/MG,0,186,15,11660
1001558,2022-06-28,Três Pontas/MG,0,186,0,11660
1007155,2022-06-29,Três Pontas/MG,0,186,70,11730
1012752,2022-06-30,Três Pontas/MG,0,186,8,11738
1018349,2022-07-01,Três Pontas/MG,0,186,26,11764
1023946,2022-07-02,Três Pontas/MG,0,186,0,11764
1029543,2022-07-03,Três Pontas/MG,0,186,0,11764
1035140,2022-07-04,Três Pontas/MG,0,186,12,11776
1040737,2022-07-05,Três Pontas/MG,0,186,45,11821
1046334,2022-07-06,Três Pontas/MG,0,186,7,11828
1051931,2022-07-07,Três Pontas/MG,0,186,3,11831
1057528,2022-07-08,Três Pontas/MG,0,186,15,11846
1063125,2022-07-09,Três Pontas/MG,0,186,0,11846
1068722,2022-07-10,Três Pontas/MG,0,186,0,11846
1074319,2022-07-11,Três Pontas/MG,0,186,14,11860
1079916,2022-07-12,Três Pontas/MG,0,186,13,11873
1085513,2022-07-13,Três Pontas/MG,0,186,16,11889
1091110,2022-07-14,Três Pontas/MG,0,186,16,11905
1096707,2022-07-15,Três Pontas/MG,0,186,8,11913
1102304,2022-07-16,Três Pontas/MG,0,186,0,11913
1107901,2022-07-17,Três Pontas/MG,0,186,0,11913
1113498,2022-07-18,Três Pontas/MG,0,186,14,11927
1119095,2022-07-19,Três Pontas/MG,0,186,16,11943
1124692,2022-07-20,Três Pontas/MG,0,186,3,11946
1130289,2022-07-21,Três Pontas/MG,1,187,22,11968
1135886,2022-07-22,Três Pontas/MG,0,187,14,11982
1141483,2022-07-23,Três Pontas/MG,0,187,0,11982
1147080,2022-07-24,Três Pontas/MG,0,187,0,11982
1152677,2022-07-25,Três Pontas/MG,0,187,5,11987
1158274,2022-07-26,Três Pontas/MG,0,187,0,11987
1163871,2022-07-27,Três Pontas/MG,0,187,12,11999
1169468,2022-07-28,Três Pontas/MG,0,187,8,12007
1175065,2022-07-29,Três Pontas/MG,0,187,4,12011
1180662,2022-07-30,Três Pontas/MG,0,187,0,12011
1186259,2022-07-31,Três Pontas/MG,0,187,0,12011
1191856,2022-08-01,Três Pontas/MG,0,187,3,12014
1197453,2022-08-02,Três Pontas/MG,0,187,0,12014
1203050,2022-08-03,Três Pontas/MG,0,187,19,12033
1208647,2022-08-04,Três Pontas/MG,0,187,1,12034
1214244,2022-08-05,Três Pontas/MG,0,187,12,12046
1219841,2022-08-06,Três Pontas/MG,0,187,0,12046
1225438,2022-08-07,Três Pontas/MG,0,187,0,12046
1231035,2022-08-08,Três Pontas/MG,0,187,15,12061
1236632,2022-08-09,Três Pontas/MG,0,187,6,12067
1242229,2022-08-10,Três Pontas/MG,0,187,7,12074
1247826,2022-08-11,Três Pontas/MG,0,187,0,12074
1253423,2022-08-12,Três Pontas/MG,0,187,18,12092
1259020,2022-08-13,Três Pontas/MG,0,187,0,12092
1264617,2022-08-14,Três Pontas/MG,0,187,0,12092
1270214,2022-08-15,Três Pontas/MG,0,187,0,12092
1275811,2022-08-16,Três Pontas/MG,0,187,1,12093
1281408,2022-08-17,Três Pontas/MG,0,187,0,12093
1287005,2022-08-18,Três Pontas/MG,0,187,1,12094
1292602,2022-08-19,Três Pontas/MG,0,187,0,12094
1298199,2022-08-20,Três Pontas/MG,0,187,0,12094
1303796,2022-08-21,Três Pontas/MG,0,187,0,12094
1309393,2022-08-22,Três Pontas/MG,0,187,1,12095
1314990,2022-08-23,Três Pontas/MG,0,187,0,12095
1320587,2022-08-24,Três Pontas/MG,0,187,2,12097
1326184,2022-08-25,Três Pontas/MG,0,187,0,12097
5429,2022-01-01,Varginha/MG,0,353,0,18256
11026,2022-01-02,Varginha/MG,0,353,0,18256
16623,2022-01-03,Varginha/MG,0,353,0,18256
22220,2022-01-04,Varginha/MG,0,353,103,18359
27817,2022-01-05,Varginha/MG,0,353,81,18440
33414,2022-01-06,Varginha/MG,0,353,-81,18359
39011,2022-01-07,Varginha/MG,0,353,440,18799
44608,2022-01-08,Varginha/MG,0,353,248,19047
50205,2022-01-09,Varginha/MG,0,353,179,19226
55802,2022-01-10,Varginha/MG,0,353,0,19226
61399,2022-01-11,Varginha/MG,0,353,0,19226
66996,2022-01-12,Varginha/MG,0,353,332,19558
72593,2022-01-13,Varginha/MG,0,353,231,19789
78190,2022-01-14,Varginha/MG,0,353,224,20013
83787,2022-01-15,Varginha/MG,0,353,611,20624
89384,2022-01-16,Varginha/MG,0,353,0,20624
94981,2022-01-17,Varginha/MG,0,353,230,20854
100578,2022-01-18,Varginha/MG,0,353,503,21357
106175,2022-01-19,Varginha/MG,0,353,467,21824
111772,2022-01-20,Varginha/MG,0,353,408,22232
117369,2022-01-21,Varginha/MG,0,353,144,22376
122966,2022-01-22,Varginha/MG,2,355,0,22376
128563,2022-01-23,Varginha/MG,0,355,0,22376
134160,2022-01-24,Varginha/MG,0,355,0,22376
139757,2022-01-25,Varginha/MG,0,355,323,22699
145354,2022-01-26,Varginha/MG,0,355,314,23013
150951,2022-01-27,Varginha/MG,0,355,256,23269
156548,2022-01-28,Varginha/MG,0,355,295,23564
162145,2022-01-29,Varginha/MG,4,359,522,24086
167742,2022-01-30,Varginha/MG,0,359,0,24086
173339,2022-01-31,Varginha/MG,0,359,0,24086
178936,2022-02-01,Varginha/MG,0,359,0,24086
184533,2022-02-02,Varginha/MG,0,359,621,24707
190130,2022-02-03,Varginha/MG,0,359,274,24981
195727,2022-02-04,Varginha/MG,0,359,0,24981
201324,2022-02-05,Varginha/MG,0,359,380,25361
206921,2022-02-06,Varginha/MG,0,359,286,25647
212518,2022-02-07,Varginha/MG,0,359,0,25647
218115,2022-02-08,Varginha/MG,7,366,0,25647
223712,2022-02-09,Varginha/MG,0,366,387,26034
229309,2022-02-10,Varginha/MG,0,366,193,26227
234906,2022-02-11,Varginha/MG,7,373,121,26348
240503,2022-02-12,Varginha/MG,0,373,134,26482
246100,2022-02-13,Varginha/MG,0,373,123,26605
251697,2022-02-14,Varginha/MG,0,373,0,26605
257294,2022-02-15,Varginha/MG,0,373,116,26721
262891,2022-02-16,Varginha/MG,0,373,186,26907
268488,2022-02-17,Varginha/MG,0,373,148,27055
274085,2022-02-18,Varginha/MG,0,373,174,27229
279682,2022-02-19,Varginha/MG,0,373,117,27346
285279,2022-02-20,Varginha/MG,0,373,0,27346
290876,2022-02-21,Varginha/MG,0,373,0,27346
296473,2022-02-22,Varginha/MG,0,373,236,27582
302070,2022-02-23,Varginha/MG,5,378,154,27736
307667,2022-02-24,Varginha/MG,0,378,150,27886
313264,2022-02-25,Varginha/MG,0,378,83,27969
318861,2022-02-26,Varginha/MG,0,378,76,28045
324458,2022-02-27,Varginha/MG,0,378,96,28141
330055,2022-02-28,Varginha/MG,0,378,0,28141
335652,2022-03-01,Varginha/MG,1,379,53,28194
341249,2022-03-02,Varginha/MG,3,382,0,28194
346846,2022-03-03,Varginha/MG,0,382,0,28194
352443,2022-03-04,Varginha/MG,0,382,0,28194
358040,2022-03-05,Varginha/MG,0,382,94,28288
363637,2022-03-06,Varginha/MG,6,388,160,28448
369234,2022-03-07,Varginha/MG,0,388,0,28448
374831,2022-03-08,Varginha/MG,0,388,54,28502
380428,2022-03-09,Varginha/MG,0,388,62,28564
386025,2022-03-10,Varginha/MG,0,388,37,28601
391622,2022-03-11,Varginha/MG,0,388,24,28625
397219,2022-03-12,Varginha/MG,2,390,38,28663
402816,2022-03-13,Varginha/MG,0,390,10,28673
408413,2022-03-14,Varginha/MG,0,390,0,28673
414010,2022-03-15,Varginha/MG,0,390,22,28695
419607,2022-03-16,Varginha/MG,0,390,24,28719
425204,2022-03-17,Varginha/MG,3,393,21,28740
430801,2022-03-18,Varginha/MG,0,393,21,28761
436398,2022-03-19,Varginha/MG,1,394,14,28775
441995,2022-03-20,Varginha/MG,1,395,0,28775
447592,2022-03-21,Varginha/MG,0,395,0,28775
453189,2022-03-22,Varginha/MG,0,395,31,28806
458786,2022-03-23,Varginha/MG,0,395,19,28825
464383,2022-03-24,Varginha/MG,0,395,8,28833
469980,2022-03-25,Varginha/MG,0,395,25,28858
475577,2022-03-26,Varginha/MG,0,395,11,28869
481174,2022-03-27,Varginha/MG,0,395,7,28876
486771,2022-03-28,Varginha/MG,0,395,0,28876
492368,2022-03-29,Varginha/MG,0,395,6,28882
497965,2022-03-30,Varginha/MG,0,395,15,28897
503562,2022-03-31,Varginha/MG,0,395,0,28897
509159,2022-04-01,Varginha/MG,1,396,10,28907
514756,2022-04-02,Varginha/MG,0,396,0,28907
520353,2022-04-03,Varginha/MG,0,396,0,28907
525950,2022-04-04,Varginha/MG,2,398,5,28912
531547,2022-04-05,Varginha/MG,0,398,12,28924
537144,2022-04-06,Varginha/MG,0,398,15,28939
542741,2022-04-07,Varginha/MG,0,398,14,28953
548338,2022-04-08,Varginha/MG,1,399,5,28958
553935,2022-04-09,Varginha/MG,0,399,8,28966
559532,2022-04-10,Varginha/MG,0,399,0,28966
565129,2022-04-11,Varginha/MG,0,399,0,28966
570726,2022-04-12,Varginha/MG,0,399,-1,28965
576323,2022-04-13,Varginha/MG,0,399,13,28978
581920,2022-04-14,Varginha/MG,0,399,28,29006
587517,2022-04-15,Varginha/MG,1,400,8,29014
593114,2022-04-16,Varginha/MG,0,400,0,29014
598711,2022-04-17,Varginha/MG,0,400,0,29014
604308,2022-04-18,Varginha/MG,0,400,0,29014
609905,2022-04-19,Varginha/MG,0,400,35,29049
615502,2022-04-20,Varginha/MG,0,400,8,29057
621099,2022-04-21,Varginha/MG,0,400,20,29077
626696,2022-04-22,Varginha/MG,0,400,0,29077
632293,2022-04-23,Varginha/MG,0,400,0,29077
637890,2022-04-24,Varginha/MG,0,400,0,29077
643487,2022-04-25,Varginha/MG,0,400,0,29077
649084,2022-04-26,Varginha/MG,0,400,32,29109
654681,2022-04-27,Varginha/MG,1,401,42,29151
660278,2022-04-28,Varginha/MG,0,401,8,29159
665875,2022-04-29,Varginha/MG,0,401,26,29185
671472,2022-04-30,Varginha/MG,0,401,10,29195
677069,2022-05-01,Varginha/MG,0,401,0,29195
682666,2022-05-02,Varginha/MG,1,402,0,29195
688263,2022-05-03,Varginha/MG,0,402,8,29203
693860,2022-05-04,Varginha/MG,0,402,43,29246
699457,2022-05-05,Varginha/MG,0,402,12,29258
705054,2022-05-06,Varginha/MG,0,402,15,29273
710651,2022-05-07,Varginha/MG,0,402,0,29273
716248,2022-05-08,Varginha/MG,0,402,0,29273
721845,2022-05-09,Varginha/MG,0,402,7,29280
727442,2022-05-10,Varginha/MG,0,402,47,29327
733039,2022-05-11,Varginha/MG,0,402,52,29379
738636,2022-05-12,Varginha/MG,0,402,22,29401
744233,2022-05-13,Varginha/MG,0,402,10,29411
749830,2022-05-14,Varginha/MG,0,402,0,29411
755427,2022-05-15,Varginha/MG,0,402,0,29411
761024,2022-05-16,Varginha/MG,0,402,45,29456
766621,2022-05-17,Varginha/MG,0,402,65,29521
772218,2022-05-18,Varginha/MG,0,402,65,29586
777815,2022-05-19,Varginha/MG,0,402,16,29602
783412,2022-05-20,Varginha/MG,0,402,62,29664
789009,2022-05-21,Varginha/MG,0,402,0,29664
794606,2022-05-22,Varginha/MG,0,402,0,29664
800203,2022-05-23,Varginha/MG,0,402,35,29699
805800,2022-05-24,Varginha/MG,0,402,28,29727
811397,2022-05-25,Varginha/MG,3,405,32,29759
816994,2022-05-26,Varginha/MG,0,405,76,29835
822591,2022-05-27,Varginha/MG,2,407,0,29835
828188,2022-05-28,Varginha/MG,0,407,0,29835
833785,2022-05-29,Varginha/MG,0,407,0,29835
839382,2022-05-30,Varginha/MG,0,407,84,29919
844979,2022-05-31,Varginha/MG,0,407,0,29919
850576,2022-06-01,Varginha/MG,0,407,222,30141
856173,2022-06-02,Varginha/MG,0,407,91,30232
861770,2022-06-03,Varginha/MG,0,407,77,30309
867367,2022-06-04,Varginha/MG,0,407,0,30309
872964,2022-06-05,Varginha/MG,0,407,0,30309
878561,2022-06-06,Varginha/MG,0,407,59,30368
884158,2022-06-07,Varginha/MG,0,407,104,30472
889755,2022-06-08,Varginha/MG,3,410,142,30614
895352,2022-06-09,Varginha/MG,2,412,139,30753
900949,2022-06-10,Varginha/MG,0,412,47,30800
906546,2022-06-11,Varginha/MG,0,412,0,30800
912143,2022-06-12,Varginha/MG,0,412,0,30800
917740,2022-06-13,Varginha/MG,0,412,89,30889
923337,2022-06-14,Varginha/MG,1,413,112,31001
928934,2022-06-15,Varginha/MG,0,413,70,31071
934531,2022-06-16,Varginha/MG,0,413,0,31071
940128,2022-06-17,Varginha/MG,0,413,0,31071
945725,2022-06-18,Varginha/MG,0,413,0,31071
951322,2022-06-19,Varginha/MG,0,413,0,31071
956919,2022-06-20,Varginha/MG,1,414,117,31188
962516,2022-06-21,Varginha/MG,0,414,0,31188
968113,2022-06-22,Varginha/MG,0,414,227,31415
973710,2022-06-23,Varginha/MG,0,414,117,31532
979307,2022-06-24,Varginha/MG,0,414,64,31596
984904,2022-06-25,Varginha/MG,0,414,0,31596
990501,2022-06-26,Varginha/MG,0,414,0,31596
996098,2022-06-27,Varginha/MG,0,414,69,31665
1001695,2022-06-28,Varginha/MG,0,414,117,31782
1007292,2022-06-29,Varginha/MG,0,414,127,31909
1012889,2022-06-30,Varginha/MG,1,415,36,31945
1018486,2022-07-01,Varginha/MG,0,415,136,32081
1024083,2022-07-02,Varginha/MG,0,415,0,32081
1029680,2022-07-03,Varginha/MG,0,415,0,32081
1035277,2022-07-04,Varginha/MG,3,418,37,32118
1040874,2022-07-05,Varginha/MG,4,422,0,32118
1046471,2022-07-06,Varginha/MG,0,422,115,32233
1052068,2022-07-07,Varginha/MG,1,423,0,32233
1057665,2022-07-08,Varginha/MG,0,423,220,32453
1063262,2022-07-09,Varginha/MG,0,423,0,32453
1068859,2022-07-10,Varginha/MG,0,423,0,32453
1074456,2022-07-11,Varginha/MG,0,423,95,32548
1080053,2022-07-12,Varginha/MG,3,426,149,32697
1085650,2022-07-13,Varginha/MG,1,427,49,32746
1091247,2022-07-14,Varginha/MG,0,427,96,32842
1096844,2022-07-15,Varginha/MG,0,427,0,32842
1102441,2022-07-16,Varginha/MG,0,427,0,32842
1108038,2022-07-17,Varginha/MG,0,427,0,32842
1113635,2022-07-18,Varginha/MG,0,427,145,32987
1119232,2022-07-19,Varginha/MG,0,427,104,33091
1124829,2022-07-20,Varginha/MG,2,429,0,33091
1130426,2022-07-21,Varginha/MG,2,431,70,33161
1136023,2022-07-22,Varginha/MG,0,431,147,33308
1141620,2022-07-23,Varginha/MG,0,431,0,33308
1147217,2022-07-24,Varginha/MG,0,431,0,33308
1152814,2022-07-25,Varginha/MG,1,432,-7,33301
1158411,2022-07-26,Varginha/MG,1,433,0,33301
1164008,2022-07-27,Varginha/MG,0,433,120,33421
1169605,2022-07-28,Varginha/MG,0,433,97,33518
1175202,2022-07-29,Varginha/MG,2,435,30,33548
1180799,2022-07-30,Varginha/MG,0,435,0,33548
1186396,2022-07-31,Varginha/MG,0,435,0,33548
1191993,2022-08-01,Varginha/MG,0,435,6,33554
1197590,2022-08-02,Varginha/MG,1,436,36,33590
1203187,2022-08-03,Varginha/MG,0,436,0,33590
1208784,2022-08-04,Varginha/MG,1,437,70,33660
1214381,2022-08-05,Varginha/MG,0,437,0,33660
1219978,2022-08-06,Varginha/MG,0,437,0,33660
1225575,2022-08-07,Varginha/MG,0,437,0,33660
1231172,2022-08-08,Varginha/MG,0,437,19,33679
1236769,2022-08-09,Varginha/MG,0,437,27,33706
1242366,2022-08-10,Varginha/MG,0,437,2,33708
1247963,2022-08-11,Varginha/MG,0,437,0,33708
1253560,2022-08-12,Varginha/MG,0,437,36,33744
1259157,2022-08-13,Varginha/MG,0,437,0,33744
1264754,2022-08-14,Varginha/MG,0,437,0,33744
1270351,2022-08-15,Varginha/MG,0,437,0,33744
1275948,2022-08-16,Varginha/MG,0,437,27,33771
1281545,2022-08-17,Varginha/MG,0,437,18,33789
1287142,2022-08-18,Varginha/MG,1,438,0,33789
1292739,2022-08-19,Varginha/MG,0,438,31,33820
1298336,2022-08-20,Varginha/MG,0,438,0,33820
1303933,2022-08-21,Varginha/MG,0,438,0,33820
1309530,2022-08-22,Varginha/MG,0,438,3,33823
1315127,2022-08-23,Varginha/MG,0,438,27,33850
1320724,2022-08-24,Varginha/MG,0,438,16,33866
1326321,2022-08-25,Varginha/MG,0,438,12,33878
451,2022-01-01,Barbacena/MG,0,312,0,9789
6048,2022-01-02,Barbacena/MG,0,312,0,9789
11645,2022-01-03,Barbacena/MG,0,312,0,9789
17242,2022-01-04,Barbacena/MG,0,312,0,9789
22839,2022-01-05,Barbacena/MG,0,312,0,9789
28436,2022-01-06,Barbacena/MG,0,312,0,9789
34033,2022-01-07,Barbacena/MG,0,312,0,9789
39630,2022-01-08,Barbacena/MG,0,312,0,9789
45227,2022-01-09,Barbacena/MG,0,312,0,9789
50824,2022-01-10,Barbacena/MG,0,312,0,9789
56421,2022-01-11,Barbacena/MG,0,312,0,9789
62018,2022-01-12,Barbacena/MG,0,312,244,10033
67615,2022-01-13,Barbacena/MG,0,312,0,10033
73212,2022-01-14,Barbacena/MG,0,312,85,10118
78809,2022-01-15,Barbacena/MG,0,312,140,10258
84406,2022-01-16,Barbacena/MG,0,312,0,10258
90003,2022-01-17,Barbacena/MG,0,312,0,10258
95600,2022-01-18,Barbacena/MG,0,312,168,10426
101197,2022-01-19,Barbacena/MG,0,312,45,10471
106794,2022-01-20,Barbacena/MG,0,312,65,10536
112391,2022-01-21,Barbacena/MG,0,312,104,10640
117988,2022-01-22,Barbacena/MG,0,312,0,10640
123585,2022-01-23,Barbacena/MG,0,312,0,10640
129182,2022-01-24,Barbacena/MG,0,312,0,10640
134779,2022-01-25,Barbacena/MG,0,312,202,10842
140376,2022-01-26,Barbacena/MG,0,312,0,10842
145973,2022-01-27,Barbacena/MG,0,312,129,10971
151570,2022-01-28,Barbacena/MG,0,312,0,10971
157167,2022-01-29,Barbacena/MG,0,312,450,11421
162764,2022-01-30,Barbacena/MG,1,313,0,11421
168361,2022-01-31,Barbacena/MG,0,313,0,11421
173958,2022-02-01,Barbacena/MG,0,313,0,11421
179555,2022-02-02,Barbacena/MG,0,313,654,12075
185152,2022-02-03,Barbacena/MG,0,313,0,12075
190749,2022-02-04,Barbacena/MG,4,317,268,12343
196346,2022-02-05,Barbacena/MG,1,318,0,12343
201943,2022-02-06,Barbacena/MG,0,318,10,12353
207540,2022-02-07,Barbacena/MG,0,318,0,12353
213137,2022-02-08,Barbacena/MG,0,318,0,12353
218734,2022-02-09,Barbacena/MG,0,318,0,12353
224331,2022-02-10,Barbacena/MG,0,318,360,12713
229928,2022-02-11,Barbacena/MG,5,323,0,12713
235525,2022-02-12,Barbacena/MG,0,323,269,12982
241122,2022-02-13,Barbacena/MG,0,323,0,12982
246719,2022-02-14,Barbacena/MG,0,323,0,12982
252316,2022-02-15,Barbacena/MG,0,323,60,13042
257913,2022-02-16,Barbacena/MG,0,323,286,13328
263510,2022-02-17,Barbacena/MG,0,323,0,13328
269107,2022-02-18,Barbacena/MG,0,323,128,13456
274704,2022-02-19,Barbacena/MG,0,323,0,13456
280301,2022-02-20,Barbacena/MG,0,323,149,13605
285898,2022-02-21,Barbacena/MG,0,323,0,13605
291495,2022-02-22,Barbacena/MG,0,323,0,13605
297092,2022-02-23,Barbacena/MG,8,331,0,13605
302689,2022-02-24,Barbacena/MG,0,331,298,13903
308286,2022-02-25,Barbacena/MG,0,331,0,13903
313883,2022-02-26,Barbacena/MG,1,332,167,14070
319480,2022-02-27,Barbacena/MG,0,332,0,14070
325077,2022-02-28,Barbacena/MG,0,332,0,14070
330674,2022-03-01,Barbacena/MG,0,332,0,14070
336271,2022-03-02,Barbacena/MG,0,332,0,14070
341868,2022-03-03,Barbacena/MG,0,332,0,14070
347465,2022-03-04,Barbacena/MG,1,333,206,14276
353062,2022-03-05,Barbacena/MG,0,333,0,14276
358659,2022-03-06,Barbacena/MG,0,333,0,14276
364256,2022-03-07,Barbacena/MG,0,333,0,14276
369853,2022-03-08,Barbacena/MG,0,333,24,14300
375450,2022-03-09,Barbacena/MG,0,333,49,14349
381047,2022-03-10,Barbacena/MG,0,333,49,14398
386644,2022-03-11,Barbacena/MG,6,339,6,14404
392241,2022-03-12,Barbacena/MG,0,339,7,14411
397838,2022-03-13,Barbacena/MG,0,339,0,14411
403435,2022-03-14,Barbacena/MG,0,339,0,14411
409032,2022-03-15,Barbacena/MG,0,339,4,14415
414629,2022-03-16,Barbacena/MG,0,339,33,14448
420226,2022-03-17,Barbacena/MG,0,339,1,14449
425823,2022-03-18,Barbacena/MG,1,340,11,14460
431420,2022-03-19,Barbacena/MG,0,340,0,14460
437017,2022-03-20,Barbacena/MG,2,342,25,14485
442614,2022-03-21,Barbacena/MG,0,342,0,14485
448211,2022-03-22,Barbacena/MG,0,342,0,14485
453808,2022-03-23,Barbacena/MG,0,342,0,14485
459405,2022-03-24,Barbacena/MG,0,342,0,14485
465002,2022-03-25,Barbacena/MG,0,342,0,14485
470599,2022-03-26,Barbacena/MG,1,343,21,14506
476196,2022-03-27,Barbacena/MG,0,343,0,14506
481793,2022-03-28,Barbacena/MG,0,343,0,14506
487390,2022-03-29,Barbacena/MG,0,343,0,14506
492987,2022-03-30,Barbacena/MG,0,343,7,14513
498584,2022-03-31,Barbacena/MG,0,343,0,14513
504181,2022-04-01,Barbacena/MG,0,343,4,14517
509778,2022-04-02,Barbacena/MG,0,343,0,14517
515375,2022-04-03,Barbacena/MG,0,343,0,14517
520972,2022-04-04,Barbacena/MG,0,343,17,14534
526569,2022-04-05,Barbacena/MG,0,343,0,14534
532166,2022-04-06,Barbacena/MG,0,343,0,14534
537763,2022-04-07,Barbacena/MG,0,343,0,14534
543360,2022-04-08,Barbacena/MG,1,344,0,14534
548957,2022-04-09,Barbacena/MG,0,344,0,14534
554554,2022-04-10,Barbacena/MG,0,344,0,14534
560151,2022-04-11,Barbacena/MG,0,344,0,14534
565748,2022-04-12,Barbacena/MG,0,344,5,14539
571345,2022-04-13,Barbacena/MG,0,344,10,14549
576942,2022-04-14,Barbacena/MG,0,344,0,14549
582539,2022-04-15,Barbacena/MG,0,344,0,14549
588136,2022-04-16,Barbacena/MG,0,344,0,14549
593733,2022-04-17,Barbacena/MG,0,344,5,14554
599330,2022-04-18,Barbacena/MG,0,344,0,14554
604927,2022-04-19,Barbacena/MG,0,344,0,14554
610524,2022-04-20,Barbacena/MG,0,344,4,14558
616121,2022-04-21,Barbacena/MG,0,344,5,14563
621718,2022-04-22,Barbacena/MG,0,344,0,14563
627315,2022-04-23,Barbacena/MG,0,344,0,14563
632912,2022-04-24,Barbacena/MG,0,344,0,14563
638509,2022-04-25,Barbacena/MG,0,344,0,14563
644106,2022-04-26,Barbacena/MG,0,344,0,14563
649703,2022-04-27,Barbacena/MG,0,344,3,14566
655300,2022-04-28,Barbacena/MG,0,344,1,14567
660897,2022-04-29,Barbacena/MG,0,344,0,14567
666494,2022-04-30,Barbacena/MG,0,344,2,14569
672091,2022-05-01,Barbacena/MG,0,344,0,14569
677688,2022-05-02,Barbacena/MG,2,346,0,14569
683285,2022-05-03,Barbacena/MG,0,346,2,14571
688882,2022-05-04,Barbacena/MG,0,346,5,14576
694479,2022-05-05,Barbacena/MG,1,347,4,14580
700076,2022-05-06,Barbacena/MG,0,347,1,14581
705673,2022-05-07,Barbacena/MG,0,347,0,14581
711270,2022-05-08,Barbacena/MG,0,347,0,14581
716867,2022-05-09,Barbacena/MG,1,348,4,14585
722464,2022-05-10,Barbacena/MG,0,348,3,14588
728061,2022-05-11,Barbacena/MG,1,349,5,14593
733658,2022-05-12,Barbacena/MG,0,349,7,14600
739255,2022-05-13,Barbacena/MG,0,349,0,14600
744852,2022-05-14,Barbacena/MG,0,349,0,14600
750449,2022-05-15,Barbacena/MG,0,349,0,14600
756046,2022-05-16,Barbacena/MG,0,349,25,14625
761643,2022-05-17,Barbacena/MG,0,349,0,14625
767240,2022-05-18,Barbacena/MG,-1,348,39,14664
772837,2022-05-19,Barbacena/MG,0,348,47,14711
778434,2022-05-20,Barbacena/MG,0,348,0,14711
784031,2022-05-21,Barbacena/MG,0,348,0,14711
789628,2022-05-22,Barbacena/MG,0,348,0,14711
795225,2022-05-23,Barbacena/MG,0,348,26,14737
800822,2022-05-24,Barbacena/MG,0,348,11,14748
806419,2022-05-25,Barbacena/MG,1,349,36,14784
812016,2022-05-26,Barbacena/MG,0,349,0,14784
817613,2022-05-27,Barbacena/MG,0,349,80,14864
823210,2022-05-28,Barbacena/MG,0,349,0,14864
828807,2022-05-29,Barbacena/MG,0,349,0,14864
834404,2022-05-30,Barbacena/MG,0,349,0,14864
840001,2022-05-31,Barbacena/MG,0,349,0,14864
845598,2022-06-01,Barbacena/MG,0,349,139,15003
851195,2022-06-02,Barbacena/MG,0,349,0,15003
856792,2022-06-03,Barbacena/MG,0,349,78,15081
862389,2022-06-04,Barbacena/MG,0,349,0,15081
867986,2022-06-05,Barbacena/MG,0,349,0,15081
873583,2022-06-06,Barbacena/MG,0,349,0,15081
879180,2022-06-07,Barbacena/MG,0,349,119,15200
884777,2022-06-08,Barbacena/MG,0,349,211,15411
890374,2022-06-09,Barbacena/MG,0,349,0,15411
895971,2022-06-10,Barbacena/MG,0,349,126,15537
901568,2022-06-11,Barbacena/MG,0,349,0,15537
907165,2022-06-12,Barbacena/MG,0,349,0,15537
912762,2022-06-13,Barbacena/MG,0,349,56,15593
918359,2022-06-14,Barbacena/MG,0,349,89,15682
923956,2022-06-15,Barbacena/MG,0,349,27,15709
929553,2022-06-16,Barbacena/MG,0,349,0,15709
935150,2022-06-17,Barbacena/MG,0,349,0,15709
940747,2022-06-18,Barbacena/MG,0,349,0,15709
946344,2022-06-19,Barbacena/MG,0,349,0,15709
951941,2022-06-20,Barbacena/MG,0,349,0,15709
957538,2022-06-21,Barbacena/MG,0,349,0,15709
963135,2022-06-22,Barbacena/MG,0,349,0,15709
968732,2022-06-23,Barbacena/MG,0,349,0,15709
974329,2022-06-24,Barbacena/MG,0,349,0,15709
979926,2022-06-25,Barbacena/MG,0,349,0,15709
985523,2022-06-26,Barbacena/MG,0,349,0,15709
991120,2022-06-27,Barbacena/MG,2,351,544,16253
996717,2022-06-28,Barbacena/MG,0,351,0,16253
1002314,2022-06-29,Barbacena/MG,0,351,0,16253
1007911,2022-06-30,Barbacena/MG,1,352,307,16560
1013508,2022-07-01,Barbacena/MG,0,352,0,16560
1019105,2022-07-02,Barbacena/MG,0,352,0,16560
1024702,2022-07-03,Barbacena/MG,0,352,0,16560
1030299,2022-07-04,Barbacena/MG,0,352,0,16560
1035896,2022-07-05,Barbacena/MG,0,352,128,16688
1041493,2022-07-06,Barbacena/MG,0,352,0,16688
1047090,2022-07-07,Barbacena/MG,0,352,172,16860
1052687,2022-07-08,Barbacena/MG,0,352,0,16860
1058284,2022-07-09,Barbacena/MG,0,352,0,16860
1063881,2022-07-10,Barbacena/MG,0,352,0,16860
1069478,2022-07-11,Barbacena/MG,0,352,0,16860
1075075,2022-07-12,Barbacena/MG,0,352,0,16860
1080672,2022-07-13,Barbacena/MG,0,352,0,16860
1086269,2022-07-14,Barbacena/MG,0,352,323,17183
1091866,2022-07-15,Barbacena/MG,0,352,110,17293
1097463,2022-07-16,Barbacena/MG,0,352,0,17293
1103060,2022-07-17,Barbacena/MG,0,352,0,17293
1108657,2022-07-18,Barbacena/MG,0,352,27,17320
1114254,2022-07-19,Barbacena/MG,0,352,43,17363
1119851,2022-07-20,Barbacena/MG,0,352,327,17690
1125448,2022-07-21,Barbacena/MG,0,352,42,17732
1131045,2022-07-22,Barbacena/MG,0,352,0,17732
1136642,2022-07-23,Barbacena/MG,0,352,0,17732
1142239,2022-07-24,Barbacena/MG,0,352,0,17732
1147836,2022-07-25,Barbacena/MG,0,352,0,17732
1153433,2022-07-26,Barbacena/MG,0,352,126,17858
1159030,2022-07-27,Barbacena/MG,1,353,0,17858
1164627,2022-07-28,Barbacena/MG,0,353,120,17978
1170224,2022-07-29,Barbacena/MG,0,353,55,18033
1175821,2022-07-30,Barbacena/MG,0,353,0,18033
1181418,2022-07-31,Barbacena/MG,0,353,0,18033
1187015,2022-08-01,Barbacena/MG,0,353,49,18082
1192612,2022-08-02,Barbacena/MG,2,355,0,18082
1198209,2022-08-03,Barbacena/MG,0,355,94,18176
1203806,2022-08-04,Barbacena/MG,0,355,0,18176
1209403,2022-08-05,Barbacena/MG,0,355,0,18176
1215000,2022-08-06,Barbacena/MG,0,355,0,18176
1220597,2022-08-07,Barbacena/MG,0,355,0,18176
1226194,2022-08-08,Barbacena/MG,1,356,0,18176
1231791,2022-08-09,Barbacena/MG,0,356,0,18176
1237388,2022-08-10,Barbacena/MG,0,356,139,18315
1242985,2022-08-11,Barbacena/MG,0,356,0,18315
1248582,2022-08-12,Barbacena/MG,1,357,0,18315
1254179,2022-08-13,Barbacena/MG,0,357,0,18315
1259776,2022-08-14,Barbacena/MG,0,357,0,18315
1265373,2022-08-15,Barbacena/MG,0,357,0,18315
1270970,2022-08-16,Barbacena/MG,0,357,55,18370
1276567,2022-08-17,Barbacena/MG,0,357,8,18378
1282164,2022-08-18,Barbacena/MG,0,357,19,18397
1287761,2022-08-19,Barbacena/MG,0,357,13,18410
1293358,2022-08-20,Barbacena/MG,0,357,0,18410
1298955,2022-08-21,Barbacena/MG,0,357,0,18410
1304552,2022-08-22,Barbacena/MG,0,357,12,18422
1310149,2022-08-23,Barbacena/MG,0,357,0,18422
1315746,2022-08-24,Barbacena/MG,0,357,4,18426
1321343,2022-08-25,Barbacena/MG,0,357,3,18429
3246,2022-01-01,Nepomuceno/MG,0,44,0,2793
8843,2022-01-02,Nepomuceno/MG,0,44,0,2793
14440,2022-01-03,Nepomuceno/MG,0,44,0,2793
20037,2022-01-04,Nepomuceno/MG,0,44,2,2795
25634,2022-01-05,Nepomuceno/MG,0,44,0,2795
31231,2022-01-06,Nepomuceno/MG,0,44,5,2800
36828,2022-01-07,Nepomuceno/MG,0,44,11,2811
42425,2022-01-08,Nepomuceno/MG,0,44,22,2833
48022,2022-01-09,Nepomuceno/MG,0,44,0,2833
53619,2022-01-10,Nepomuceno/MG,0,44,26,2859
59216,2022-01-11,Nepomuceno/MG,0,44,0,2859
64813,2022-01-12,Nepomuceno/MG,0,44,34,2893
70410,2022-01-13,Nepomuceno/MG,0,44,0,2893
76007,2022-01-14,Nepomuceno/MG,0,44,81,2974
81604,2022-01-15,Nepomuceno/MG,0,44,63,3037
87201,2022-01-16,Nepomuceno/MG,0,44,0,3037
92798,2022-01-17,Nepomuceno/MG,0,44,65,3102
98395,2022-01-18,Nepomuceno/MG,0,44,0,3102
103992,2022-01-19,Nepomuceno/MG,0,44,103,3205
109589,2022-01-20,Nepomuceno/MG,0,44,75,3280
115186,2022-01-21,Nepomuceno/MG,0,44,55,3335
120783,2022-01-22,Nepomuceno/MG,0,44,56,3391
126380,2022-01-23,Nepomuceno/MG,0,44,0,3391
131977,2022-01-24,Nepomuceno/MG,0,44,0,3391
137574,2022-01-25,Nepomuceno/MG,0,44,100,3491
143171,2022-01-26,Nepomuceno/MG,1,45,63,3554
148768,2022-01-27,Nepomuceno/MG,1,46,92,3646
154365,2022-01-28,Nepomuceno/MG,0,46,90,3736
159962,2022-01-29,Nepomuceno/MG,0,46,57,3793
165559,2022-01-30,Nepomuceno/MG,2,48,42,3835
171156,2022-01-31,Nepomuceno/MG,0,48,0,3835
176753,2022-02-01,Nepomuceno/MG,0,48,63,3898
182350,2022-02-02,Nepomuceno/MG,0,48,0,3898
187947,2022-02-03,Nepomuceno/MG,0,48,151,4049
193544,2022-02-04,Nepomuceno/MG,0,48,40,4089
199141,2022-02-05,Nepomuceno/MG,0,48,35,4124
204738,2022-02-06,Nepomuceno/MG,0,48,0,4124
210335,2022-02-07,Nepomuceno/MG,0,48,0,4124
215932,2022-02-08,Nepomuceno/MG,0,48,64,4188
221529,2022-02-09,Nepomuceno/MG,0,48,69,4257
227126,2022-02-10,Nepomuceno/MG,1,49,0,4257
232723,2022-02-11,Nepomuceno/MG,0,49,98,4355
238320,2022-02-12,Nepomuceno/MG,0,49,0,4355
243917,2022-02-13,Nepomuceno/MG,2,51,78,4433
249514,2022-02-14,Nepomuceno/MG,0,51,0,4433
255111,2022-02-15,Nepomuceno/MG,0,51,10,4443
260708,2022-02-16,Nepomuceno/MG,0,51,32,4475
266305,2022-02-17,Nepomuceno/MG,1,52,35,4510
271902,2022-02-18,Nepomuceno/MG,1,53,27,4537
277499,2022-02-19,Nepomuceno/MG,0,53,35,4572
283096,2022-02-20,Nepomuceno/MG,0,53,0,4572
288693,2022-02-21,Nepomuceno/MG,0,53,0,4572
294290,2022-02-22,Nepomuceno/MG,0,53,33,4605
299887,2022-02-23,Nepomuceno/MG,0,53,36,4641
305484,2022-02-24,Nepomuceno/MG,0,53,25,4666
311081,2022-02-25,Nepomuceno/MG,0,53,11,4677
316678,2022-02-26,Nepomuceno/MG,0,53,16,4693
322275,2022-02-27,Nepomuceno/MG,0,53,23,4716
327872,2022-02-28,Nepomuceno/MG,0,53,0,4716
333469,2022-03-01,Nepomuceno/MG,0,53,11,4727
339066,2022-03-02,Nepomuceno/MG,0,53,0,4727
344663,2022-03-03,Nepomuceno/MG,0,53,0,4727
350260,2022-03-04,Nepomuceno/MG,0,53,0,4727
355857,2022-03-05,Nepomuceno/MG,0,53,16,4743
361454,2022-03-06,Nepomuceno/MG,0,53,10,4753
367051,2022-03-07,Nepomuceno/MG,0,53,0,4753
372648,2022-03-08,Nepomuceno/MG,0,53,0,4753
378245,2022-03-09,Nepomuceno/MG,0,53,12,4765
383842,2022-03-10,Nepomuceno/MG,0,53,1,4766
389439,2022-03-11,Nepomuceno/MG,0,53,1,4767
395036,2022-03-12,Nepomuceno/MG,0,53,2,4769
400633,2022-03-13,Nepomuceno/MG,0,53,3,4772
406230,2022-03-14,Nepomuceno/MG,0,53,0,4772
411827,2022-03-15,Nepomuceno/MG,0,53,0,4772
417424,2022-03-16,Nepomuceno/MG,0,53,3,4775
423021,2022-03-17,Nepomuceno/MG,0,53,0,4775
428618,2022-03-18,Nepomuceno/MG,0,53,0,4775
434215,2022-03-19,Nepomuceno/MG,0,53,3,4778
439812,2022-03-20,Nepomuceno/MG,0,53,0,4778
445409,2022-03-21,Nepomuceno/MG,0,53,0,4778
451006,2022-03-22,Nepomuceno/MG,0,53,2,4780
456603,2022-03-23,Nepomuceno/MG,0,53,2,4782
462200,2022-03-24,Nepomuceno/MG,0,53,3,4785
467797,2022-03-25,Nepomuceno/MG,0,53,2,4787
473394,2022-03-26,Nepomuceno/MG,0,53,2,4789
478991,2022-03-27,Nepomuceno/MG,0,53,1,4790
484588,2022-03-28,Nepomuceno/MG,0,53,0,4790
490185,2022-03-29,Nepomuceno/MG,0,53,0,4790
495782,2022-03-30,Nepomuceno/MG,0,53,2,4792
501379,2022-03-31,Nepomuceno/MG,0,53,0,4792
506976,2022-04-01,Nepomuceno/MG,0,53,2,4794
512573,2022-04-02,Nepomuceno/MG,0,53,0,4794
518170,2022-04-03,Nepomuceno/MG,0,53,0,4794
523767,2022-04-04,Nepomuceno/MG,0,53,0,4794
529364,2022-04-05,Nepomuceno/MG,0,53,1,4795
534961,2022-04-06,Nepomuceno/MG,0,53,2,4797
540558,2022-04-07,Nepomuceno/MG,0,53,0,4797
546155,2022-04-08,Nepomuceno/MG,0,53,0,4797
551752,2022-04-09,Nepomuceno/MG,0,53,0,4797
557349,2022-04-10,Nepomuceno/MG,0,53,0,4797
562946,2022-04-11,Nepomuceno/MG,0,53,0,4797
568543,2022-04-12,Nepomuceno/MG,0,53,1,4798
574140,2022-04-13,Nepomuceno/MG,0,53,1,4799
579737,2022-04-14,Nepomuceno/MG,0,53,0,4799
585334,2022-04-15,Nepomuceno/MG,0,53,0,4799
590931,2022-04-16,Nepomuceno/MG,0,53,0,4799
596528,2022-04-17,Nepomuceno/MG,0,53,0,4799
602125,2022-04-18,Nepomuceno/MG,0,53,0,4799
607722,2022-04-19,Nepomuceno/MG,0,53,1,4800
613319,2022-04-20,Nepomuceno/MG,0,53,3,4803
618916,2022-04-21,Nepomuceno/MG,0,53,0,4803
624513,2022-04-22,Nepomuceno/MG,0,53,0,4803
630110,2022-04-23,Nepomuceno/MG,0,53,0,4803
635707,2022-04-24,Nepomuceno/MG,0,53,0,4803
641304,2022-04-25,Nepomuceno/MG,0,53,0,4803
646901,2022-04-26,Nepomuceno/MG,0,53,1,4804
652498,2022-04-27,Nepomuceno/MG,0,53,1,4805
658095,2022-04-28,Nepomuceno/MG,0,53,0,4805
663692,2022-04-29,Nepomuceno/MG,0,53,1,4806
669289,2022-04-30,Nepomuceno/MG,0,53,2,4808
674886,2022-05-01,Nepomuceno/MG,0,53,2,4810
680483,2022-05-02,Nepomuceno/MG,0,53,0,4810
686080,2022-05-03,Nepomuceno/MG,0,53,1,4811
691677,2022-05-04,Nepomuceno/MG,0,53,5,4816
697274,2022-05-05,Nepomuceno/MG,0,53,4,4820
702871,2022-05-06,Nepomuceno/MG,0,53,5,4825
708468,2022-05-07,Nepomuceno/MG,0,53,0,4825
714065,2022-05-08,Nepomuceno/MG,0,53,0,4825
719662,2022-05-09,Nepomuceno/MG,0,53,4,4829
725259,2022-05-10,Nepomuceno/MG,0,53,7,4836
730856,2022-05-11,Nepomuceno/MG,0,53,7,4843
736453,2022-05-12,Nepomuceno/MG,0,53,4,4847
742050,2022-05-13,Nepomuceno/MG,0,53,3,4850
747647,2022-05-14,Nepomuceno/MG,0,53,0,4850
753244,2022-05-15,Nepomuceno/MG,0,53,0,4850
758841,2022-05-16,Nepomuceno/MG,0,53,8,4858
764438,2022-05-17,Nepomuceno/MG,0,53,0,4858
770035,2022-05-18,Nepomuceno/MG,0,53,5,4863
775632,2022-05-19,Nepomuceno/MG,0,53,5,4868
781229,2022-05-20,Nepomuceno/MG,0,53,5,4873
786826,2022-05-21,Nepomuceno/MG,0,53,0,4873
792423,2022-05-22,Nepomuceno/MG,0,53,0,4873
798020,2022-05-23,Nepomuceno/MG,0,53,7,4880
803617,2022-05-24,Nepomuceno/MG,0,53,0,4880
809214,2022-05-25,Nepomuceno/MG,0,53,9,4889
814811,2022-05-26,Nepomuceno/MG,0,53,1,4890
820408,2022-05-27,Nepomuceno/MG,0,53,2,4892
826005,2022-05-28,Nepomuceno/MG,0,53,0,4892
831602,2022-05-29,Nepomuceno/MG,0,53,0,4892
837199,2022-05-30,Nepomuceno/MG,0,53,7,4899
842796,2022-05-31,Nepomuceno/MG,0,53,19,4918
848393,2022-06-01,Nepomuceno/MG,0,53,28,4946
853990,2022-06-02,Nepomuceno/MG,0,53,11,4957
859587,2022-06-03,Nepomuceno/MG,0,53,12,4969
865184,2022-06-04,Nepomuceno/MG,0,53,0,4969
870781,2022-06-05,Nepomuceno/MG,0,53,0,4969
876378,2022-06-06,Nepomuceno/MG,0,53,16,4985
881975,2022-06-07,Nepomuceno/MG,0,53,17,5002
887572,2022-06-08,Nepomuceno/MG,0,53,18,5020
893169,2022-06-09,Nepomuceno/MG,0,53,14,5034
898766,2022-06-10,Nepomuceno/MG,0,53,11,5045
904363,2022-06-11,Nepomuceno/MG,0,53,0,5045
909960,2022-06-12,Nepomuceno/MG,0,53,0,5045
915557,2022-06-13,Nepomuceno/MG,0,53,31,5076
921154,2022-06-14,Nepomuceno/MG,0,53,0,5076
926751,2022-06-15,Nepomuceno/MG,0,53,17,5093
932348,2022-06-16,Nepomuceno/MG,0,53,0,5093
937945,2022-06-17,Nepomuceno/MG,0,53,0,5093
943542,2022-06-18,Nepomuceno/MG,0,53,0,5093
949139,2022-06-19,Nepomuceno/MG,0,53,0,5093
954736,2022-06-20,Nepomuceno/MG,0,53,7,5100
960333,2022-06-21,Nepomuceno/MG,0,53,10,5110
965930,2022-06-22,Nepomuceno/MG,0,53,12,5122
971527,2022-06-23,Nepomuceno/MG,0,53,12,5134
977124,2022-06-24,Nepomuceno/MG,0,53,5,5139
982721,2022-06-25,Nepomuceno/MG,0,53,0,5139
988318,2022-06-26,Nepomuceno/MG,0,53,0,5139
993915,2022-06-27,Nepomuceno/MG,0,53,6,5145
999512,2022-06-28,Nepomuceno/MG,0,53,14,5159
1005109,2022-06-29,Nepomuceno/MG,0,53,14,5173
1010706,2022-06-30,Nepomuceno/MG,0,53,9,5182
1016303,2022-07-01,Nepomuceno/MG,0,53,12,5194
1021900,2022-07-02,Nepomuceno/MG,0,53,0,5194
1027497,2022-07-03,Nepomuceno/MG,0,53,0,5194
1033094,2022-07-04,Nepomuceno/MG,0,53,4,5198
1038691,2022-07-05,Nepomuceno/MG,0,53,15,5213
1044288,2022-07-06,Nepomuceno/MG,0,53,16,5229
1049885,2022-07-07,Nepomuceno/MG,0,53,9,5238
1055482,2022-07-08,Nepomuceno/MG,0,53,12,5250
1061079,2022-07-09,Nepomuceno/MG,0,53,0,5250
1066676,2022-07-10,Nepomuceno/MG,0,53,0,5250
1072273,2022-07-11,Nepomuceno/MG,1,54,0,5250
1077870,2022-07-12,Nepomuceno/MG,0,54,6,5256
1083467,2022-07-13,Nepomuceno/MG,0,54,10,5266
1089064,2022-07-14,Nepomuceno/MG,0,54,5,5271
1094661,2022-07-15,Nepomuceno/MG,0,54,16,5287
1100258,2022-07-16,Nepomuceno/MG,0,54,0,5287
1105855,2022-07-17,Nepomuceno/MG,0,54,0,5287
1111452,2022-07-18,Nepomuceno/MG,0,54,3,5290
1117049,2022-07-19,Nepomuceno/MG,0,54,10,5300
1122646,2022-07-20,Nepomuceno/MG,0,54,8,5308
1128243,2022-07-21,Nepomuceno/MG,0,54,0,5308
1133840,2022-07-22,Nepomuceno/MG,0,54,14,5322
1139437,2022-07-23,Nepomuceno/MG,0,54,0,5322
1145034,2022-07-24,Nepomuceno/MG,0,54,0,5322
1150631,2022-07-25,Nepomuceno/MG,0,54,6,5328
1156228,2022-07-26,Nepomuceno/MG,0,54,6,5334
1161825,2022-07-27,Nepomuceno/MG,0,54,6,5340
1167422,2022-07-28,Nepomuceno/MG,0,54,8,5348
1173019,2022-07-29,Nepomuceno/MG,0,54,6,5354
1178616,2022-07-30,Nepomuceno/MG,0,54,0,5354
1184213,2022-07-31,Nepomuceno/MG,0,54,0,5354
1189810,2022-08-01,Nepomuceno/MG,0,54,0,5354
1195407,2022-08-02,Nepomuceno/MG,0,54,6,5360
1201004,2022-08-03,Nepomuceno/MG,0,54,5,5365
1206601,2022-08-04,Nepomuceno/MG,0,54,0,5365
1212198,2022-08-05,Nepomuceno/MG,0,54,2,5367
1217795,2022-08-06,Nepomuceno/MG,0,54,0,5367
1223392,2022-08-07,Nepomuceno/MG,0,54,0,5367
1228989,2022-08-08,Nepomuceno/MG,0,54,3,5370
1234586,2022-08-09,Nepomuceno/MG,0,54,2,5372
1240183,2022-08-10,Nepomuceno/MG,0,54,3,5375
1245780,2022-08-11,Nepomuceno/MG,0,54,0,5375
1251377,2022-08-12,Nepomuceno/MG,0,54,0,5375
1256974,2022-08-13,Nepomuceno/MG,0,54,0,5375
1262571,2022-08-14,Nepomuceno/MG,0,54,0,5375
1268168,2022-08-15,Nepomuceno/MG,0,54,0,5375
1273765,2022-08-16,Nepomuceno/MG,0,54,2,5377
1279362,2022-08-17,Nepomuceno/MG,0,54,2,5379
1284959,2022-08-18,Nepomuceno/MG,0,54,0,5379
1290556,2022-08-19,Nepomuceno/MG,0,54,0,5379
1296153,2022-08-20,Nepomuceno/MG,0,54,0,5379
1301750,2022-08-21,Nepomuceno/MG,0,54,0,5379
1307347,2022-08-22,Nepomuceno/MG,0,54,0,5379
1312944,2022-08-23,Nepomuceno/MG,0,54,0,5379
1318541,2022-08-24,Nepomuceno/MG,0,54,0,5379
1324138,2022-08-25,Nepomuceno/MG,0,54,1,5380
4935,2022-01-01,São João del Rei/MG,0,228,0,10326
10532,2022-01-02,São João del Rei/MG,0,228,0,10326
16129,2022-01-03,São João del Rei/MG,0,228,0,10326
21726,2022-01-04,São João del Rei/MG,0,228,8,10334
27323,2022-01-05,São João del Rei/MG,0,228,0,10334
32920,2022-01-06,São João del Rei/MG,0,228,37,10371
38517,2022-01-07,São João del Rei/MG,0,228,40,10411
44114,2022-01-08,São João del Rei/MG,0,228,54,10465
49711,2022-01-09,São João del Rei/MG,0,228,0,10465
55308,2022-01-10,São João del Rei/MG,0,228,0,10465
60905,2022-01-11,São João del Rei/MG,0,228,115,10580
66502,2022-01-12,São João del Rei/MG,0,228,133,10713
72099,2022-01-13,São João del Rei/MG,0,228,92,10805
77696,2022-01-14,São João del Rei/MG,0,228,0,10805
83293,2022-01-15,São João del Rei/MG,0,228,0,10805
88890,2022-01-16,São João del Rei/MG,0,228,0,10805
94487,2022-01-17,São João del Rei/MG,0,228,222,11027
100084,2022-01-18,São João del Rei/MG,0,228,0,11027
105681,2022-01-19,São João del Rei/MG,0,228,293,11320
111278,2022-01-20,São João del Rei/MG,0,228,163,11483
116875,2022-01-21,São João del Rei/MG,0,228,145,11628
122472,2022-01-22,São João del Rei/MG,0,228,213,11841
128069,2022-01-23,São João del Rei/MG,0,228,0,11841
133666,2022-01-24,São João del Rei/MG,0,228,0,11841
139263,2022-01-25,São João del Rei/MG,0,228,300,12141
144860,2022-01-26,São João del Rei/MG,0,228,512,12653
150457,2022-01-27,São João del Rei/MG,0,228,616,13269
156054,2022-01-28,São João del Rei/MG,0,228,445,13714
161651,2022-01-29,São João del Rei/MG,0,228,321,14035
167248,2022-01-30,São João del Rei/MG,0,228,0,14035
172845,2022-01-31,São João del Rei/MG,0,228,0,14035
178442,2022-02-01,São João del Rei/MG,0,228,0,14035
184039,2022-02-02,São João del Rei/MG,0,228,580,14615
189636,2022-02-03,São João del Rei/MG,0,228,277,14892
195233,2022-02-04,São João del Rei/MG,0,228,258,15150
200830,2022-02-05,São João del Rei/MG,0,228,237,15387
206427,2022-02-06,São João del Rei/MG,11,239,0,15387
212024,2022-02-07,São João del Rei/MG,6,245,0,15387
217621,2022-02-08,São João del Rei/MG,0,245,0,15387
223218,2022-02-09,São João del Rei/MG,1,246,415,15802
228815,2022-02-10,São João del Rei/MG,1,247,136,15938
234412,2022-02-11,São João del Rei/MG,3,250,79,16017
240009,2022-02-12,São João del Rei/MG,0,250,155,16172
245606,2022-02-13,São João del Rei/MG,0,250,0,16172
251203,2022-02-14,São João del Rei/MG,0,250,0,16172
256800,2022-02-15,São João del Rei/MG,0,250,86,16258
262397,2022-02-16,São João del Rei/MG,0,250,199,16457
267994,2022-02-17,São João del Rei/MG,0,250,107,16564
273591,2022-02-18,São João del Rei/MG,2,252,51,16615
279188,2022-02-19,São João del Rei/MG,0,252,52,16667
284785,2022-02-20,São João del Rei/MG,1,253,0,16667
290382,2022-02-21,São João del Rei/MG,0,253,0,16667
295979,2022-02-22,São João del Rei/MG,0,253,34,16701
301576,2022-02-23,São João del Rei/MG,0,253,73,16774
307173,2022-02-24,São João del Rei/MG,0,253,0,16774
312770,2022-02-25,São João del Rei/MG,0,253,79,16853
318367,2022-02-26,São João del Rei/MG,0,253,11,16864
323964,2022-02-27,São João del Rei/MG,0,253,0,16864
329561,2022-02-28,São João del Rei/MG,0,253,0,16864
335158,2022-03-01,São João del Rei/MG,0,253,0,16864
340755,2022-03-02,São João del Rei/MG,0,253,0,16864
346352,2022-03-03,São João del Rei/MG,0,253,0,16864
351949,2022-03-04,São João del Rei/MG,0,253,0,16864
357546,2022-03-05,São João del Rei/MG,0,253,101,16965
363143,2022-03-06,São João del Rei/MG,4,257,0,16965
368740,2022-03-07,São João del Rei/MG,1,258,0,16965
374337,2022-03-08,São João del Rei/MG,0,258,32,16997
379934,2022-03-09,São João del Rei/MG,0,258,17,17014
385531,2022-03-10,São João del Rei/MG,0,258,14,17028
391128,2022-03-11,São João del Rei/MG,0,258,7,17035
396725,2022-03-12,São João del Rei/MG,0,258,7,17042
402322,2022-03-13,São João del Rei/MG,0,258,0,17042
407919,2022-03-14,São João del Rei/MG,0,258,0,17042
413516,2022-03-15,São João del Rei/MG,0,258,11,17053
419113,2022-03-16,São João del Rei/MG,0,258,12,17065
424710,2022-03-17,São João del Rei/MG,0,258,3,17068
430307,2022-03-18,São João del Rei/MG,0,258,2,17070
435904,2022-03-19,São João del Rei/MG,0,258,4,17074
441501,2022-03-20,São João del Rei/MG,0,258,0,17074
447098,2022-03-21,São João del Rei/MG,0,258,0,17074
452695,2022-03-22,São João del Rei/MG,0,258,6,17080
458292,2022-03-23,São João del Rei/MG,0,258,2,17082
463889,2022-03-24,São João del Rei/MG,0,258,1,17083
469486,2022-03-25,São João del Rei/MG,0,258,0,17083
475083,2022-03-26,São João del Rei/MG,1,259,0,17083
480680,2022-03-27,São João del Rei/MG,0,259,0,17083
486277,2022-03-28,São João del Rei/MG,0,259,0,17083
491874,2022-03-29,São João del Rei/MG,0,259,0,17083
497471,2022-03-30,São João del Rei/MG,0,259,2,17085
503068,2022-03-31,São João del Rei/MG,0,259,0,17085
508665,2022-04-01,São João del Rei/MG,0,259,2,17087
514262,2022-04-02,São João del Rei/MG,0,259,0,17087
519859,2022-04-03,São João del Rei/MG,0,259,0,17087
525456,2022-04-04,São João del Rei/MG,0,259,0,17087
531053,2022-04-05,São João del Rei/MG,0,259,3,17090
536650,2022-04-06,São João del Rei/MG,0,259,5,17095
542247,2022-04-07,São João del Rei/MG,0,259,4,17099
547844,2022-04-08,São João del Rei/MG,0,259,1,17100
553441,2022-04-09,São João del Rei/MG,0,259,2,17102
559038,2022-04-10,São João del Rei/MG,0,259,0,17102
564635,2022-04-11,São João del Rei/MG,0,259,0,17102
570232,2022-04-12,São João del Rei/MG,0,259,2,17104
575829,2022-04-13,São João del Rei/MG,0,259,2,17106
581426,2022-04-14,São João del Rei/MG,0,259,2,17108
587023,2022-04-15,São João del Rei/MG,0,259,0,17108
592620,2022-04-16,São João del Rei/MG,0,259,0,17108
598217,2022-04-17,São João del Rei/MG,0,259,0,17108
603814,2022-04-18,São João del Rei/MG,0,259,0,17108
609411,2022-04-19,São João del Rei/MG,0,259,0,17108
615008,2022-04-20,São João del Rei/MG,0,259,5,17113
620605,2022-04-21,São João del Rei/MG,0,259,0,17113
626202,2022-04-22,São João del Rei/MG,0,259,0,17113
631799,2022-04-23,São João del Rei/MG,0,259,0,17113
637396,2022-04-24,São João del Rei/MG,0,259,0,17113
642993,2022-04-25,São João del Rei/MG,0,259,0,17113
648590,2022-04-26,São João del Rei/MG,0,259,0,17113
654187,2022-04-27,São João del Rei/MG,0,259,4,17117
659784,2022-04-28,São João del Rei/MG,0,259,0,17117
665381,2022-04-29,São João del Rei/MG,0,259,3,17120
670978,2022-04-30,São João del Rei/MG,0,259,0,17120
676575,2022-05-01,São João del Rei/MG,0,259,0,17120
682172,2022-05-02,São João del Rei/MG,0,259,0,17120
687769,2022-05-03,São João del Rei/MG,0,259,3,17123
693366,2022-05-04,São João del Rei/MG,0,259,1,17124
698963,2022-05-05,São João del Rei/MG,0,259,0,17124
704560,2022-05-06,São João del Rei/MG,0,259,3,17127
710157,2022-05-07,São João del Rei/MG,0,259,0,17127
715754,2022-05-08,São João del Rei/MG,0,259,0,17127
721351,2022-05-09,São João del Rei/MG,0,259,0,17127
726948,2022-05-10,São João del Rei/MG,0,259,5,17132
732545,2022-05-11,São João del Rei/MG,0,259,7,17139
738142,2022-05-12,São João del Rei/MG,0,259,0,17139
743739,2022-05-13,São João del Rei/MG,0,259,0,17139
749336,2022-05-14,São João del Rei/MG,0,259,0,17139
754933,2022-05-15,São João del Rei/MG,0,259,0,17139
760530,2022-05-16,São João del Rei/MG,0,259,6,17145
766127,2022-05-17,São João del Rei/MG,0,259,10,17155
771724,2022-05-18,São João del Rei/MG,0,259,17,17172
777321,2022-05-19,São João del Rei/MG,0,259,0,17172
782918,2022-05-20,São João del Rei/MG,0,259,16,17188
788515,2022-05-21,São João del Rei/MG,0,259,0,17188
794112,2022-05-22,São João del Rei/MG,0,259,0,17188
799709,2022-05-23,São João del Rei/MG,0,259,0,17188
805306,2022-05-24,São João del Rei/MG,0,259,32,17220
810903,2022-05-25,São João del Rei/MG,0,259,22,17242
816500,2022-05-26,São João del Rei/MG,0,259,0,17242
822097,2022-05-27,São João del Rei/MG,0,259,40,17282
827694,2022-05-28,São João del Rei/MG,0,259,0,17282
833291,2022-05-29,São João del Rei/MG,0,259,0,17282
838888,2022-05-30,São João del Rei/MG,0,259,0,17282
844485,2022-05-31,São João del Rei/MG,0,259,78,17360
850082,2022-06-01,São João del Rei/MG,0,259,44,17404
855679,2022-06-02,São João del Rei/MG,0,259,44,17448
861276,2022-06-03,São João del Rei/MG,0,259,50,17498
866873,2022-06-04,São João del Rei/MG,0,259,0,17498
872470,2022-06-05,São João del Rei/MG,0,259,0,17498
878067,2022-06-06,São João del Rei/MG,0,259,49,17547
883664,2022-06-07,São João del Rei/MG,0,259,82,17629
889261,2022-06-08,São João del Rei/MG,2,261,69,17698
894858,2022-06-09,São João del Rei/MG,0,261,39,17737
900455,2022-06-10,São João del Rei/MG,0,261,63,17800
906052,2022-06-11,São João del Rei/MG,0,261,0,17800
911649,2022-06-12,São João del Rei/MG,0,261,0,17800
917246,2022-06-13,São João del Rei/MG,0,261,31,17831
922843,2022-06-14,São João del Rei/MG,0,261,0,17831
928440,2022-06-15,São João del Rei/MG,0,261,97,17928
934037,2022-06-16,São João del Rei/MG,0,261,0,17928
939634,2022-06-17,São João del Rei/MG,0,261,0,17928
945231,2022-06-18,São João del Rei/MG,0,261,0,17928
950828,2022-06-19,São João del Rei/MG,0,261,0,17928
956425,2022-06-20,São João del Rei/MG,0,261,0,17928
962022,2022-06-21,São João del Rei/MG,0,261,0,17928
967619,2022-06-22,São João del Rei/MG,0,261,120,18048
973216,2022-06-23,São João del Rei/MG,0,261,62,18110
978813,2022-06-24,São João del Rei/MG,0,261,119,18229
984410,2022-06-25,São João del Rei/MG,0,261,0,18229
990007,2022-06-26,São João del Rei/MG,0,261,0,18229
995604,2022-06-27,São João del Rei/MG,0,261,62,18291
1001201,2022-06-28,São João del Rei/MG,0,261,0,18291
1006798,2022-06-29,São João del Rei/MG,0,261,125,18416
1012395,2022-06-30,São João del Rei/MG,1,262,58,18474
1017992,2022-07-01,São João del Rei/MG,0,262,29,18503
1023589,2022-07-02,São João del Rei/MG,0,262,0,18503
1029186,2022-07-03,São João del Rei/MG,0,262,0,18503
1034783,2022-07-04,São João del Rei/MG,0,262,36,18539
1040380,2022-07-05,São João del Rei/MG,0,262,69,18608
1045977,2022-07-06,São João del Rei/MG,0,262,38,18646
1051574,2022-07-07,São João del Rei/MG,0,262,20,18666
1057171,2022-07-08,São João del Rei/MG,0,262,20,18686
1062768,2022-07-09,São João del Rei/MG,0,262,0,18686
1068365,2022-07-10,São João del Rei/MG,0,262,0,18686
1073962,2022-07-11,São João del Rei/MG,0,262,31,18717
1079559,2022-07-12,São João del Rei/MG,0,262,35,18752
1085156,2022-07-13,São João del Rei/MG,0,262,50,18802
1090753,2022-07-14,São João del Rei/MG,0,262,29,18831
1096350,2022-07-15,São João del Rei/MG,0,262,56,18887
1101947,2022-07-16,São João del Rei/MG,0,262,0,18887
1107544,2022-07-17,São João del Rei/MG,0,262,0,18887
1113141,2022-07-18,São João del Rei/MG,0,262,0,18887
1118738,2022-07-19,São João del Rei/MG,0,262,0,18887
1124335,2022-07-20,São João del Rei/MG,0,262,0,18887
1129932,2022-07-21,São João del Rei/MG,0,262,0,18887
1135529,2022-07-22,São João del Rei/MG,0,262,0,18887
1141126,2022-07-23,São João del Rei/MG,0,262,0,18887
1146723,2022-07-24,São João del Rei/MG,0,262,0,18887
1152320,2022-07-25,São João del Rei/MG,0,262,246,19133
1157917,2022-07-26,São João del Rei/MG,0,262,0,19133
1163514,2022-07-27,São João del Rei/MG,0,262,0,19133
1169111,2022-07-28,São João del Rei/MG,0,262,0,19133
1174708,2022-07-29,São João del Rei/MG,0,262,0,19133
1180305,2022-07-30,São João del Rei/MG,0,262,0,19133
1185902,2022-07-31,São João del Rei/MG,0,262,0,19133
1191499,2022-08-01,São João del Rei/MG,0,262,152,19285
1197096,2022-08-02,São João del Rei/MG,0,262,20,19305
1202693,2022-08-03,São João del Rei/MG,0,262,16,19321
1208290,2022-08-04,São João del Rei/MG,0,262,25,19346
1213887,2022-08-05,São João del Rei/MG,0,262,17,19363
1219484,2022-08-06,São João del Rei/MG,0,262,0,19363
1225081,2022-08-07,São João del Rei/MG,0,262,0,19363
1230678,2022-08-08,São João del Rei/MG,0,262,0,19363
1236275,2022-08-09,São João del Rei/MG,0,262,14,19377
1241872,2022-08-10,São João del Rei/MG,0,262,27,19404
1247469,2022-08-11,São João del Rei/MG,0,262,0,19404
1253066,2022-08-12,São João del Rei/MG,0,262,5,19409
1258663,2022-08-13,São João del Rei/MG,0,262,0,19409
1264260,2022-08-14,São João del Rei/MG,0,262,0,19409
1269857,2022-08-15,São João del Rei/MG,0,262,0,19409
1275454,2022-08-16,São João del Rei/MG,0,262,-5,19404
1281051,2022-08-17,São João del Rei/MG,0,262,14,19418
1286648,2022-08-18,São João del Rei/MG,0,262,0,19418
1292245,2022-08-19,São João del Rei/MG,0,262,6,19424
1297842,2022-08-20,São João del Rei/MG,0,262,0,19424
1303439,2022-08-21,São João del Rei/MG,0,262,0,19424
1309036,2022-08-22,São João del Rei/MG,0,262,0,19424
1314633,2022-08-23,São João del Rei/MG,0,262,10,19434
1320230,2022-08-24,São João del Rei/MG,0,262,7,19441
1325827,2022-08-25,São João del Rei/MG,0,262,0,19441
2744,2022-01-01,Lavras/MG,0,173,28,9773
8341,2022-01-02,Lavras/MG,0,173,0,9773
13938,2022-01-03,Lavras/MG,0,173,103,9876
19535,2022-01-04,Lavras/MG,0,173,8,9884
25132,2022-01-05,Lavras/MG,0,173,44,9928
30729,2022-01-06,Lavras/MG,0,173,0,9928
36326,2022-01-07,Lavras/MG,0,173,262,10190
41923,2022-01-08,Lavras/MG,0,173,371,10561
47520,2022-01-09,Lavras/MG,0,173,453,11014
53117,2022-01-10,Lavras/MG,0,173,300,11314
58714,2022-01-11,Lavras/MG,0,173,40,11354
64311,2022-01-12,Lavras/MG,0,173,214,11568
69908,2022-01-13,Lavras/MG,1,174,677,12245
75505,2022-01-14,Lavras/MG,0,174,424,12669
81102,2022-01-15,Lavras/MG,1,175,291,12960
86699,2022-01-16,Lavras/MG,0,175,0,12960
92296,2022-01-17,Lavras/MG,0,175,599,13559
97893,2022-01-18,Lavras/MG,0,175,144,13703
103490,2022-01-19,Lavras/MG,1,176,78,13781
109087,2022-01-20,Lavras/MG,0,176,272,14053
114684,2022-01-21,Lavras/MG,1,177,203,14256
120281,2022-01-22,Lavras/MG,0,177,264,14520
125878,2022-01-23,Lavras/MG,0,177,333,14853
131475,2022-01-24,Lavras/MG,0,177,464,15317
137072,2022-01-25,Lavras/MG,0,177,22,15339
142669,2022-01-26,Lavras/MG,0,177,401,15740
148266,2022-01-27,Lavras/MG,0,177,0,15740
153863,2022-01-28,Lavras/MG,0,177,0,15740
159460,2022-01-29,Lavras/MG,1,178,0,15740
165057,2022-01-30,Lavras/MG,0,178,1829,17569
170654,2022-01-31,Lavras/MG,0,178,316,17885
176251,2022-02-01,Lavras/MG,1,179,0,17885
181848,2022-02-02,Lavras/MG,0,179,351,18236
187445,2022-02-03,Lavras/MG,0,179,347,18583
193042,2022-02-04,Lavras/MG,0,179,301,18884
198639,2022-02-05,Lavras/MG,1,180,0,18884
204236,2022-02-06,Lavras/MG,0,180,539,19423
209833,2022-02-07,Lavras/MG,0,180,192,19615
215430,2022-02-08,Lavras/MG,0,180,27,19642
221027,2022-02-09,Lavras/MG,0,180,247,19889
226624,2022-02-10,Lavras/MG,1,181,255,20144
232221,2022-02-11,Lavras/MG,2,183,153,20297
237818,2022-02-12,Lavras/MG,0,183,166,20463
243415,2022-02-13,Lavras/MG,2,185,149,20612
249012,2022-02-14,Lavras/MG,-1,184,127,20739
254609,2022-02-15,Lavras/MG,0,184,0,20739
260206,2022-02-16,Lavras/MG,0,184,223,20962
265803,2022-02-17,Lavras/MG,0,184,180,21142
271400,2022-02-18,Lavras/MG,0,184,129,21271
276997,2022-02-19,Lavras/MG,0,184,0,21271
282594,2022-02-20,Lavras/MG,0,184,245,21516
288191,2022-02-21,Lavras/MG,0,184,56,21572
293788,2022-02-22,Lavras/MG,0,184,6,21578
299385,2022-02-23,Lavras/MG,2,186,105,21683
304982,2022-02-24,Lavras/MG,0,186,122,21805
310579,2022-02-25,Lavras/MG,0,186,136,21941
316176,2022-02-26,Lavras/MG,0,186,162,22103
321773,2022-02-27,Lavras/MG,0,186,167,22270
327370,2022-02-28,Lavras/MG,0,186,90,22360
332967,2022-03-01,Lavras/MG,0,186,13,22373
338564,2022-03-02,Lavras/MG,0,186,0,22373
344161,2022-03-03,Lavras/MG,0,186,50,22423
349758,2022-03-04,Lavras/MG,0,186,0,22423
355355,2022-03-05,Lavras/MG,0,186,133,22556
360952,2022-03-06,Lavras/MG,4,190,79,22635
366549,2022-03-07,Lavras/MG,0,190,37,22672
372146,2022-03-08,Lavras/MG,0,190,12,22684
377743,2022-03-09,Lavras/MG,0,190,44,22728
383340,2022-03-10,Lavras/MG,0,190,53,22781
388937,2022-03-11,Lavras/MG,0,190,31,22812
394534,2022-03-12,Lavras/MG,0,190,20,22832
400131,2022-03-13,Lavras/MG,0,190,34,22866
405728,2022-03-14,Lavras/MG,0,190,19,22885
411325,2022-03-15,Lavras/MG,0,190,4,22889
416922,2022-03-16,Lavras/MG,0,190,22,22911
422519,2022-03-17,Lavras/MG,0,190,16,22927
428116,2022-03-18,Lavras/MG,0,190,21,22948
433713,2022-03-19,Lavras/MG,0,190,42,22990
439310,2022-03-20,Lavras/MG,0,190,27,23017
444907,2022-03-21,Lavras/MG,0,190,11,23028
450504,2022-03-22,Lavras/MG,2,192,6,23034
456101,2022-03-23,Lavras/MG,0,192,12,23046
461698,2022-03-24,Lavras/MG,0,192,30,23076
467295,2022-03-25,Lavras/MG,0,192,16,23092
472892,2022-03-26,Lavras/MG,1,193,19,23111
478489,2022-03-27,Lavras/MG,0,193,13,23124
484086,2022-03-28,Lavras/MG,0,193,11,23135
489683,2022-03-29,Lavras/MG,0,193,0,23135
495280,2022-03-30,Lavras/MG,0,193,14,23149
500877,2022-03-31,Lavras/MG,0,193,16,23165
506474,2022-04-01,Lavras/MG,0,193,15,23180
512071,2022-04-02,Lavras/MG,0,193,0,23180
517668,2022-04-03,Lavras/MG,0,193,0,23180
523265,2022-04-04,Lavras/MG,0,193,34,23214
528862,2022-04-05,Lavras/MG,0,193,0,23214
534459,2022-04-06,Lavras/MG,0,193,38,23252
540056,2022-04-07,Lavras/MG,0,193,21,23273
545653,2022-04-08,Lavras/MG,0,193,8,23281
551250,2022-04-09,Lavras/MG,0,193,8,23289
556847,2022-04-10,Lavras/MG,0,193,15,23304
562444,2022-04-11,Lavras/MG,0,193,0,23304
568041,2022-04-12,Lavras/MG,0,193,0,23304
573638,2022-04-13,Lavras/MG,0,193,13,23317
579235,2022-04-14,Lavras/MG,0,193,1,23318
584832,2022-04-15,Lavras/MG,0,193,6,23324
590429,2022-04-16,Lavras/MG,0,193,5,23329
596026,2022-04-17,Lavras/MG,0,193,0,23329
601623,2022-04-18,Lavras/MG,0,193,0,23329
607220,2022-04-19,Lavras/MG,1,194,0,23329
612817,2022-04-20,Lavras/MG,0,194,13,23342
618414,2022-04-21,Lavras/MG,0,194,6,23348
624011,2022-04-22,Lavras/MG,0,194,4,23352
629608,2022-04-23,Lavras/MG,0,194,8,23360
635205,2022-04-24,Lavras/MG,0,194,0,23360
640802,2022-04-25,Lavras/MG,0,194,0,23360
646399,2022-04-26,Lavras/MG,0,194,0,23360
651996,2022-04-27,Lavras/MG,0,194,25,23385
657593,2022-04-28,Lavras/MG,0,194,11,23396
663190,2022-04-29,Lavras/MG,0,194,21,23417
668787,2022-04-30,Lavras/MG,0,194,18,23435
674384,2022-05-01,Lavras/MG,0,194,16,23451
679981,2022-05-02,Lavras/MG,0,194,0,23451
685578,2022-05-03,Lavras/MG,0,194,0,23451
691175,2022-05-04,Lavras/MG,0,194,17,23468
696772,2022-05-05,Lavras/MG,0,194,21,23489
702369,2022-05-06,Lavras/MG,0,194,11,23500
707966,2022-05-07,Lavras/MG,0,194,0,23500
713563,2022-05-08,Lavras/MG,0,194,0,23500
719160,2022-05-09,Lavras/MG,0,194,59,23559
724757,2022-05-10,Lavras/MG,0,194,0,23559
730354,2022-05-11,Lavras/MG,0,194,0,23559
735951,2022-05-12,Lavras/MG,0,194,77,23636
741548,2022-05-13,Lavras/MG,0,194,21,23657
747145,2022-05-14,Lavras/MG,0,194,0,23657
752742,2022-05-15,Lavras/MG,0,194,0,23657
758339,2022-05-16,Lavras/MG,0,194,71,23728
763936,2022-05-17,Lavras/MG,0,194,0,23728
769533,2022-05-18,Lavras/MG,0,194,0,23728
775130,2022-05-19,Lavras/MG,0,194,158,23886
780727,2022-05-20,Lavras/MG,0,194,57,23943
786324,2022-05-21,Lavras/MG,0,194,0,23943
791921,2022-05-22,Lavras/MG,0,194,0,23943
797518,2022-05-23,Lavras/MG,0,194,104,24047
803115,2022-05-24,Lavras/MG,0,194,0,24047
808712,2022-05-25,Lavras/MG,0,194,88,24135
814309,2022-05-26,Lavras/MG,0,194,68,24203
819906,2022-05-27,Lavras/MG,0,194,117,24320
825503,2022-05-28,Lavras/MG,0,194,0,24320
831100,2022-05-29,Lavras/MG,0,194,0,24320
836697,2022-05-30,Lavras/MG,0,194,287,24607
842294,2022-05-31,Lavras/MG,0,194,0,24607
847891,2022-06-01,Lavras/MG,1,195,0,24607
853488,2022-06-02,Lavras/MG,0,195,243,24850
859085,2022-06-03,Lavras/MG,0,195,98,24948
864682,2022-06-04,Lavras/MG,0,195,0,24948
870279,2022-06-05,Lavras/MG,0,195,0,24948
875876,2022-06-06,Lavras/MG,0,195,319,25267
881473,2022-06-07,Lavras/MG,0,195,0,25267
887070,2022-06-08,Lavras/MG,3,198,86,25353
892667,2022-06-09,Lavras/MG,0,198,118,25471
898264,2022-06-10,Lavras/MG,0,198,91,25562
903861,2022-06-11,Lavras/MG,0,198,0,25562
909458,2022-06-12,Lavras/MG,0,198,0,25562
915055,2022-06-13,Lavras/MG,0,198,223,25785
920652,2022-06-14,Lavras/MG,0,198,0,25785
926249,2022-06-15,Lavras/MG,0,198,0,25785
931846,2022-06-16,Lavras/MG,0,198,0,25785
937443,2022-06-17,Lavras/MG,0,198,0,25785
943040,2022-06-18,Lavras/MG,0,198,0,25785
948637,2022-06-19,Lavras/MG,0,198,0,25785
954234,2022-06-20,Lavras/MG,0,198,333,26118
959831,2022-06-21,Lavras/MG,0,198,0,26118
965428,2022-06-22,Lavras/MG,0,198,95,26213
971025,2022-06-23,Lavras/MG,0,198,94,26307
976622,2022-06-24,Lavras/MG,0,198,73,26380
982219,2022-06-25,Lavras/MG,0,198,0,26380
987816,2022-06-26,Lavras/MG,0,198,0,26380
993413,2022-06-27,Lavras/MG,0,198,212,26592
999010,2022-06-28,Lavras/MG,0,198,0,26592
1004607,2022-06-29,Lavras/MG,0,198,122,26714
1010204,2022-06-30,Lavras/MG,0,198,101,26815
1015801,2022-07-01,Lavras/MG,0,198,0,26815
1021398,2022-07-02,Lavras/MG,0,198,0,26815
1026995,2022-07-03,Lavras/MG,0,198,0,26815
1032592,2022-07-04,Lavras/MG,0,198,246,27061
1038189,2022-07-05,Lavras/MG,1,199,0,27061
1043786,2022-07-06,Lavras/MG,0,199,143,27204
1049383,2022-07-07,Lavras/MG,0,199,100,27304
1054980,2022-07-08,Lavras/MG,0,199,99,27403
1060577,2022-07-09,Lavras/MG,0,199,0,27403
1066174,2022-07-10,Lavras/MG,0,199,0,27403
1071771,2022-07-11,Lavras/MG,0,199,142,27545
1077368,2022-07-12,Lavras/MG,0,199,0,27545
1082965,2022-07-13,Lavras/MG,0,199,171,27716
1088562,2022-07-14,Lavras/MG,0,199,0,27716
1094159,2022-07-15,Lavras/MG,0,199,211,27927
1099756,2022-07-16,Lavras/MG,0,199,0,27927
1105353,2022-07-17,Lavras/MG,0,199,0,27927
1110950,2022-07-18,Lavras/MG,0,199,60,27987
1116547,2022-07-19,Lavras/MG,0,199,75,28062
1122144,2022-07-20,Lavras/MG,0,199,135,28197
1127741,2022-07-21,Lavras/MG,0,199,79,28276
1133338,2022-07-22,Lavras/MG,0,199,52,28328
1138935,2022-07-23,Lavras/MG,0,199,0,28328
1144532,2022-07-24,Lavras/MG,0,199,0,28328
1150129,2022-07-25,Lavras/MG,0,199,79,28407
1155726,2022-07-26,Lavras/MG,0,199,0,28407
1161323,2022-07-27,Lavras/MG,0,199,0,28407
1166920,2022-07-28,Lavras/MG,0,199,60,28467
1172517,2022-07-29,Lavras/MG,0,199,139,28606
1178114,2022-07-30,Lavras/MG,0,199,0,28606
1183711,2022-07-31,Lavras/MG,0,199,0,28606
1189308,2022-08-01,Lavras/MG,0,199,92,28698
1194905,2022-08-02,Lavras/MG,0,199,0,28698
1200502,2022-08-03,Lavras/MG,2,201,64,28762
1206099,2022-08-04,Lavras/MG,1,202,32,28794
1211696,2022-08-05,Lavras/MG,0,202,29,28823
1217293,2022-08-06,Lavras/MG,0,202,0,28823
1222890,2022-08-07,Lavras/MG,0,202,0,28823
1228487,2022-08-08,Lavras/MG,0,202,86,28909
1234084,2022-08-09,Lavras/MG,0,202,0,28909
1239681,2022-08-10,Lavras/MG,0,202,73,28982
1245278,2022-08-11,Lavras/MG,0,202,0,28982
1250875,2022-08-12,Lavras/MG,0,202,22,29004
1256472,2022-08-13,Lavras/MG,0,202,0,29004
1262069,2022-08-14,Lavras/MG,0,202,0,29004
1267666,2022-08-15,Lavras/MG,0,202,0,29004
1273263,2022-08-16,Lavras/MG,0,202,31,29035
1278860,2022-08-17,Lavras/MG,1,203,25,29060
1284457,2022-08-18,Lavras/MG,0,203,29,29089
1290054,2022-08-19,Lavras/MG,0,203,14,29103
1295651,2022-08-20,Lavras/MG,0,203,0,29103
1301248,2022-08-21,Lavras/MG,0,203,0,29103
1306845,2022-08-22,Lavras/MG,0,203,42,29145
1312442,2022-08-23,Lavras/MG,0,203,0,29145
1318039,2022-08-24,Lavras/MG,0,203,27,29172
1323636,2022-08-25,Lavras/MG,1,204,16,29188
947,2022-01-01,Campo Belo/MG,0,224,0,7585
6544,2022-01-02,Campo Belo/MG,0,224,0,7585
12141,2022-01-03,Campo Belo/MG,0,224,0,7585
17738,2022-01-04,Campo Belo/MG,0,224,17,7602
23335,2022-01-05,Campo Belo/MG,0,224,0,7602
28932,2022-01-06,Campo Belo/MG,0,224,0,7602
34529,2022-01-07,Campo Belo/MG,0,224,0,7602
40126,2022-01-08,Campo Belo/MG,0,224,0,7602
45723,2022-01-09,Campo Belo/MG,0,224,0,7602
51320,2022-01-10,Campo Belo/MG,0,224,0,7602
56917,2022-01-11,Campo Belo/MG,0,224,361,7963
62514,2022-01-12,Campo Belo/MG,0,224,149,8112
68111,2022-01-13,Campo Belo/MG,0,224,0,8112
73708,2022-01-14,Campo Belo/MG,0,224,0,8112
79305,2022-01-15,Campo Belo/MG,0,224,438,8550
84902,2022-01-16,Campo Belo/MG,0,224,0,8550
90499,2022-01-17,Campo Belo/MG,0,224,182,8732
96096,2022-01-18,Campo Belo/MG,0,224,0,8732
101693,2022-01-19,Campo Belo/MG,0,224,178,8910
107290,2022-01-20,Campo Belo/MG,0,224,197,9107
112887,2022-01-21,Campo Belo/MG,0,224,279,9386
118484,2022-01-22,Campo Belo/MG,0,224,158,9544
124081,2022-01-23,Campo Belo/MG,0,224,0,9544
129678,2022-01-24,Campo Belo/MG,0,224,0,9544
135275,2022-01-25,Campo Belo/MG,0,224,0,9544
140872,2022-01-26,Campo Belo/MG,0,224,426,9970
146469,2022-01-27,Campo Belo/MG,0,224,184,10154
152066,2022-01-28,Campo Belo/MG,0,224,0,10154
157663,2022-01-29,Campo Belo/MG,0,224,282,10436
163260,2022-01-30,Campo Belo/MG,1,225,0,10436
168857,2022-01-31,Campo Belo/MG,0,225,0,10436
174454,2022-02-01,Campo Belo/MG,0,225,162,10598
180051,2022-02-02,Campo Belo/MG,1,226,263,10861
185648,2022-02-03,Campo Belo/MG,0,226,157,11018
191245,2022-02-04,Campo Belo/MG,0,226,0,11018
196842,2022-02-05,Campo Belo/MG,0,226,237,11255
202439,2022-02-06,Campo Belo/MG,2,228,0,11255
208036,2022-02-07,Campo Belo/MG,0,228,0,11255
213633,2022-02-08,Campo Belo/MG,3,231,149,11404
219230,2022-02-09,Campo Belo/MG,0,231,194,11598
224827,2022-02-10,Campo Belo/MG,0,231,0,11598
230424,2022-02-11,Campo Belo/MG,1,232,211,11809
236021,2022-02-12,Campo Belo/MG,0,232,0,11809
241618,2022-02-13,Campo Belo/MG,2,234,161,11970
247215,2022-02-14,Campo Belo/MG,0,234,0,11970
252812,2022-02-15,Campo Belo/MG,0,234,0,11970
258409,2022-02-16,Campo Belo/MG,0,234,0,11970
264006,2022-02-17,Campo Belo/MG,0,234,147,12117
269603,2022-02-18,Campo Belo/MG,0,234,87,12204
275200,2022-02-19,Campo Belo/MG,0,234,137,12341
280797,2022-02-20,Campo Belo/MG,0,234,0,12341
286394,2022-02-21,Campo Belo/MG,0,234,0,12341
291991,2022-02-22,Campo Belo/MG,0,234,66,12407
297588,2022-02-23,Campo Belo/MG,0,234,88,12495
303185,2022-02-24,Campo Belo/MG,0,234,0,12495
308782,2022-02-25,Campo Belo/MG,0,234,116,12611
314379,2022-02-26,Campo Belo/MG,1,235,36,12647
319976,2022-02-27,Campo Belo/MG,3,238,0,12647
325573,2022-02-28,Campo Belo/MG,0,238,0,12647
331170,2022-03-01,Campo Belo/MG,0,238,0,12647
336767,2022-03-02,Campo Belo/MG,0,238,0,12647
342364,2022-03-03,Campo Belo/MG,0,238,27,12674
347961,2022-03-04,Campo Belo/MG,0,238,0,12674
353558,2022-03-05,Campo Belo/MG,1,239,83,12757
359155,2022-03-06,Campo Belo/MG,0,239,0,12757
364752,2022-03-07,Campo Belo/MG,0,239,0,12757
370349,2022-03-08,Campo Belo/MG,0,239,23,12780
375946,2022-03-09,Campo Belo/MG,0,239,0,12780
381543,2022-03-10,Campo Belo/MG,0,239,68,12848
387140,2022-03-11,Campo Belo/MG,1,240,10,12858
392737,2022-03-12,Campo Belo/MG,0,240,47,12905
398334,2022-03-13,Campo Belo/MG,0,240,0,12905
403931,2022-03-14,Campo Belo/MG,0,240,0,12905
409528,2022-03-15,Campo Belo/MG,0,240,6,12911
415125,2022-03-16,Campo Belo/MG,0,240,12,12923
420722,2022-03-17,Campo Belo/MG,0,240,0,12923
426319,2022-03-18,Campo Belo/MG,1,241,54,12977
431916,2022-03-19,Campo Belo/MG,0,241,4,12981
437513,2022-03-20,Campo Belo/MG,1,242,0,12981
443110,2022-03-21,Campo Belo/MG,0,242,0,12981
448707,2022-03-22,Campo Belo/MG,0,242,5,12986
454304,2022-03-23,Campo Belo/MG,0,242,0,12986
459901,2022-03-24,Campo Belo/MG,0,242,0,12986
465498,2022-03-25,Campo Belo/MG,0,242,17,13003
471095,2022-03-26,Campo Belo/MG,0,242,3,13006
476692,2022-03-27,Campo Belo/MG,0,242,0,13006
482289,2022-03-28,Campo Belo/MG,0,242,0,13006
487886,2022-03-29,Campo Belo/MG,0,242,2,13008
493483,2022-03-30,Campo Belo/MG,0,242,2,13010
499080,2022-03-31,Campo Belo/MG,0,242,0,13010
504677,2022-04-01,Campo Belo/MG,0,242,4,13014
510274,2022-04-02,Campo Belo/MG,0,242,0,13014
515871,2022-04-03,Campo Belo/MG,0,242,0,13014
521468,2022-04-04,Campo Belo/MG,0,242,3,13017
527065,2022-04-05,Campo Belo/MG,0,242,1,13018
532662,2022-04-06,Campo Belo/MG,0,242,3,13021
538259,2022-04-07,Campo Belo/MG,0,242,0,13021
543856,2022-04-08,Campo Belo/MG,0,242,3,13024
549453,2022-04-09,Campo Belo/MG,0,242,0,13024
555050,2022-04-10,Campo Belo/MG,0,242,1,13025
560647,2022-04-11,Campo Belo/MG,0,242,0,13025
566244,2022-04-12,Campo Belo/MG,0,242,0,13025
571841,2022-04-13,Campo Belo/MG,0,242,1,13026
577438,2022-04-14,Campo Belo/MG,0,242,0,13026
583035,2022-04-15,Campo Belo/MG,0,242,0,13026
588632,2022-04-16,Campo Belo/MG,0,242,0,13026
594229,2022-04-17,Campo Belo/MG,0,242,0,13026
599826,2022-04-18,Campo Belo/MG,0,242,0,13026
605423,2022-04-19,Campo Belo/MG,0,242,0,13026
611020,2022-04-20,Campo Belo/MG,0,242,1,13027
616617,2022-04-21,Campo Belo/MG,0,242,1,13028
622214,2022-04-22,Campo Belo/MG,0,242,0,13028
627811,2022-04-23,Campo Belo/MG,0,242,0,13028
633408,2022-04-24,Campo Belo/MG,0,242,0,13028
639005,2022-04-25,Campo Belo/MG,0,242,0,13028
644602,2022-04-26,Campo Belo/MG,0,242,0,13028
650199,2022-04-27,Campo Belo/MG,0,242,0,13028
655796,2022-04-28,Campo Belo/MG,0,242,0,13028
661393,2022-04-29,Campo Belo/MG,0,242,0,13028
666990,2022-04-30,Campo Belo/MG,0,242,0,13028
672587,2022-05-01,Campo Belo/MG,0,242,0,13028
678184,2022-05-02,Campo Belo/MG,0,242,0,13028
683781,2022-05-03,Campo Belo/MG,0,242,0,13028
689378,2022-05-04,Campo Belo/MG,0,242,0,13028
694975,2022-05-05,Campo Belo/MG,0,242,0,13028
700572,2022-05-06,Campo Belo/MG,0,242,0,13028
706169,2022-05-07,Campo Belo/MG,0,242,0,13028
711766,2022-05-08,Campo Belo/MG,0,242,0,13028
717363,2022-05-09,Campo Belo/MG,0,242,0,13028
722960,2022-05-10,Campo Belo/MG,0,242,10,13038
728557,2022-05-11,Campo Belo/MG,0,242,0,13038
734154,2022-05-12,Campo Belo/MG,0,242,0,13038
739751,2022-05-13,Campo Belo/MG,0,242,0,13038
745348,2022-05-14,Campo Belo/MG,0,242,0,13038
750945,2022-05-15,Campo Belo/MG,0,242,0,13038
756542,2022-05-16,Campo Belo/MG,0,242,0,13038
762139,2022-05-17,Campo Belo/MG,0,242,20,13058
767736,2022-05-18,Campo Belo/MG,0,242,0,13058
773333,2022-05-19,Campo Belo/MG,0,242,0,13058
778930,2022-05-20,Campo Belo/MG,0,242,0,13058
784527,2022-05-21,Campo Belo/MG,0,242,0,13058
790124,2022-05-22,Campo Belo/MG,0,242,0,13058
795721,2022-05-23,Campo Belo/MG,0,242,0,13058
801318,2022-05-24,Campo Belo/MG,0,242,41,13099
806915,2022-05-25,Campo Belo/MG,0,242,0,13099
812512,2022-05-26,Campo Belo/MG,0,242,0,13099
818109,2022-05-27,Campo Belo/MG,0,242,0,13099
823706,2022-05-28,Campo Belo/MG,0,242,0,13099
829303,2022-05-29,Campo Belo/MG,0,242,0,13099
834900,2022-05-30,Campo Belo/MG,0,242,93,13192
840497,2022-05-31,Campo Belo/MG,0,242,0,13192
846094,2022-06-01,Campo Belo/MG,0,242,46,13238
851691,2022-06-02,Campo Belo/MG,0,242,28,13266
857288,2022-06-03,Campo Belo/MG,0,242,0,13266
862885,2022-06-04,Campo Belo/MG,0,242,0,13266
868482,2022-06-05,Campo Belo/MG,0,242,0,13266
874079,2022-06-06,Campo Belo/MG,0,242,80,13346
879676,2022-06-07,Campo Belo/MG,0,242,136,13482
885273,2022-06-08,Campo Belo/MG,0,242,0,13482
890870,2022-06-09,Campo Belo/MG,0,242,0,13482
896467,2022-06-10,Campo Belo/MG,0,242,0,13482
902064,2022-06-11,Campo Belo/MG,0,242,0,13482
907661,2022-06-12,Campo Belo/MG,0,242,0,13482
913258,2022-06-13,Campo Belo/MG,0,242,535,14017
918855,2022-06-14,Campo Belo/MG,0,242,0,14017
924452,2022-06-15,Campo Belo/MG,0,242,0,14017
930049,2022-06-16,Campo Belo/MG,0,242,0,14017
935646,2022-06-17,Campo Belo/MG,0,242,0,14017
941243,2022-06-18,Campo Belo/MG,0,242,0,14017
946840,2022-06-19,Campo Belo/MG,0,242,0,14017
952437,2022-06-20,Campo Belo/MG,0,242,221,14238
958034,2022-06-21,Campo Belo/MG,0,242,0,14238
963631,2022-06-22,Campo Belo/MG,0,242,183,14421
969228,2022-06-23,Campo Belo/MG,0,242,0,14421
974825,2022-06-24,Campo Belo/MG,0,242,285,14706
980422,2022-06-25,Campo Belo/MG,0,242,0,14706
986019,2022-06-26,Campo Belo/MG,0,242,0,14706
991616,2022-06-27,Campo Belo/MG,0,242,171,14877
997213,2022-06-28,Campo Belo/MG,0,242,0,14877
1002810,2022-06-29,Campo Belo/MG,1,243,0,14877
1008407,2022-06-30,Campo Belo/MG,0,243,0,14877
1014004,2022-07-01,Campo Belo/MG,0,243,283,15160
1019601,2022-07-02,Campo Belo/MG,0,243,0,15160
1025198,2022-07-03,Campo Belo/MG,0,243,0,15160
1030795,2022-07-04,Campo Belo/MG,0,243,188,15348
1036392,2022-07-05,Campo Belo/MG,0,243,0,15348
1041989,2022-07-06,Campo Belo/MG,0,243,0,15348
1047586,2022-07-07,Campo Belo/MG,1,244,182,15530
1053183,2022-07-08,Campo Belo/MG,0,244,0,15530
1058780,2022-07-09,Campo Belo/MG,0,244,0,15530
1064377,2022-07-10,Campo Belo/MG,0,244,0,15530
1069974,2022-07-11,Campo Belo/MG,0,244,157,15687
1075571,2022-07-12,Campo Belo/MG,0,244,0,15687
1081168,2022-07-13,Campo Belo/MG,0,244,74,15761
1086765,2022-07-14,Campo Belo/MG,0,244,72,15833
1092362,2022-07-15,Campo Belo/MG,0,244,42,15875
1097959,2022-07-16,Campo Belo/MG,0,244,0,15875
1103556,2022-07-17,Campo Belo/MG,0,244,0,15875
1109153,2022-07-18,Campo Belo/MG,0,244,97,15972
1114750,2022-07-19,Campo Belo/MG,0,244,0,15972
1120347,2022-07-20,Campo Belo/MG,0,244,77,16049
1125944,2022-07-21,Campo Belo/MG,0,244,23,16072
1131541,2022-07-22,Campo Belo/MG,0,244,26,16098
1137138,2022-07-23,Campo Belo/MG,0,244,0,16098
1142735,2022-07-24,Campo Belo/MG,0,244,0,16098
1148332,2022-07-25,Campo Belo/MG,0,244,45,16143
1153929,2022-07-26,Campo Belo/MG,0,244,0,16143
1159526,2022-07-27,Campo Belo/MG,0,244,51,16194
1165123,2022-07-28,Campo Belo/MG,0,244,11,16205
1170720,2022-07-29,Campo Belo/MG,0,244,9,16214
1176317,2022-07-30,Campo Belo/MG,0,244,0,16214
1181914,2022-07-31,Campo Belo/MG,0,244,0,16214
1187511,2022-08-01,Campo Belo/MG,0,244,26,16240
1193108,2022-08-02,Campo Belo/MG,1,245,0,16240
1198705,2022-08-03,Campo Belo/MG,1,246,19,16259
1204302,2022-08-04,Campo Belo/MG,0,246,0,16259
1209899,2022-08-05,Campo Belo/MG,0,246,0,16259
1215496,2022-08-06,Campo Belo/MG,0,246,0,16259
1221093,2022-08-07,Campo Belo/MG,0,246,0,16259
1226690,2022-08-08,Campo Belo/MG,0,246,40,16299
1232287,2022-08-09,Campo Belo/MG,0,246,0,16299
1237884,2022-08-10,Campo Belo/MG,1,247,24,16323
1243481,2022-08-11,Campo Belo/MG,0,247,0,16323
1249078,2022-08-12,Campo Belo/MG,0,247,22,16345
1254675,2022-08-13,Campo Belo/MG,0,247,0,16345
1260272,2022-08-14,Campo Belo/MG,0,247,0,16345
1265869,2022-08-15,Campo Belo/MG,0,247,0,16345
1271466,2022-08-16,Campo Belo/MG,0,247,5,16350
1277063,2022-08-17,Campo Belo/MG,0,247,12,16362
1282660,2022-08-18,Campo Belo/MG,0,247,5,16367
1288257,2022-08-19,Campo Belo/MG,0,247,5,16372
1293854,2022-08-20,Campo Belo/MG,0,247,0,16372
1299451,2022-08-21,Campo Belo/MG,0,247,0,16372
1305048,2022-08-22,Campo Belo/MG,0,247,11,16383
1310645,2022-08-23,Campo Belo/MG,1,248,0,16383
1316242,2022-08-24,Campo Belo/MG,0,248,5,16388
1321839,2022-08-25,Campo Belo/MG,0,248,2,16390
3438,2022-01-01,Oliveira/MG,0,81,0,5602
9035,2022-01-02,Oliveira/MG,0,81,0,5602
14632,2022-01-03,Oliveira/MG,0,81,0,5602
20229,2022-01-04,Oliveira/MG,0,81,0,5602
25826,2022-01-05,Oliveira/MG,0,81,0,5602
31423,2022-01-06,Oliveira/MG,0,81,11,5613
37020,2022-01-07,Oliveira/MG,0,81,4,5617
42617,2022-01-08,Oliveira/MG,0,81,15,5632
48214,2022-01-09,Oliveira/MG,0,81,0,5632
53811,2022-01-10,Oliveira/MG,0,81,0,5632
59408,2022-01-11,Oliveira/MG,0,81,0,5632
65005,2022-01-12,Oliveira/MG,0,81,0,5632
70602,2022-01-13,Oliveira/MG,0,81,0,5632
76199,2022-01-14,Oliveira/MG,0,81,84,5716
81796,2022-01-15,Oliveira/MG,0,81,68,5784
87393,2022-01-16,Oliveira/MG,0,81,0,5784
92990,2022-01-17,Oliveira/MG,0,81,0,5784
98587,2022-01-18,Oliveira/MG,0,81,0,5784
104184,2022-01-19,Oliveira/MG,0,81,46,5830
109781,2022-01-20,Oliveira/MG,0,81,0,5830
115378,2022-01-21,Oliveira/MG,0,81,0,5830
120975,2022-01-22,Oliveira/MG,0,81,106,5936
126572,2022-01-23,Oliveira/MG,0,81,0,5936
132169,2022-01-24,Oliveira/MG,0,81,0,5936
137766,2022-01-25,Oliveira/MG,0,81,69,6005
143363,2022-01-26,Oliveira/MG,0,81,55,6060
148960,2022-01-27,Oliveira/MG,0,81,0,6060
154557,2022-01-28,Oliveira/MG,0,81,65,6125
160154,2022-01-29,Oliveira/MG,0,81,0,6125
165751,2022-01-30,Oliveira/MG,0,81,0,6125
171348,2022-01-31,Oliveira/MG,0,81,0,6125
176945,2022-02-01,Oliveira/MG,0,81,0,6125
182542,2022-02-02,Oliveira/MG,0,81,147,6272
188139,2022-02-03,Oliveira/MG,0,81,0,6272
193736,2022-02-04,Oliveira/MG,0,81,0,6272
199333,2022-02-05,Oliveira/MG,1,82,0,6272
204930,2022-02-06,Oliveira/MG,0,82,0,6272
210527,2022-02-07,Oliveira/MG,0,82,0,6272
216124,2022-02-08,Oliveira/MG,0,82,0,6272
221721,2022-02-09,Oliveira/MG,0,82,0,6272
227318,2022-02-10,Oliveira/MG,0,82,0,6272
232915,2022-02-11,Oliveira/MG,0,82,0,6272
238512,2022-02-12,Oliveira/MG,0,82,0,6272
244109,2022-02-13,Oliveira/MG,0,82,0,6272
249706,2022-02-14,Oliveira/MG,0,82,0,6272
255303,2022-02-15,Oliveira/MG,0,82,0,6272
260900,2022-02-16,Oliveira/MG,1,83,0,6272
266497,2022-02-17,Oliveira/MG,0,83,0,6272
272094,2022-02-18,Oliveira/MG,1,84,0,6272
277691,2022-02-19,Oliveira/MG,1,85,0,6272
283288,2022-02-20,Oliveira/MG,0,85,0,6272
288885,2022-02-21,Oliveira/MG,0,85,0,6272
294482,2022-02-22,Oliveira/MG,0,85,0,6272
300079,2022-02-23,Oliveira/MG,0,85,0,6272
305676,2022-02-24,Oliveira/MG,0,85,0,6272
311273,2022-02-25,Oliveira/MG,0,85,0,6272
316870,2022-02-26,Oliveira/MG,2,87,0,6272
322467,2022-02-27,Oliveira/MG,0,87,0,6272
328064,2022-02-28,Oliveira/MG,0,87,0,6272
333661,2022-03-01,Oliveira/MG,0,87,0,6272
339258,2022-03-02,Oliveira/MG,0,87,0,6272
344855,2022-03-03,Oliveira/MG,0,87,0,6272
350452,2022-03-04,Oliveira/MG,0,87,0,6272
356049,2022-03-05,Oliveira/MG,0,87,0,6272
361646,2022-03-06,Oliveira/MG,0,87,0,6272
367243,2022-03-07,Oliveira/MG,0,87,0,6272
372840,2022-03-08,Oliveira/MG,0,87,0,6272
378437,2022-03-09,Oliveira/MG,0,87,0,6272
384034,2022-03-10,Oliveira/MG,0,87,0,6272
389631,2022-03-11,Oliveira/MG,0,87,0,6272
395228,2022-03-12,Oliveira/MG,0,87,0,6272
400825,2022-03-13,Oliveira/MG,0,87,0,6272
406422,2022-03-14,Oliveira/MG,0,87,0,6272
412019,2022-03-15,Oliveira/MG,0,87,0,6272
417616,2022-03-16,Oliveira/MG,0,87,0,6272
423213,2022-03-17,Oliveira/MG,0,87,0,6272
428810,2022-03-18,Oliveira/MG,0,87,0,6272
434407,2022-03-19,Oliveira/MG,0,87,0,6272
440004,2022-03-20,Oliveira/MG,0,87,0,6272
445601,2022-03-21,Oliveira/MG,0,87,0,6272
451198,2022-03-22,Oliveira/MG,0,87,0,6272
456795,2022-03-23,Oliveira/MG,0,87,0,6272
462392,2022-03-24,Oliveira/MG,0,87,0,6272
467989,2022-03-25,Oliveira/MG,0,87,0,6272
473586,2022-03-26,Oliveira/MG,0,87,0,6272
479183,2022-03-27,Oliveira/MG,0,87,0,6272
484780,2022-03-28,Oliveira/MG,0,87,0,6272
490377,2022-03-29,Oliveira/MG,0,87,0,6272
495974,2022-03-30,Oliveira/MG,0,87,0,6272
501571,2022-03-31,Oliveira/MG,0,87,0,6272
507168,2022-04-01,Oliveira/MG,0,87,0,6272
512765,2022-04-02,Oliveira/MG,0,87,0,6272
518362,2022-04-03,Oliveira/MG,0,87,0,6272
523959,2022-04-04,Oliveira/MG,1,88,0,6272
529556,2022-04-05,Oliveira/MG,0,88,0,6272
535153,2022-04-06,Oliveira/MG,0,88,0,6272
540750,2022-04-07,Oliveira/MG,0,88,0,6272
546347,2022-04-08,Oliveira/MG,0,88,0,6272
551944,2022-04-09,Oliveira/MG,0,88,0,6272
557541,2022-04-10,Oliveira/MG,0,88,0,6272
563138,2022-04-11,Oliveira/MG,0,88,0,6272
568735,2022-04-12,Oliveira/MG,0,88,0,6272
574332,2022-04-13,Oliveira/MG,0,88,0,6272
579929,2022-04-14,Oliveira/MG,0,88,0,6272
585526,2022-04-15,Oliveira/MG,0,88,0,6272
591123,2022-04-16,Oliveira/MG,0,88,0,6272
596720,2022-04-17,Oliveira/MG,0,88,0,6272
602317,2022-04-18,Oliveira/MG,0,88,0,6272
607914,2022-04-19,Oliveira/MG,0,88,0,6272
613511,2022-04-20,Oliveira/MG,0,88,0,6272
619108,2022-04-21,Oliveira/MG,0,88,0,6272
624705,2022-04-22,Oliveira/MG,0,88,0,6272
630302,2022-04-23,Oliveira/MG,0,88,0,6272
635899,2022-04-24,Oliveira/MG,0,88,0,6272
641496,2022-04-25,Oliveira/MG,0,88,0,6272
647093,2022-04-26,Oliveira/MG,0,88,0,6272
652690,2022-04-27,Oliveira/MG,0,88,0,6272
658287,2022-04-28,Oliveira/MG,0,88,0,6272
663884,2022-04-29,Oliveira/MG,0,88,0,6272
669481,2022-04-30,Oliveira/MG,0,88,0,6272
675078,2022-05-01,Oliveira/MG,0,88,0,6272
680675,2022-05-02,Oliveira/MG,0,88,0,6272
686272,2022-05-03,Oliveira/MG,0,88,0,6272
691869,2022-05-04,Oliveira/MG,0,88,0,6272
697466,2022-05-05,Oliveira/MG,0,88,0,6272
703063,2022-05-06,Oliveira/MG,0,88,0,6272
708660,2022-05-07,Oliveira/MG,0,88,0,6272
714257,2022-05-08,Oliveira/MG,0,88,0,6272
719854,2022-05-09,Oliveira/MG,0,88,0,6272
725451,2022-05-10,Oliveira/MG,0,88,0,6272
731048,2022-05-11,Oliveira/MG,0,88,0,6272
736645,2022-05-12,Oliveira/MG,0,88,0,6272
742242,2022-05-13,Oliveira/MG,0,88,0,6272
747839,2022-05-14,Oliveira/MG,0,88,0,6272
753436,2022-05-15,Oliveira/MG,0,88,0,6272
759033,2022-05-16,Oliveira/MG,0,88,0,6272
764630,2022-05-17,Oliveira/MG,0,88,0,6272
770227,2022-05-18,Oliveira/MG,0,88,0,6272
775824,2022-05-19,Oliveira/MG,0,88,0,6272
781421,2022-05-20,Oliveira/MG,0,88,0,6272
787018,2022-05-21,Oliveira/MG,0,88,0,6272
792615,2022-05-22,Oliveira/MG,0,88,0,6272
798212,2022-05-23,Oliveira/MG,0,88,0,6272
803809,2022-05-24,Oliveira/MG,0,88,0,6272
809406,2022-05-25,Oliveira/MG,0,88,0,6272
815003,2022-05-26,Oliveira/MG,0,88,0,6272
820600,2022-05-27,Oliveira/MG,0,88,0,6272
826197,2022-05-28,Oliveira/MG,0,88,0,6272
831794,2022-05-29,Oliveira/MG,0,88,0,6272
837391,2022-05-30,Oliveira/MG,0,88,0,6272
842988,2022-05-31,Oliveira/MG,0,88,0,6272
848585,2022-06-01,Oliveira/MG,0,88,0,6272
854182,2022-06-02,Oliveira/MG,0,88,0,6272
859779,2022-06-03,Oliveira/MG,0,88,0,6272
865376,2022-06-04,Oliveira/MG,0,88,0,6272
870973,2022-06-05,Oliveira/MG,0,88,0,6272
876570,2022-06-06,Oliveira/MG,0,88,0,6272
882167,2022-06-07,Oliveira/MG,0,88,0,6272
887764,2022-06-08,Oliveira/MG,0,88,0,6272
893361,2022-06-09,Oliveira/MG,0,88,0,6272
898958,2022-06-10,Oliveira/MG,0,88,0,6272
904555,2022-06-11,Oliveira/MG,0,88,0,6272
910152,2022-06-12,Oliveira/MG,0,88,0,6272
915749,2022-06-13,Oliveira/MG,0,88,0,6272
921346,2022-06-14,Oliveira/MG,0,88,0,6272
926943,2022-06-15,Oliveira/MG,0,88,0,6272
932540,2022-06-16,Oliveira/MG,0,88,0,6272
938137,2022-06-17,Oliveira/MG,0,88,0,6272
943734,2022-06-18,Oliveira/MG,0,88,0,6272
949331,2022-06-19,Oliveira/MG,0,88,0,6272
954928,2022-06-20,Oliveira/MG,0,88,0,6272
960525,2022-06-21,Oliveira/MG,0,88,0,6272
966122,2022-06-22,Oliveira/MG,0,88,0,6272
971719,2022-06-23,Oliveira/MG,0,88,0,6272
977316,2022-06-24,Oliveira/MG,0,88,0,6272
982913,2022-06-25,Oliveira/MG,0,88,0,6272
988510,2022-06-26,Oliveira/MG,0,88,0,6272
994107,2022-06-27,Oliveira/MG,0,88,0,6272
999704,2022-06-28,Oliveira/MG,0,88,0,6272
1005301,2022-06-29,Oliveira/MG,0,88,0,6272
1010898,2022-06-30,Oliveira/MG,0,88,0,6272
1016495,2022-07-01,Oliveira/MG,0,88,0,6272
1022092,2022-07-02,Oliveira/MG,0,88,0,6272
1027689,2022-07-03,Oliveira/MG,0,88,0,6272
1033286,2022-07-04,Oliveira/MG,0,88,0,6272
1038883,2022-07-05,Oliveira/MG,0,88,0,6272
1044480,2022-07-06,Oliveira/MG,0,88,0,6272
1050077,2022-07-07,Oliveira/MG,0,88,0,6272
1055674,2022-07-08,Oliveira/MG,0,88,0,6272
1061271,2022-07-09,Oliveira/MG,0,88,0,6272
1066868,2022-07-10,Oliveira/MG,0,88,0,6272
1072465,2022-07-11,Oliveira/MG,0,88,0,6272
1078062,2022-07-12,Oliveira/MG,0,88,0,6272
1083659,2022-07-13,Oliveira/MG,0,88,0,6272
1089256,2022-07-14,Oliveira/MG,0,88,0,6272
1094853,2022-07-15,Oliveira/MG,0,88,0,6272
1100450,2022-07-16,Oliveira/MG,0,88,0,6272
1106047,2022-07-17,Oliveira/MG,0,88,0,6272
1111644,2022-07-18,Oliveira/MG,0,88,0,6272
1117241,2022-07-19,Oliveira/MG,0,88,0,6272
1122838,2022-07-20,Oliveira/MG,0,88,0,6272
1128435,2022-07-21,Oliveira/MG,0,88,0,6272
1134032,2022-07-22,Oliveira/MG,0,88,0,6272
1139629,2022-07-23,Oliveira/MG,0,88,0,6272
1145226,2022-07-24,Oliveira/MG,0,88,0,6272
1150823,2022-07-25,Oliveira/MG,0,88,0,6272
1156420,2022-07-26,Oliveira/MG,0,88,0,6272
1162017,2022-07-27,Oliveira/MG,0,88,0,6272
1167614,2022-07-28,Oliveira/MG,0,88,0,6272
1173211,2022-07-29,Oliveira/MG,0,88,0,6272
1178808,2022-07-30,Oliveira/MG,0,88,0,6272
1184405,2022-07-31,Oliveira/MG,0,88,0,6272
1190002,2022-08-01,Oliveira/MG,0,88,0,6272
1195599,2022-08-02,Oliveira/MG,0,88,0,6272
1201196,2022-08-03,Oliveira/MG,0,88,0,6272
1206793,2022-08-04,Oliveira/MG,0,88,0,6272
1212390,2022-08-05,Oliveira/MG,0,88,0,6272
1217987,2022-08-06,Oliveira/MG,0,88,0,6272
1223584,2022-08-07,Oliveira/MG,0,88,0,6272
1229181,2022-08-08,Oliveira/MG,0,88,0,6272
1234778,2022-08-09,Oliveira/MG,1,89,0,6272
1240375,2022-08-10,Oliveira/MG,0,89,0,6272
1245972,2022-08-11,Oliveira/MG,0,89,0,6272
1251569,2022-08-12,Oliveira/MG,0,89,0,6272
1257166,2022-08-13,Oliveira/MG,0,89,0,6272
1262763,2022-08-14,Oliveira/MG,0,89,0,6272
1268360,2022-08-15,Oliveira/MG,0,89,0,6272
1273957,2022-08-16,Oliveira/MG,0,89,0,6272
1279554,2022-08-17,Oliveira/MG,0,89,0,6272
1285151,2022-08-18,Oliveira/MG,0,89,0,6272
1290748,2022-08-19,Oliveira/MG,0,89,0,6272
1296345,2022-08-20,Oliveira/MG,0,89,0,6272
1301942,2022-08-21,Oliveira/MG,0,89,0,6272
1307539,2022-08-22,Oliveira/MG,0,89,0,6272
1313136,2022-08-23,Oliveira/MG,0,89,0,6272
1318733,2022-08-24,Oliveira/MG,0,89,0,6272
1324330,2022-08-25,Oliveira/MG,0,89,0,6272
1805,2022-01-01,Formiga/MG,0,270,7,11563
7402,2022-01-02,Formiga/MG,0,270,0,11563
12999,2022-01-03,Formiga/MG,0,270,0,11563
18596,2022-01-04,Formiga/MG,0,270,0,11563
24193,2022-01-05,Formiga/MG,0,270,16,11579
29790,2022-01-06,Formiga/MG,0,270,30,11609
35387,2022-01-07,Formiga/MG,0,270,0,11609
40984,2022-01-08,Formiga/MG,0,270,139,11748
46581,2022-01-09,Formiga/MG,0,270,123,11871
52178,2022-01-10,Formiga/MG,0,270,0,11871
57775,2022-01-11,Formiga/MG,1,271,0,11871
63372,2022-01-12,Formiga/MG,0,271,201,12072
68969,2022-01-13,Formiga/MG,0,271,111,12183
74566,2022-01-14,Formiga/MG,0,271,0,12183
80163,2022-01-15,Formiga/MG,0,271,236,12419
85760,2022-01-16,Formiga/MG,0,271,0,12419
91357,2022-01-17,Formiga/MG,0,271,150,12569
96954,2022-01-18,Formiga/MG,0,271,0,12569
102551,2022-01-19,Formiga/MG,0,271,337,12906
108148,2022-01-20,Formiga/MG,0,271,256,13162
113745,2022-01-21,Formiga/MG,0,271,296,13458
119342,2022-01-22,Formiga/MG,0,271,0,13458
124939,2022-01-23,Formiga/MG,0,271,538,13996
130536,2022-01-24,Formiga/MG,0,271,0,13996
136133,2022-01-25,Formiga/MG,0,271,0,13996
141730,2022-01-26,Formiga/MG,0,271,304,14300
147327,2022-01-27,Formiga/MG,0,271,457,14757
152924,2022-01-28,Formiga/MG,0,271,0,14757
158521,2022-01-29,Formiga/MG,0,271,0,14757
164118,2022-01-30,Formiga/MG,0,271,0,14757
169715,2022-01-31,Formiga/MG,0,271,0,14757
175312,2022-02-01,Formiga/MG,0,271,0,14757
180909,2022-02-02,Formiga/MG,1,272,1494,16251
186506,2022-02-03,Formiga/MG,1,273,0,16251
192103,2022-02-04,Formiga/MG,0,273,463,16714
197700,2022-02-05,Formiga/MG,0,273,173,16887
203297,2022-02-06,Formiga/MG,0,273,229,17116
208894,2022-02-07,Formiga/MG,0,273,0,17116
214491,2022-02-08,Formiga/MG,0,273,0,17116
220088,2022-02-09,Formiga/MG,0,273,0,17116
225685,2022-02-10,Formiga/MG,2,275,725,17841
231282,2022-02-11,Formiga/MG,2,277,0,17841
236879,2022-02-12,Formiga/MG,1,278,0,17841
242476,2022-02-13,Formiga/MG,0,278,502,18343
248073,2022-02-14,Formiga/MG,0,278,0,18343
253670,2022-02-15,Formiga/MG,0,278,0,18343
259267,2022-02-16,Formiga/MG,0,278,263,18606
264864,2022-02-17,Formiga/MG,1,279,185,18791
270461,2022-02-18,Formiga/MG,0,279,114,18905
276058,2022-02-19,Formiga/MG,1,280,0,18905
281655,2022-02-20,Formiga/MG,0,280,0,18905
287252,2022-02-21,Formiga/MG,0,280,0,18905
292849,2022-02-22,Formiga/MG,0,280,0,18905
298446,2022-02-23,Formiga/MG,0,280,458,19363
304043,2022-02-24,Formiga/MG,0,280,280,19643
309640,2022-02-25,Formiga/MG,1,281,0,19643
315237,2022-02-26,Formiga/MG,0,281,-50,19593
320834,2022-02-27,Formiga/MG,0,281,0,19593
326431,2022-02-28,Formiga/MG,0,281,0,19593
332028,2022-03-01,Formiga/MG,0,281,0,19593
337625,2022-03-02,Formiga/MG,0,281,0,19593
343222,2022-03-03,Formiga/MG,0,281,0,19593
348819,2022-03-04,Formiga/MG,2,283,222,19815
354416,2022-03-05,Formiga/MG,0,283,65,19880
360013,2022-03-06,Formiga/MG,0,283,26,19906
365610,2022-03-07,Formiga/MG,0,283,0,19906
371207,2022-03-08,Formiga/MG,0,283,0,19906
376804,2022-03-09,Formiga/MG,0,283,0,19906
382401,2022-03-10,Formiga/MG,0,283,115,20021
387998,2022-03-11,Formiga/MG,1,284,30,20051
393595,2022-03-12,Formiga/MG,0,284,25,20076
399192,2022-03-13,Formiga/MG,0,284,24,20100
404789,2022-03-14,Formiga/MG,0,284,0,20100
410386,2022-03-15,Formiga/MG,0,284,0,20100
415983,2022-03-16,Formiga/MG,0,284,30,20130
421580,2022-03-17,Formiga/MG,0,284,19,20149
427177,2022-03-18,Formiga/MG,0,284,16,20165
432774,2022-03-19,Formiga/MG,0,284,10,20175
438371,2022-03-20,Formiga/MG,0,284,11,20186
443968,2022-03-21,Formiga/MG,0,284,0,20186
449565,2022-03-22,Formiga/MG,0,284,0,20186
455162,2022-03-23,Formiga/MG,0,284,0,20186
460759,2022-03-24,Formiga/MG,0,284,26,20212
466356,2022-03-25,Formiga/MG,1,285,0,20212
471953,2022-03-26,Formiga/MG,0,285,8,20220
477550,2022-03-27,Formiga/MG,0,285,0,20220
483147,2022-03-28,Formiga/MG,0,285,0,20220
488744,2022-03-29,Formiga/MG,0,285,0,20220
494341,2022-03-30,Formiga/MG,1,286,0,20220
499938,2022-03-31,Formiga/MG,0,286,15,20235
505535,2022-04-01,Formiga/MG,0,286,4,20239
511132,2022-04-02,Formiga/MG,0,286,0,20239
516729,2022-04-03,Formiga/MG,0,286,0,20239
522326,2022-04-04,Formiga/MG,0,286,6,20245
527923,2022-04-05,Formiga/MG,1,287,0,20245
533520,2022-04-06,Formiga/MG,0,287,7,20252
539117,2022-04-07,Formiga/MG,0,287,2,20254
544714,2022-04-08,Formiga/MG,0,287,7,20261
550311,2022-04-09,Formiga/MG,0,287,5,20266
555908,2022-04-10,Formiga/MG,0,287,3,20269
561505,2022-04-11,Formiga/MG,0,287,0,20269
567102,2022-04-12,Formiga/MG,0,287,0,20269
572699,2022-04-13,Formiga/MG,0,287,10,20279
578296,2022-04-14,Formiga/MG,0,287,2,20281
583893,2022-04-15,Formiga/MG,0,287,0,20281
589490,2022-04-16,Formiga/MG,0,287,6,20287
595087,2022-04-17,Formiga/MG,0,287,0,20287
600684,2022-04-18,Formiga/MG,0,287,0,20287
606281,2022-04-19,Formiga/MG,0,287,0,20287
611878,2022-04-20,Formiga/MG,0,287,9,20296
617475,2022-04-21,Formiga/MG,0,287,2,20298
623072,2022-04-22,Formiga/MG,0,287,4,20302
628669,2022-04-23,Formiga/MG,0,287,0,20302
634266,2022-04-24,Formiga/MG,0,287,0,20302
639863,2022-04-25,Formiga/MG,0,287,0,20302
645460,2022-04-26,Formiga/MG,0,287,0,20302
651057,2022-04-27,Formiga/MG,0,287,4,20306
656654,2022-04-28,Formiga/MG,0,287,6,20312
662251,2022-04-29,Formiga/MG,0,287,1,20313
667848,2022-04-30,Formiga/MG,0,287,1,20314
673445,2022-05-01,Formiga/MG,0,287,3,20317
679042,2022-05-02,Formiga/MG,0,287,0,20317
684639,2022-05-03,Formiga/MG,0,287,0,20317
690236,2022-05-04,Formiga/MG,0,287,7,20324
695833,2022-05-05,Formiga/MG,0,287,4,20328
701430,2022-05-06,Formiga/MG,0,287,5,20333
707027,2022-05-07,Formiga/MG,0,287,0,20333
712624,2022-05-08,Formiga/MG,0,287,0,20333
718221,2022-05-09,Formiga/MG,0,287,5,20338
723818,2022-05-10,Formiga/MG,0,287,0,20338
729415,2022-05-11,Formiga/MG,0,287,9,20347
735012,2022-05-12,Formiga/MG,0,287,6,20353
740609,2022-05-13,Formiga/MG,0,287,6,20359
746206,2022-05-14,Formiga/MG,0,287,0,20359
751803,2022-05-15,Formiga/MG,0,287,0,20359
757400,2022-05-16,Formiga/MG,0,287,10,20369
762997,2022-05-17,Formiga/MG,0,287,0,20369
768594,2022-05-18,Formiga/MG,0,287,11,20380
774191,2022-05-19,Formiga/MG,0,287,4,20384
779788,2022-05-20,Formiga/MG,0,287,23,20407
785385,2022-05-21,Formiga/MG,0,287,0,20407
790982,2022-05-22,Formiga/MG,0,287,0,20407
796579,2022-05-23,Formiga/MG,0,287,17,20424
802176,2022-05-24,Formiga/MG,0,287,0,20424
807773,2022-05-25,Formiga/MG,1,288,11,20435
813370,2022-05-26,Formiga/MG,0,288,16,20451
818967,2022-05-27,Formiga/MG,1,289,18,20469
824564,2022-05-28,Formiga/MG,0,289,0,20469
830161,2022-05-29,Formiga/MG,0,289,0,20469
835758,2022-05-30,Formiga/MG,0,289,70,20539
841355,2022-05-31,Formiga/MG,0,289,0,20539
846952,2022-06-01,Formiga/MG,0,289,64,20603
852549,2022-06-02,Formiga/MG,0,289,65,20668
858146,2022-06-03,Formiga/MG,0,289,23,20691
863743,2022-06-04,Formiga/MG,0,289,0,20691
869340,2022-06-05,Formiga/MG,0,289,0,20691
874937,2022-06-06,Formiga/MG,0,289,111,20802
880534,2022-06-07,Formiga/MG,0,289,0,20802
886131,2022-06-08,Formiga/MG,0,289,0,20802
891728,2022-06-09,Formiga/MG,0,289,60,20862
897325,2022-06-10,Formiga/MG,0,289,51,20913
902922,2022-06-11,Formiga/MG,0,289,0,20913
908519,2022-06-12,Formiga/MG,0,289,0,20913
914116,2022-06-13,Formiga/MG,0,289,149,21062
919713,2022-06-14,Formiga/MG,0,289,0,21062
925310,2022-06-15,Formiga/MG,0,289,0,21062
930907,2022-06-16,Formiga/MG,0,289,0,21062
936504,2022-06-17,Formiga/MG,0,289,0,21062
942101,2022-06-18,Formiga/MG,0,289,0,21062
947698,2022-06-19,Formiga/MG,0,289,0,21062
953295,2022-06-20,Formiga/MG,0,289,246,21308
958892,2022-06-21,Formiga/MG,0,289,0,21308
964489,2022-06-22,Formiga/MG,0,289,172,21480
970086,2022-06-23,Formiga/MG,0,289,126,21606
975683,2022-06-24,Formiga/MG,2,291,93,21699
981280,2022-06-25,Formiga/MG,0,291,0,21699
986877,2022-06-26,Formiga/MG,0,291,0,21699
992474,2022-06-27,Formiga/MG,1,292,137,21836
998071,2022-06-28,Formiga/MG,0,292,0,21836
1003668,2022-06-29,Formiga/MG,1,293,0,21836
1009265,2022-06-30,Formiga/MG,0,293,218,22054
1014862,2022-07-01,Formiga/MG,0,293,75,22129
1020459,2022-07-02,Formiga/MG,0,293,0,22129
1026056,2022-07-03,Formiga/MG,0,293,0,22129
1031653,2022-07-04,Formiga/MG,0,293,168,22297
1037250,2022-07-05,Formiga/MG,1,294,0,22297
1042847,2022-07-06,Formiga/MG,1,295,108,22405
1048444,2022-07-07,Formiga/MG,0,295,96,22501
1054041,2022-07-08,Formiga/MG,2,297,100,22601
1059638,2022-07-09,Formiga/MG,0,297,0,22601
1065235,2022-07-10,Formiga/MG,0,297,0,22601
1070832,2022-07-11,Formiga/MG,0,297,181,22782
1076429,2022-07-12,Formiga/MG,0,297,0,22782
1082026,2022-07-13,Formiga/MG,0,297,85,22867
1087623,2022-07-14,Formiga/MG,0,297,68,22935
1093220,2022-07-15,Formiga/MG,1,298,84,23019
1098817,2022-07-16,Formiga/MG,0,298,0,23019
1104414,2022-07-17,Formiga/MG,0,298,0,23019
1110011,2022-07-18,Formiga/MG,0,298,106,23125
1115608,2022-07-19,Formiga/MG,0,298,0,23125
1121205,2022-07-20,Formiga/MG,1,299,60,23185
1126802,2022-07-21,Formiga/MG,0,299,58,23243
1132399,2022-07-22,Formiga/MG,0,299,55,23298
1137996,2022-07-23,Formiga/MG,0,299,0,23298
1143593,2022-07-24,Formiga/MG,0,299,0,23298
1149190,2022-07-25,Formiga/MG,0,299,158,23456
1154787,2022-07-26,Formiga/MG,0,299,0,23456
1160384,2022-07-27,Formiga/MG,0,299,45,23501
1165981,2022-07-28,Formiga/MG,0,299,33,23534
1171578,2022-07-29,Formiga/MG,0,299,24,23558
1177175,2022-07-30,Formiga/MG,0,299,0,23558
1182772,2022-07-31,Formiga/MG,0,299,0,23558
1188369,2022-08-01,Formiga/MG,5,304,64,23622
1193966,2022-08-02,Formiga/MG,1,305,0,23622
1199563,2022-08-03,Formiga/MG,1,306,16,23638
1205160,2022-08-04,Formiga/MG,5,311,15,23653
1210757,2022-08-05,Formiga/MG,1,312,18,23671
1216354,2022-08-06,Formiga/MG,0,312,0,23671
1221951,2022-08-07,Formiga/MG,0,312,0,23671
1227548,2022-08-08,Formiga/MG,0,312,28,23699
1233145,2022-08-09,Formiga/MG,0,312,0,23699
1238742,2022-08-10,Formiga/MG,1,313,24,23723
1244339,2022-08-11,Formiga/MG,0,313,0,23723
1249936,2022-08-12,Formiga/MG,1,314,10,23733
1255533,2022-08-13,Formiga/MG,0,314,0,23733
1261130,2022-08-14,Formiga/MG,0,314,0,23733
1266727,2022-08-15,Formiga/MG,0,314,0,23733
1272324,2022-08-16,Formiga/MG,0,314,12,23745
1277921,2022-08-17,Formiga/MG,1,315,0,23745
1283518,2022-08-18,Formiga/MG,0,315,16,23761
1289115,2022-08-19,Formiga/MG,0,315,6,23767
1294712,2022-08-20,Formiga/MG,0,315,0,23767
1300309,2022-08-21,Formiga/MG,0,315,0,23767
1305906,2022-08-22,Formiga/MG,0,315,10,23777
1311503,2022-08-23,Formiga/MG,0,315,0,23777
1317100,2022-08-24,Formiga/MG,1,316,6,23783
1322697,2022-08-25,Formiga/MG,0,316,4,23787
3852,2022-01-01,Piumhi/MG,0,118,4,5835
9449,2022-01-02,Piumhi/MG,0,118,0,5835
15046,2022-01-03,Piumhi/MG,0,118,7,5842
20643,2022-01-04,Piumhi/MG,0,118,0,5842
26240,2022-01-05,Piumhi/MG,0,118,3,5845
31837,2022-01-06,Piumhi/MG,0,118,13,5858
37434,2022-01-07,Piumhi/MG,0,118,23,5881
43031,2022-01-08,Piumhi/MG,0,118,0,5881
48628,2022-01-09,Piumhi/MG,0,118,0,5881
54225,2022-01-10,Piumhi/MG,0,118,163,6044
59822,2022-01-11,Piumhi/MG,0,118,29,6073
65419,2022-01-12,Piumhi/MG,0,118,0,6073
71016,2022-01-13,Piumhi/MG,0,118,106,6179
76613,2022-01-14,Piumhi/MG,0,118,84,6263
82210,2022-01-15,Piumhi/MG,0,118,76,6339
87807,2022-01-16,Piumhi/MG,0,118,0,6339
93404,2022-01-17,Piumhi/MG,0,118,0,6339
99001,2022-01-18,Piumhi/MG,0,118,0,6339
104598,2022-01-19,Piumhi/MG,0,118,186,6525
110195,2022-01-20,Piumhi/MG,0,118,63,6588
115792,2022-01-21,Piumhi/MG,0,118,83,6671
121389,2022-01-22,Piumhi/MG,0,118,221,6892
126986,2022-01-23,Piumhi/MG,0,118,0,6892
132583,2022-01-24,Piumhi/MG,0,118,0,6892
138180,2022-01-25,Piumhi/MG,0,118,243,7135
143777,2022-01-26,Piumhi/MG,0,118,116,7251
149374,2022-01-27,Piumhi/MG,2,120,116,7367
154971,2022-01-28,Piumhi/MG,0,120,136,7503
160568,2022-01-29,Piumhi/MG,0,120,0,7503
166165,2022-01-30,Piumhi/MG,0,120,188,7691
171762,2022-01-31,Piumhi/MG,0,120,79,7770
177359,2022-02-01,Piumhi/MG,0,120,39,7809
182956,2022-02-02,Piumhi/MG,0,120,84,7893
188553,2022-02-03,Piumhi/MG,0,120,132,8025
194150,2022-02-04,Piumhi/MG,1,121,115,8140
199747,2022-02-05,Piumhi/MG,1,122,64,8204
205344,2022-02-06,Piumhi/MG,0,122,55,8259
210941,2022-02-07,Piumhi/MG,0,122,0,8259
216538,2022-02-08,Piumhi/MG,0,122,77,8336
222135,2022-02-09,Piumhi/MG,0,122,0,8336
227732,2022-02-10,Piumhi/MG,0,122,151,8487
233329,2022-02-11,Piumhi/MG,0,122,46,8533
238926,2022-02-12,Piumhi/MG,0,122,61,8594
244523,2022-02-13,Piumhi/MG,0,122,67,8661
250120,2022-02-14,Piumhi/MG,0,122,26,8687
255717,2022-02-15,Piumhi/MG,0,122,4,8691
261314,2022-02-16,Piumhi/MG,0,122,32,8723
266911,2022-02-17,Piumhi/MG,0,122,81,8804
272508,2022-02-18,Piumhi/MG,2,124,27,8831
278105,2022-02-19,Piumhi/MG,3,127,33,8864
283702,2022-02-20,Piumhi/MG,0,127,26,8890
289299,2022-02-21,Piumhi/MG,0,127,0,8890
294896,2022-02-22,Piumhi/MG,0,127,25,8915
300493,2022-02-23,Piumhi/MG,0,127,20,8935
306090,2022-02-24,Piumhi/MG,0,127,34,8969
311687,2022-02-25,Piumhi/MG,0,127,25,8994
317284,2022-02-26,Piumhi/MG,2,129,15,9009
322881,2022-02-27,Piumhi/MG,0,129,24,9033
328478,2022-02-28,Piumhi/MG,0,129,18,9051
334075,2022-03-01,Piumhi/MG,0,129,4,9055
339672,2022-03-02,Piumhi/MG,0,129,0,9055
345269,2022-03-03,Piumhi/MG,0,129,18,9073
350866,2022-03-04,Piumhi/MG,0,129,3,9076
356463,2022-03-05,Piumhi/MG,0,129,19,9095
362060,2022-03-06,Piumhi/MG,0,129,17,9112
367657,2022-03-07,Piumhi/MG,0,129,6,9118
373254,2022-03-08,Piumhi/MG,0,129,2,9120
378851,2022-03-09,Piumhi/MG,0,129,6,9126
384448,2022-03-10,Piumhi/MG,0,129,18,9144
390045,2022-03-11,Piumhi/MG,4,133,8,9152
395642,2022-03-12,Piumhi/MG,0,133,9,9161
401239,2022-03-13,Piumhi/MG,0,133,0,9161
406836,2022-03-14,Piumhi/MG,0,133,0,9161
412433,2022-03-15,Piumhi/MG,0,133,15,9176
418030,2022-03-16,Piumhi/MG,0,133,4,9180
423627,2022-03-17,Piumhi/MG,0,133,7,9187
429224,2022-03-18,Piumhi/MG,0,133,8,9195
434821,2022-03-19,Piumhi/MG,0,133,9,9204
440418,2022-03-20,Piumhi/MG,0,133,0,9204
446015,2022-03-21,Piumhi/MG,0,133,0,9204
451612,2022-03-22,Piumhi/MG,0,133,4,9208
457209,2022-03-23,Piumhi/MG,0,133,2,9210
462806,2022-03-24,Piumhi/MG,0,133,4,9214
468403,2022-03-25,Piumhi/MG,0,133,1,9215
474000,2022-03-26,Piumhi/MG,0,133,1,9216
479597,2022-03-27,Piumhi/MG,0,133,0,9216
485194,2022-03-28,Piumhi/MG,0,133,0,9216
490791,2022-03-29,Piumhi/MG,0,133,1,9217
496388,2022-03-30,Piumhi/MG,0,133,3,9220
501985,2022-03-31,Piumhi/MG,0,133,0,9220
507582,2022-04-01,Piumhi/MG,0,133,2,9222
513179,2022-04-02,Piumhi/MG,0,133,0,9222
518776,2022-04-03,Piumhi/MG,0,133,0,9222
524373,2022-04-04,Piumhi/MG,0,133,0,9222
529970,2022-04-05,Piumhi/MG,0,133,3,9225
535567,2022-04-06,Piumhi/MG,0,133,1,9226
541164,2022-04-07,Piumhi/MG,0,133,0,9226
546761,2022-04-08,Piumhi/MG,0,133,0,9226
552358,2022-04-09,Piumhi/MG,0,133,1,9227
557955,2022-04-10,Piumhi/MG,0,133,0,9227
563552,2022-04-11,Piumhi/MG,0,133,0,9227
569149,2022-04-12,Piumhi/MG,0,133,4,9231
574746,2022-04-13,Piumhi/MG,0,133,1,9232
580343,2022-04-14,Piumhi/MG,0,133,0,9232
585940,2022-04-15,Piumhi/MG,0,133,7,9239
591537,2022-04-16,Piumhi/MG,0,133,0,9239
597134,2022-04-17,Piumhi/MG,0,133,0,9239
602731,2022-04-18,Piumhi/MG,0,133,0,9239
608328,2022-04-19,Piumhi/MG,0,133,2,9241
613925,2022-04-20,Piumhi/MG,0,133,0,9241
619522,2022-04-21,Piumhi/MG,0,133,3,9244
625119,2022-04-22,Piumhi/MG,1,134,2,9246
630716,2022-04-23,Piumhi/MG,0,134,3,9249
636313,2022-04-24,Piumhi/MG,0,134,0,9249
641910,2022-04-25,Piumhi/MG,0,134,0,9249
647507,2022-04-26,Piumhi/MG,0,134,3,9252
653104,2022-04-27,Piumhi/MG,0,134,4,9256
658701,2022-04-28,Piumhi/MG,0,134,1,9257
664298,2022-04-29,Piumhi/MG,0,134,1,9258
669895,2022-04-30,Piumhi/MG,0,134,0,9258
675492,2022-05-01,Piumhi/MG,0,134,3,9261
681089,2022-05-02,Piumhi/MG,0,134,0,9261
686686,2022-05-03,Piumhi/MG,0,134,3,9264
692283,2022-05-04,Piumhi/MG,0,134,0,9264
697880,2022-05-05,Piumhi/MG,0,134,2,9266
703477,2022-05-06,Piumhi/MG,0,134,2,9268
709074,2022-05-07,Piumhi/MG,0,134,0,9268
714671,2022-05-08,Piumhi/MG,0,134,0,9268
720268,2022-05-09,Piumhi/MG,0,134,6,9274
725865,2022-05-10,Piumhi/MG,0,134,19,9293
731462,2022-05-11,Piumhi/MG,0,134,6,9299
737059,2022-05-12,Piumhi/MG,0,134,16,9315
742656,2022-05-13,Piumhi/MG,0,134,0,9315
748253,2022-05-14,Piumhi/MG,0,134,0,9315
753850,2022-05-15,Piumhi/MG,0,134,0,9315
759447,2022-05-16,Piumhi/MG,0,134,23,9338
765044,2022-05-17,Piumhi/MG,0,134,46,9384
770641,2022-05-18,Piumhi/MG,0,134,7,9391
776238,2022-05-19,Piumhi/MG,0,134,18,9409
781835,2022-05-20,Piumhi/MG,0,134,9,9418
787432,2022-05-21,Piumhi/MG,0,134,0,9418
793029,2022-05-22,Piumhi/MG,0,134,0,9418
798626,2022-05-23,Piumhi/MG,0,134,12,9430
804223,2022-05-24,Piumhi/MG,0,134,25,9455
809820,2022-05-25,Piumhi/MG,0,134,13,9468
815417,2022-05-26,Piumhi/MG,0,134,0,9468
821014,2022-05-27,Piumhi/MG,0,134,44,9512
826611,2022-05-28,Piumhi/MG,0,134,0,9512
832208,2022-05-29,Piumhi/MG,0,134,0,9512
837805,2022-05-30,Piumhi/MG,0,134,43,9555
843402,2022-05-31,Piumhi/MG,0,134,39,9594
848999,2022-06-01,Piumhi/MG,0,134,10,9604
854596,2022-06-02,Piumhi/MG,0,134,30,9634
860193,2022-06-03,Piumhi/MG,0,134,15,9649
865790,2022-06-04,Piumhi/MG,0,134,0,9649
871387,2022-06-05,Piumhi/MG,0,134,0,9649
876984,2022-06-06,Piumhi/MG,0,134,22,9671
882581,2022-06-07,Piumhi/MG,0,134,53,9724
888178,2022-06-08,Piumhi/MG,0,134,15,9739
893775,2022-06-09,Piumhi/MG,0,134,36,9775
899372,2022-06-10,Piumhi/MG,1,135,12,9787
904969,2022-06-11,Piumhi/MG,0,135,0,9787
910566,2022-06-12,Piumhi/MG,0,135,0,9787
916163,2022-06-13,Piumhi/MG,0,135,35,9822
921760,2022-06-14,Piumhi/MG,0,135,26,9848
927357,2022-06-15,Piumhi/MG,1,136,11,9859
932954,2022-06-16,Piumhi/MG,0,136,0,9859
938551,2022-06-17,Piumhi/MG,0,136,0,9859
944148,2022-06-18,Piumhi/MG,0,136,0,9859
949745,2022-06-19,Piumhi/MG,0,136,0,9859
955342,2022-06-20,Piumhi/MG,0,136,24,9883
960939,2022-06-21,Piumhi/MG,0,136,57,9940
966536,2022-06-22,Piumhi/MG,0,136,0,9940
972133,2022-06-23,Piumhi/MG,0,136,37,9977
977730,2022-06-24,Piumhi/MG,1,137,24,10001
983327,2022-06-25,Piumhi/MG,0,137,0,10001
988924,2022-06-26,Piumhi/MG,0,137,0,10001
994521,2022-06-27,Piumhi/MG,0,137,18,10019
1000118,2022-06-28,Piumhi/MG,0,137,40,10059
1005715,2022-06-29,Piumhi/MG,0,137,13,10072
1011312,2022-06-30,Piumhi/MG,1,138,20,10092
1016909,2022-07-01,Piumhi/MG,0,138,17,10109
1022506,2022-07-02,Piumhi/MG,0,138,0,10109
1028103,2022-07-03,Piumhi/MG,0,138,0,10109
1033700,2022-07-04,Piumhi/MG,0,138,0,10109
1039297,2022-07-05,Piumhi/MG,0,138,52,10161
1044894,2022-07-06,Piumhi/MG,0,138,12,10173
1050491,2022-07-07,Piumhi/MG,0,138,19,10192
1056088,2022-07-08,Piumhi/MG,0,138,15,10207
1061685,2022-07-09,Piumhi/MG,0,138,0,10207
1067282,2022-07-10,Piumhi/MG,0,138,0,10207
1072879,2022-07-11,Piumhi/MG,0,138,12,10219
1078476,2022-07-12,Piumhi/MG,0,138,29,10248
1084073,2022-07-13,Piumhi/MG,0,138,12,10260
1089670,2022-07-14,Piumhi/MG,0,138,12,10272
1095267,2022-07-15,Piumhi/MG,0,138,13,10285
1100864,2022-07-16,Piumhi/MG,0,138,0,10285
1106461,2022-07-17,Piumhi/MG,0,138,0,10285
1112058,2022-07-18,Piumhi/MG,0,138,0,10285
1117655,2022-07-19,Piumhi/MG,0,138,55,10340
1123252,2022-07-20,Piumhi/MG,0,138,4,10344
1128849,2022-07-21,Piumhi/MG,0,138,10,10354
1134446,2022-07-22,Piumhi/MG,1,139,21,10375
1140043,2022-07-23,Piumhi/MG,0,139,0,10375
1145640,2022-07-24,Piumhi/MG,0,139,0,10375
1151237,2022-07-25,Piumhi/MG,0,139,31,10406
1156834,2022-07-26,Piumhi/MG,0,139,34,10440
1162431,2022-07-27,Piumhi/MG,0,139,9,10449
1168028,2022-07-28,Piumhi/MG,0,139,12,10461
1173625,2022-07-29,Piumhi/MG,0,139,12,10473
1179222,2022-07-30,Piumhi/MG,0,139,0,10473
1184819,2022-07-31,Piumhi/MG,0,139,0,10473
1190416,2022-08-01,Piumhi/MG,0,139,13,10486
1196013,2022-08-02,Piumhi/MG,0,139,37,10523
1201610,2022-08-03,Piumhi/MG,1,140,5,10528
1207207,2022-08-04,Piumhi/MG,0,140,17,10545
1212804,2022-08-05,Piumhi/MG,0,140,6,10551
1218401,2022-08-06,Piumhi/MG,0,140,0,10551
1223998,2022-08-07,Piumhi/MG,0,140,0,10551
1229595,2022-08-08,Piumhi/MG,1,141,9,10560
1235192,2022-08-09,Piumhi/MG,0,141,25,10585
1240789,2022-08-10,Piumhi/MG,0,141,4,10589
1246386,2022-08-11,Piumhi/MG,0,141,14,10603
1251983,2022-08-12,Piumhi/MG,1,142,3,10606
1257580,2022-08-13,Piumhi/MG,0,142,0,10606
1263177,2022-08-14,Piumhi/MG,0,142,0,10606
1268774,2022-08-15,Piumhi/MG,0,142,0,10606
1274371,2022-08-16,Piumhi/MG,0,142,29,10635
1279968,2022-08-17,Piumhi/MG,0,142,0,10635
1285565,2022-08-18,Piumhi/MG,0,142,3,10638
1291162,2022-08-19,Piumhi/MG,0,142,9,10647
1296759,2022-08-20,Piumhi/MG,0,142,0,10647
1302356,2022-08-21,Piumhi/MG,0,142,0,10647
1307953,2022-08-22,Piumhi/MG,0,142,1,10648
1313550,2022-08-23,Piumhi/MG,0,142,7,10655
1319147,2022-08-24,Piumhi/MG,0,142,0,10655
1324744,2022-08-25,Piumhi/MG,0,142,3,10658
1567,2022-01-01,Divinópolis/MG,0,660,0,21899
7164,2022-01-02,Divinópolis/MG,0,660,0,21899
12761,2022-01-03,Divinópolis/MG,0,660,0,21899
18358,2022-01-04,Divinópolis/MG,0,660,3,21902
23955,2022-01-05,Divinópolis/MG,0,660,14,21916
29552,2022-01-06,Divinópolis/MG,0,660,9,21925
35149,2022-01-07,Divinópolis/MG,0,660,48,21973
40746,2022-01-08,Divinópolis/MG,0,660,47,22020
46343,2022-01-09,Divinópolis/MG,0,660,0,22020
51940,2022-01-10,Divinópolis/MG,0,660,0,22020
57537,2022-01-11,Divinópolis/MG,0,660,41,22061
63134,2022-01-12,Divinópolis/MG,0,660,56,22117
68731,2022-01-13,Divinópolis/MG,1,661,25,22142
74328,2022-01-14,Divinópolis/MG,0,661,70,22212
79925,2022-01-15,Divinópolis/MG,0,661,122,22334
85522,2022-01-16,Divinópolis/MG,0,661,0,22334
91119,2022-01-17,Divinópolis/MG,0,661,0,22334
96716,2022-01-18,Divinópolis/MG,0,661,121,22455
102313,2022-01-19,Divinópolis/MG,0,661,129,22584
107910,2022-01-20,Divinópolis/MG,1,662,135,22719
113507,2022-01-21,Divinópolis/MG,0,662,141,22860
119104,2022-01-22,Divinópolis/MG,0,662,113,22973
124701,2022-01-23,Divinópolis/MG,0,662,0,22973
130298,2022-01-24,Divinópolis/MG,0,662,0,22973
135895,2022-01-25,Divinópolis/MG,0,662,147,23120
141492,2022-01-26,Divinópolis/MG,2,664,246,23366
147089,2022-01-27,Divinópolis/MG,0,664,163,23529
152686,2022-01-28,Divinópolis/MG,0,664,234,23763
158283,2022-01-29,Divinópolis/MG,2,666,196,23959
163880,2022-01-30,Divinópolis/MG,2,668,0,23959
169477,2022-01-31,Divinópolis/MG,0,668,0,23959
175074,2022-02-01,Divinópolis/MG,1,669,196,24155
180671,2022-02-02,Divinópolis/MG,2,671,210,24365
186268,2022-02-03,Divinópolis/MG,2,673,200,24565
191865,2022-02-04,Divinópolis/MG,1,674,188,24753
197462,2022-02-05,Divinópolis/MG,2,676,207,24960
203059,2022-02-06,Divinópolis/MG,3,679,0,24960
208656,2022-02-07,Divinópolis/MG,0,679,0,24960
214253,2022-02-08,Divinópolis/MG,1,680,450,25410
219850,2022-02-09,Divinópolis/MG,4,684,350,25760
225447,2022-02-10,Divinópolis/MG,2,686,0,25760
231044,2022-02-11,Divinópolis/MG,4,690,671,26431
236641,2022-02-12,Divinópolis/MG,1,691,404,26835
242238,2022-02-13,Divinópolis/MG,-1,690,0,26835
247835,2022-02-14,Divinópolis/MG,1,691,0,26835
253432,2022-02-15,Divinópolis/MG,1,692,505,27340
259029,2022-02-16,Divinópolis/MG,2,694,375,27715
264626,2022-02-17,Divinópolis/MG,1,695,393,28108
270223,2022-02-18,Divinópolis/MG,1,696,499,28607
275820,2022-02-19,Divinópolis/MG,0,696,591,29198
281417,2022-02-20,Divinópolis/MG,2,698,0,29198
287014,2022-02-21,Divinópolis/MG,0,698,0,29198
292611,2022-02-22,Divinópolis/MG,0,698,552,29750
298208,2022-02-23,Divinópolis/MG,0,698,423,30173
303805,2022-02-24,Divinópolis/MG,0,698,295,30468
309402,2022-02-25,Divinópolis/MG,0,698,370,30838
314999,2022-02-26,Divinópolis/MG,0,698,349,31187
320596,2022-02-27,Divinópolis/MG,1,699,0,31187
326193,2022-02-28,Divinópolis/MG,0,699,0,31187
331790,2022-03-01,Divinópolis/MG,0,699,0,31187
337387,2022-03-02,Divinópolis/MG,0,699,0,31187
342984,2022-03-03,Divinópolis/MG,0,699,0,31187
348581,2022-03-04,Divinópolis/MG,0,699,713,31900
354178,2022-03-05,Divinópolis/MG,4,703,288,32188
359775,2022-03-06,Divinópolis/MG,0,703,0,32188
365372,2022-03-07,Divinópolis/MG,0,703,0,32188
370969,2022-03-08,Divinópolis/MG,0,703,353,32541
376566,2022-03-09,Divinópolis/MG,0,703,406,32947
382163,2022-03-10,Divinópolis/MG,0,703,269,33216
387760,2022-03-11,Divinópolis/MG,0,703,227,33443
393357,2022-03-12,Divinópolis/MG,0,703,400,33843
398954,2022-03-13,Divinópolis/MG,0,703,0,33843
404551,2022-03-14,Divinópolis/MG,0,703,0,33843
410148,2022-03-15,Divinópolis/MG,0,703,378,34221
415745,2022-03-16,Divinópolis/MG,1,704,429,34650
421342,2022-03-17,Divinópolis/MG,1,705,235,34885
426939,2022-03-18,Divinópolis/MG,0,705,372,35257
432536,2022-03-19,Divinópolis/MG,0,705,319,35576
438133,2022-03-20,Divinópolis/MG,0,705,0,35576
443730,2022-03-21,Divinópolis/MG,0,705,0,35576
449327,2022-03-22,Divinópolis/MG,0,705,302,35878
454924,2022-03-23,Divinópolis/MG,0,705,175,36053
460521,2022-03-24,Divinópolis/MG,0,705,49,36102
466118,2022-03-25,Divinópolis/MG,0,705,11,36113
471715,2022-03-26,Divinópolis/MG,0,705,72,36185
477312,2022-03-27,Divinópolis/MG,0,705,0,36185
482909,2022-03-28,Divinópolis/MG,0,705,0,36185
488506,2022-03-29,Divinópolis/MG,0,705,37,36222
494103,2022-03-30,Divinópolis/MG,0,705,25,36247
499700,2022-03-31,Divinópolis/MG,1,706,0,36247
505297,2022-04-01,Divinópolis/MG,1,707,37,36284
510894,2022-04-02,Divinópolis/MG,0,707,0,36284
516491,2022-04-03,Divinópolis/MG,0,707,0,36284
522088,2022-04-04,Divinópolis/MG,-1,706,75,36359
527685,2022-04-05,Divinópolis/MG,0,706,13,36372
533282,2022-04-06,Divinópolis/MG,0,706,19,36391
538879,2022-04-07,Divinópolis/MG,0,706,5,36396
544476,2022-04-08,Divinópolis/MG,0,706,0,36396
550073,2022-04-09,Divinópolis/MG,0,706,27,36423
555670,2022-04-10,Divinópolis/MG,0,706,0,36423
561267,2022-04-11,Divinópolis/MG,0,706,0,36423
566864,2022-04-12,Divinópolis/MG,0,706,6,36429
572461,2022-04-13,Divinópolis/MG,1,707,5,36434
578058,2022-04-14,Divinópolis/MG,0,707,8,36442
583655,2022-04-15,Divinópolis/MG,0,707,0,36442
589252,2022-04-16,Divinópolis/MG,0,707,0,36442
594849,2022-04-17,Divinópolis/MG,0,707,0,36442
600446,2022-04-18,Divinópolis/MG,0,707,0,36442
606043,2022-04-19,Divinópolis/MG,0,707,29,36471
611640,2022-04-20,Divinópolis/MG,0,707,60,36531
617237,2022-04-21,Divinópolis/MG,0,707,21,36552
622834,2022-04-22,Divinópolis/MG,0,707,0,36552
628431,2022-04-23,Divinópolis/MG,0,707,11,36563
634028,2022-04-24,Divinópolis/MG,0,707,0,36563
639625,2022-04-25,Divinópolis/MG,0,707,0,36563
645222,2022-04-26,Divinópolis/MG,0,707,38,36601
650819,2022-04-27,Divinópolis/MG,0,707,32,36633
656416,2022-04-28,Divinópolis/MG,0,707,38,36671
662013,2022-04-29,Divinópolis/MG,0,707,10,36681
667610,2022-04-30,Divinópolis/MG,0,707,69,36750
673207,2022-05-01,Divinópolis/MG,0,707,0,36750
678804,2022-05-02,Divinópolis/MG,0,707,0,36750
684401,2022-05-03,Divinópolis/MG,0,707,11,36761
689998,2022-05-04,Divinópolis/MG,0,707,1,36762
695595,2022-05-05,Divinópolis/MG,0,707,3,36765
701192,2022-05-06,Divinópolis/MG,0,707,13,36778
706789,2022-05-07,Divinópolis/MG,0,707,0,36778
712386,2022-05-08,Divinópolis/MG,0,707,0,36778
717983,2022-05-09,Divinópolis/MG,0,707,26,36804
723580,2022-05-10,Divinópolis/MG,1,708,18,36822
729177,2022-05-11,Divinópolis/MG,0,708,1,36823
734774,2022-05-12,Divinópolis/MG,0,708,9,36832
740371,2022-05-13,Divinópolis/MG,0,708,4,36836
745968,2022-05-14,Divinópolis/MG,0,708,0,36836
751565,2022-05-15,Divinópolis/MG,0,708,0,36836
757162,2022-05-16,Divinópolis/MG,0,708,40,36876
762759,2022-05-17,Divinópolis/MG,0,708,36,36912
768356,2022-05-18,Divinópolis/MG,0,708,5,36917
773953,2022-05-19,Divinópolis/MG,0,708,12,36929
779550,2022-05-20,Divinópolis/MG,0,708,3,36932
785147,2022-05-21,Divinópolis/MG,0,708,0,36932
790744,2022-05-22,Divinópolis/MG,0,708,0,36932
796341,2022-05-23,Divinópolis/MG,0,708,14,36946
801938,2022-05-24,Divinópolis/MG,0,708,9,36955
807535,2022-05-25,Divinópolis/MG,0,708,4,36959
813132,2022-05-26,Divinópolis/MG,0,708,13,36972
818729,2022-05-27,Divinópolis/MG,0,708,37,37009
824326,2022-05-28,Divinópolis/MG,0,708,0,37009
829923,2022-05-29,Divinópolis/MG,0,708,0,37009
835520,2022-05-30,Divinópolis/MG,0,708,29,37038
841117,2022-05-31,Divinópolis/MG,0,708,46,37084
846714,2022-06-01,Divinópolis/MG,0,708,20,37104
852311,2022-06-02,Divinópolis/MG,0,708,0,37104
857908,2022-06-03,Divinópolis/MG,0,708,2,37106
863505,2022-06-04,Divinópolis/MG,0,708,0,37106
869102,2022-06-05,Divinópolis/MG,0,708,0,37106
874699,2022-06-06,Divinópolis/MG,0,708,36,37142
880296,2022-06-07,Divinópolis/MG,0,708,18,37160
885893,2022-06-08,Divinópolis/MG,0,708,21,37181
891490,2022-06-09,Divinópolis/MG,0,708,32,37213
897087,2022-06-10,Divinópolis/MG,0,708,0,37213
902684,2022-06-11,Divinópolis/MG,0,708,0,37213
908281,2022-06-12,Divinópolis/MG,0,708,0,37213
913878,2022-06-13,Divinópolis/MG,1,709,106,37319
919475,2022-06-14,Divinópolis/MG,0,709,0,37319
925072,2022-06-15,Divinópolis/MG,0,709,113,37432
930669,2022-06-16,Divinópolis/MG,0,709,0,37432
936266,2022-06-17,Divinópolis/MG,0,709,0,37432
941863,2022-06-18,Divinópolis/MG,0,709,0,37432
947460,2022-06-19,Divinópolis/MG,0,709,0,37432
953057,2022-06-20,Divinópolis/MG,0,709,65,37497
958654,2022-06-21,Divinópolis/MG,0,709,60,37557
964251,2022-06-22,Divinópolis/MG,0,709,92,37649
969848,2022-06-23,Divinópolis/MG,0,709,52,37701
975445,2022-06-24,Divinópolis/MG,1,710,65,37766
981042,2022-06-25,Divinópolis/MG,0,710,0,37766
986639,2022-06-26,Divinópolis/MG,0,710,0,37766
992236,2022-06-27,Divinópolis/MG,0,710,115,37881
997833,2022-06-28,Divinópolis/MG,0,710,152,38033
1003430,2022-06-29,Divinópolis/MG,1,711,128,38161
1009027,2022-06-30,Divinópolis/MG,1,712,98,38259
1014624,2022-07-01,Divinópolis/MG,1,713,142,38401
1020221,2022-07-02,Divinópolis/MG,0,713,0,38401
1025818,2022-07-03,Divinópolis/MG,0,713,0,38401
1031415,2022-07-04,Divinópolis/MG,0,713,151,38552
1037012,2022-07-05,Divinópolis/MG,0,713,228,38780
1042609,2022-07-06,Divinópolis/MG,0,713,181,38961
1048206,2022-07-07,Divinópolis/MG,0,713,114,39075
1053803,2022-07-08,Divinópolis/MG,2,715,120,39195
1059400,2022-07-09,Divinópolis/MG,0,715,0,39195
1064997,2022-07-10,Divinópolis/MG,0,715,0,39195
1070594,2022-07-11,Divinópolis/MG,1,716,202,39397
1076191,2022-07-12,Divinópolis/MG,0,716,0,39397
1081788,2022-07-13,Divinópolis/MG,2,718,0,39397
1087385,2022-07-14,Divinópolis/MG,0,718,549,39946
1092982,2022-07-15,Divinópolis/MG,2,720,215,40161
1098579,2022-07-16,Divinópolis/MG,0,720,0,40161
1104176,2022-07-17,Divinópolis/MG,0,720,0,40161
1109773,2022-07-18,Divinópolis/MG,0,720,213,40374
1115370,2022-07-19,Divinópolis/MG,0,720,123,40497
1120967,2022-07-20,Divinópolis/MG,0,720,130,40627
1126564,2022-07-21,Divinópolis/MG,1,721,142,40769
1132161,2022-07-22,Divinópolis/MG,0,721,98,40867
1137758,2022-07-23,Divinópolis/MG,0,721,0,40867
1143355,2022-07-24,Divinópolis/MG,0,721,0,40867
1148952,2022-07-25,Divinópolis/MG,0,721,0,40867
1154549,2022-07-26,Divinópolis/MG,1,722,250,41117
1160146,2022-07-27,Divinópolis/MG,2,724,17,41134
1165743,2022-07-28,Divinópolis/MG,1,725,0,41134
1171340,2022-07-29,Divinópolis/MG,0,725,100,41234
1176937,2022-07-30,Divinópolis/MG,0,725,0,41234
1182534,2022-07-31,Divinópolis/MG,0,725,0,41234
1188131,2022-08-01,Divinópolis/MG,1,726,31,41265
1193728,2022-08-02,Divinópolis/MG,0,726,0,41265
1199325,2022-08-03,Divinópolis/MG,0,726,53,41318
1204922,2022-08-04,Divinópolis/MG,0,726,31,41349
1210519,2022-08-05,Divinópolis/MG,0,726,36,41385
1216116,2022-08-06,Divinópolis/MG,0,726,0,41385
1221713,2022-08-07,Divinópolis/MG,0,726,0,41385
1227310,2022-08-08,Divinópolis/MG,1,727,36,41421
1232907,2022-08-09,Divinópolis/MG,0,727,19,41440
1238504,2022-08-10,Divinópolis/MG,0,727,37,41477
1244101,2022-08-11,Divinópolis/MG,3,730,17,41494
1249698,2022-08-12,Divinópolis/MG,0,730,19,41513
1255295,2022-08-13,Divinópolis/MG,0,730,0,41513
1260892,2022-08-14,Divinópolis/MG,0,730,0,41513
1266489,2022-08-15,Divinópolis/MG,0,730,0,41513
1272086,2022-08-16,Divinópolis/MG,1,731,55,41568
1277683,2022-08-17,Divinópolis/MG,1,732,7,41575
1283280,2022-08-18,Divinópolis/MG,1,733,12,41587
1288877,2022-08-19,Divinópolis/MG,0,733,21,41608
1294474,2022-08-20,Divinópolis/MG,0,733,0,41608
1300071,2022-08-21,Divinópolis/MG,0,733,0,41608
1305668,2022-08-22,Divinópolis/MG,1,734,21,41629
1311265,2022-08-23,Divinópolis/MG,0,734,21,41650
1316862,2022-08-24,Divinópolis/MG,0,734,7,41657
1322459,2022-08-25,Divinópolis/MG,0,734,9,41666
548,2022-01-01,Belo Horizonte/MG,0,7058,0,295369
6145,2022-01-02,Belo Horizonte/MG,0,7058,0,295369
11742,2022-01-03,Belo Horizonte/MG,6,7064,157,295526
17339,2022-01-04,Belo Horizonte/MG,5,7069,114,295640
22936,2022-01-05,Belo Horizonte/MG,0,7069,567,296207
28533,2022-01-06,Belo Horizonte/MG,7,7076,421,296628
34130,2022-01-07,Belo Horizonte/MG,1,7077,772,297400
39727,2022-01-08,Belo Horizonte/MG,1,7078,326,297726
45324,2022-01-09,Belo Horizonte/MG,8,7086,0,297726
50921,2022-01-10,Belo Horizonte/MG,0,7086,0,297726
56518,2022-01-11,Belo Horizonte/MG,0,7086,1836,299562
62115,2022-01-12,Belo Horizonte/MG,4,7090,1113,300675
67712,2022-01-13,Belo Horizonte/MG,2,7092,1022,301697
73309,2022-01-14,Belo Horizonte/MG,5,7097,1293,302990
78906,2022-01-15,Belo Horizonte/MG,3,7100,1081,304071
84503,2022-01-16,Belo Horizonte/MG,0,7100,0,304071
90100,2022-01-17,Belo Horizonte/MG,1,7101,0,304071
95697,2022-01-18,Belo Horizonte/MG,0,7101,67,304138
101294,2022-01-19,Belo Horizonte/MG,1,7102,1069,305207
106891,2022-01-20,Belo Horizonte/MG,0,7102,1041,306248
112488,2022-01-21,Belo Horizonte/MG,2,7104,1227,307475
118085,2022-01-22,Belo Horizonte/MG,5,7109,1002,308477
123682,2022-01-23,Belo Horizonte/MG,3,7112,0,308477
129279,2022-01-24,Belo Horizonte/MG,0,7112,0,308477
134876,2022-01-25,Belo Horizonte/MG,0,7112,1223,309700
140473,2022-01-26,Belo Horizonte/MG,3,7115,0,309700
146070,2022-01-27,Belo Horizonte/MG,4,7119,1841,311541
151667,2022-01-28,Belo Horizonte/MG,7,7126,1384,312925
157264,2022-01-29,Belo Horizonte/MG,7,7133,845,313770
162861,2022-01-30,Belo Horizonte/MG,2,7135,0,313770
168458,2022-01-31,Belo Horizonte/MG,0,7135,0,313770
174055,2022-02-01,Belo Horizonte/MG,2,7137,1419,315189
179652,2022-02-02,Belo Horizonte/MG,7,7144,1058,316247
185249,2022-02-03,Belo Horizonte/MG,3,7147,0,316247
190846,2022-02-04,Belo Horizonte/MG,16,7163,2202,318449
196443,2022-02-05,Belo Horizonte/MG,13,7176,1117,319566
202040,2022-02-06,Belo Horizonte/MG,14,7190,0,319566
207637,2022-02-07,Belo Horizonte/MG,0,7190,0,319566
213234,2022-02-08,Belo Horizonte/MG,7,7197,1407,320973
218831,2022-02-09,Belo Horizonte/MG,11,7208,927,321900
224428,2022-02-10,Belo Horizonte/MG,13,7221,1059,322959
230025,2022-02-11,Belo Horizonte/MG,6,7227,1302,324261
235622,2022-02-12,Belo Horizonte/MG,9,7236,1273,325534
241219,2022-02-13,Belo Horizonte/MG,-4,7232,0,325534
246816,2022-02-14,Belo Horizonte/MG,15,7247,0,325534
252413,2022-02-15,Belo Horizonte/MG,0,7247,0,325534
258010,2022-02-16,Belo Horizonte/MG,9,7256,2452,327986
263607,2022-02-17,Belo Horizonte/MG,17,7273,0,327986
269204,2022-02-18,Belo Horizonte/MG,14,7287,87,328073
274801,2022-02-19,Belo Horizonte/MG,17,7304,4398,332471
280398,2022-02-20,Belo Horizonte/MG,20,7324,0,332471
285995,2022-02-21,Belo Horizonte/MG,0,7324,0,332471
291592,2022-02-22,Belo Horizonte/MG,0,7324,1746,334217
297189,2022-02-23,Belo Horizonte/MG,14,7338,1853,336070
302786,2022-02-24,Belo Horizonte/MG,17,7355,0,336070
308383,2022-02-25,Belo Horizonte/MG,29,7384,2853,338923
313980,2022-02-26,Belo Horizonte/MG,7,7391,1601,340524
319577,2022-02-27,Belo Horizonte/MG,8,7399,0,340524
325174,2022-02-28,Belo Horizonte/MG,0,7399,0,340524
330771,2022-03-01,Belo Horizonte/MG,1,7400,1867,342391
336368,2022-03-02,Belo Horizonte/MG,14,7414,0,342391
341965,2022-03-03,Belo Horizonte/MG,7,7421,4415,346806
347562,2022-03-04,Belo Horizonte/MG,5,7426,0,346806
353159,2022-03-05,Belo Horizonte/MG,7,7433,-1133,345673
358756,2022-03-06,Belo Horizonte/MG,24,7457,0,345673
364353,2022-03-07,Belo Horizonte/MG,2,7459,0,345673
369950,2022-03-08,Belo Horizonte/MG,1,7460,0,345673
375547,2022-03-09,Belo Horizonte/MG,15,7475,1783,347456
381144,2022-03-10,Belo Horizonte/MG,8,7483,1187,348643
386741,2022-03-11,Belo Horizonte/MG,17,7500,1115,349758
392338,2022-03-12,Belo Horizonte/MG,13,7513,911,350669
397935,2022-03-13,Belo Horizonte/MG,10,7523,0,350669
403532,2022-03-14,Belo Horizonte/MG,1,7524,0,350669
409129,2022-03-15,Belo Horizonte/MG,3,7527,1443,352112
414726,2022-03-16,Belo Horizonte/MG,1,7528,1368,353480
420323,2022-03-17,Belo Horizonte/MG,10,7538,2100,355580
425920,2022-03-18,Belo Horizonte/MG,6,7544,2054,357634
431517,2022-03-19,Belo Horizonte/MG,9,7553,2412,360046
437114,2022-03-20,Belo Horizonte/MG,0,7553,0,360046
442711,2022-03-21,Belo Horizonte/MG,4,7557,0,360046
448308,2022-03-22,Belo Horizonte/MG,6,7563,2314,362360
453905,2022-03-23,Belo Horizonte/MG,12,7575,2191,364551
459502,2022-03-24,Belo Horizonte/MG,12,7587,2473,367024
465099,2022-03-25,Belo Horizonte/MG,18,7605,2077,369101
470696,2022-03-26,Belo Horizonte/MG,2,7607,2002,371103
476293,2022-03-27,Belo Horizonte/MG,9,7616,0,371103
481890,2022-03-28,Belo Horizonte/MG,1,7617,0,371103
487487,2022-03-29,Belo Horizonte/MG,0,7617,2183,373286
493084,2022-03-30,Belo Horizonte/MG,4,7621,1400,374686
498681,2022-03-31,Belo Horizonte/MG,8,7629,1766,376452
504278,2022-04-01,Belo Horizonte/MG,12,7641,1357,377809
509875,2022-04-02,Belo Horizonte/MG,0,7641,0,377809
515472,2022-04-03,Belo Horizonte/MG,0,7641,0,377809
521069,2022-04-04,Belo Horizonte/MG,15,7656,1991,379800
526666,2022-04-05,Belo Horizonte/MG,3,7659,2201,382001
532263,2022-04-06,Belo Horizonte/MG,11,7670,1428,383429
537860,2022-04-07,Belo Horizonte/MG,3,7673,0,383429
543457,2022-04-08,Belo Horizonte/MG,8,7681,2277,385706
549054,2022-04-09,Belo Horizonte/MG,5,7686,1178,386884
554651,2022-04-10,Belo Horizonte/MG,2,7688,0,386884
560248,2022-04-11,Belo Horizonte/MG,0,7688,0,386884
565845,2022-04-12,Belo Horizonte/MG,0,7688,0,386884
571442,2022-04-13,Belo Horizonte/MG,14,7702,0,386884
577039,2022-04-14,Belo Horizonte/MG,1,7703,1592,388476
582636,2022-04-15,Belo Horizonte/MG,4,7707,101,388577
588233,2022-04-16,Belo Horizonte/MG,2,7709,0,388577
593830,2022-04-17,Belo Horizonte/MG,0,7709,0,388577
599427,2022-04-18,Belo Horizonte/MG,0,7709,0,388577
605024,2022-04-19,Belo Horizonte/MG,4,7713,0,388577
610621,2022-04-20,Belo Horizonte/MG,5,7718,73,388650
616218,2022-04-21,Belo Horizonte/MG,1,7719,319,388969
621815,2022-04-22,Belo Horizonte/MG,6,7725,0,388969
627412,2022-04-23,Belo Horizonte/MG,0,7725,0,388969
633009,2022-04-24,Belo Horizonte/MG,0,7725,0,388969
638606,2022-04-25,Belo Horizonte/MG,0,7725,0,388969
644203,2022-04-26,Belo Horizonte/MG,0,7725,381,389350
649800,2022-04-27,Belo Horizonte/MG,4,7729,19,389369
655397,2022-04-28,Belo Horizonte/MG,4,7733,366,389735
660994,2022-04-29,Belo Horizonte/MG,4,7737,129,389864
666591,2022-04-30,Belo Horizonte/MG,9,7746,61,389925
672188,2022-05-01,Belo Horizonte/MG,0,7746,0,389925
677785,2022-05-02,Belo Horizonte/MG,9,7755,0,389925
683382,2022-05-03,Belo Horizonte/MG,0,7755,111,390036
688979,2022-05-04,Belo Horizonte/MG,0,7755,0,390036
694576,2022-05-05,Belo Horizonte/MG,11,7766,0,390036
700173,2022-05-06,Belo Horizonte/MG,7,7773,470,390506
705770,2022-05-07,Belo Horizonte/MG,0,7773,0,390506
711367,2022-05-08,Belo Horizonte/MG,0,7773,0,390506
716964,2022-05-09,Belo Horizonte/MG,1,7774,107,390613
722561,2022-05-10,Belo Horizonte/MG,1,7775,181,390794
728158,2022-05-11,Belo Horizonte/MG,4,7779,0,390794
733755,2022-05-12,Belo Horizonte/MG,0,7779,0,390794
739352,2022-05-13,Belo Horizonte/MG,3,7782,829,391623
744949,2022-05-14,Belo Horizonte/MG,0,7782,0,391623
750546,2022-05-15,Belo Horizonte/MG,0,7782,0,391623
756143,2022-05-16,Belo Horizonte/MG,5,7787,300,391923
761740,2022-05-17,Belo Horizonte/MG,1,7788,367,392290
767337,2022-05-18,Belo Horizonte/MG,0,7788,146,392436
772934,2022-05-19,Belo Horizonte/MG,2,7790,0,392436
778531,2022-05-20,Belo Horizonte/MG,0,7790,61,392497
784128,2022-05-21,Belo Horizonte/MG,0,7790,0,392497
789725,2022-05-22,Belo Horizonte/MG,0,7790,0,392497
795322,2022-05-23,Belo Horizonte/MG,2,7792,106,392603
800919,2022-05-24,Belo Horizonte/MG,1,7793,569,393172
806516,2022-05-25,Belo Horizonte/MG,6,7799,434,393606
812113,2022-05-26,Belo Horizonte/MG,1,7800,734,394340
817710,2022-05-27,Belo Horizonte/MG,0,7800,873,395213
823307,2022-05-28,Belo Horizonte/MG,0,7800,0,395213
828904,2022-05-29,Belo Horizonte/MG,0,7800,0,395213
834501,2022-05-30,Belo Horizonte/MG,0,7800,0,395213
840098,2022-05-31,Belo Horizonte/MG,1,7801,1432,396645
845695,2022-06-01,Belo Horizonte/MG,0,7801,774,397419
851292,2022-06-02,Belo Horizonte/MG,0,7801,0,397419
856889,2022-06-03,Belo Horizonte/MG,0,7801,1258,398677
862486,2022-06-04,Belo Horizonte/MG,0,7801,0,398677
868083,2022-06-05,Belo Horizonte/MG,0,7801,0,398677
873680,2022-06-06,Belo Horizonte/MG,0,7801,772,399449
879277,2022-06-07,Belo Horizonte/MG,0,7801,935,400384
884874,2022-06-08,Belo Horizonte/MG,14,7815,893,401277
890471,2022-06-09,Belo Horizonte/MG,0,7815,822,402099
896068,2022-06-10,Belo Horizonte/MG,0,7815,971,403070
901665,2022-06-11,Belo Horizonte/MG,0,7815,0,403070
907262,2022-06-12,Belo Horizonte/MG,0,7815,0,403070
912859,2022-06-13,Belo Horizonte/MG,0,7815,913,403983
918456,2022-06-14,Belo Horizonte/MG,7,7822,1109,405092
924053,2022-06-15,Belo Horizonte/MG,25,7847,977,406069
929650,2022-06-16,Belo Horizonte/MG,0,7847,0,406069
935247,2022-06-17,Belo Horizonte/MG,0,7847,0,406069
940844,2022-06-18,Belo Horizonte/MG,0,7847,0,406069
946441,2022-06-19,Belo Horizonte/MG,0,7847,0,406069
952038,2022-06-20,Belo Horizonte/MG,9,7856,2359,408428
957635,2022-06-21,Belo Horizonte/MG,3,7859,652,409080
963232,2022-06-22,Belo Horizonte/MG,0,7859,971,410051
968829,2022-06-23,Belo Horizonte/MG,0,7859,1007,411058
974426,2022-06-24,Belo Horizonte/MG,14,7873,1129,412187
980023,2022-06-25,Belo Horizonte/MG,0,7873,0,412187
985620,2022-06-26,Belo Horizonte/MG,0,7873,0,412187
991217,2022-06-27,Belo Horizonte/MG,5,7878,1332,413519
996814,2022-06-28,Belo Horizonte/MG,0,7878,1165,414684
1002411,2022-06-29,Belo Horizonte/MG,2,7880,971,415655
1008008,2022-06-30,Belo Horizonte/MG,4,7884,1333,416988
1013605,2022-07-01,Belo Horizonte/MG,0,7884,1404,418392
1019202,2022-07-02,Belo Horizonte/MG,0,7884,0,418392
1024799,2022-07-03,Belo Horizonte/MG,0,7884,0,418392
1030396,2022-07-04,Belo Horizonte/MG,1,7885,1441,419833
1035993,2022-07-05,Belo Horizonte/MG,5,7890,1491,421324
1041590,2022-07-06,Belo Horizonte/MG,3,7893,0,421324
1047187,2022-07-07,Belo Horizonte/MG,5,7898,2097,423421
1052784,2022-07-08,Belo Horizonte/MG,4,7902,623,424044
1058381,2022-07-09,Belo Horizonte/MG,0,7902,0,424044
1063978,2022-07-10,Belo Horizonte/MG,0,7902,0,424044
1069575,2022-07-11,Belo Horizonte/MG,4,7906,980,425024
1075172,2022-07-12,Belo Horizonte/MG,7,7913,721,425745
1080769,2022-07-13,Belo Horizonte/MG,10,7923,934,426679
1086366,2022-07-14,Belo Horizonte/MG,7,7930,1037,427716
1091963,2022-07-15,Belo Horizonte/MG,2,7932,938,428654
1097560,2022-07-16,Belo Horizonte/MG,0,7932,0,428654
1103157,2022-07-17,Belo Horizonte/MG,0,7932,0,428654
1108754,2022-07-18,Belo Horizonte/MG,2,7934,1193,429847
1114351,2022-07-19,Belo Horizonte/MG,5,7939,1400,431247
1119948,2022-07-20,Belo Horizonte/MG,6,7945,1279,432526
1125545,2022-07-21,Belo Horizonte/MG,10,7955,856,433382
1131142,2022-07-22,Belo Horizonte/MG,6,7961,0,433382
1136739,2022-07-23,Belo Horizonte/MG,0,7961,0,433382
1142336,2022-07-24,Belo Horizonte/MG,0,7961,0,433382
1147933,2022-07-25,Belo Horizonte/MG,2,7963,964,434346
1153530,2022-07-26,Belo Horizonte/MG,6,7969,0,434346
1159127,2022-07-27,Belo Horizonte/MG,8,7977,1884,436230
1164724,2022-07-28,Belo Horizonte/MG,10,7987,524,436754
1170321,2022-07-29,Belo Horizonte/MG,5,7992,145,436899
1175918,2022-07-30,Belo Horizonte/MG,0,7992,0,436899
1181515,2022-07-31,Belo Horizonte/MG,0,7992,0,436899
1187112,2022-08-01,Belo Horizonte/MG,13,8005,284,437183
1192709,2022-08-02,Belo Horizonte/MG,3,8008,0,437183
1198306,2022-08-03,Belo Horizonte/MG,8,8016,520,437703
1203903,2022-08-04,Belo Horizonte/MG,13,8029,551,438254
1209500,2022-08-05,Belo Horizonte/MG,1,8030,366,438620
1215097,2022-08-06,Belo Horizonte/MG,0,8030,0,438620
1220694,2022-08-07,Belo Horizonte/MG,0,8030,0,438620
1226291,2022-08-08,Belo Horizonte/MG,5,8035,281,438901
1231888,2022-08-09,Belo Horizonte/MG,8,8043,103,439004
1237485,2022-08-10,Belo Horizonte/MG,5,8048,169,439173
1243082,2022-08-11,Belo Horizonte/MG,8,8056,0,439173
1248679,2022-08-12,Belo Horizonte/MG,3,8059,570,439743
1254276,2022-08-13,Belo Horizonte/MG,0,8059,0,439743
1259873,2022-08-14,Belo Horizonte/MG,0,8059,0,439743
1265470,2022-08-15,Belo Horizonte/MG,0,8059,0,439743
1271067,2022-08-16,Belo Horizonte/MG,5,8064,270,440013
1276664,2022-08-17,Belo Horizonte/MG,8,8072,310,440323
1282261,2022-08-18,Belo Horizonte/MG,3,8075,349,440672
1287858,2022-08-19,Belo Horizonte/MG,3,8078,295,440967
1293455,2022-08-20,Belo Horizonte/MG,0,8078,0,440967
1299052,2022-08-21,Belo Horizonte/MG,0,8078,0,440967
1304649,2022-08-22,Belo Horizonte/MG,6,8084,443,441410
1310246,2022-08-23,Belo Horizonte/MG,5,8089,393,441803
1315843,2022-08-24,Belo Horizonte/MG,6,8095,816,442619
1321440,2022-08-25,Belo Horizonte/MG,5,8100,424,443043
582,2022-01-01,Betim/MG,0,1378,0,32683
6179,2022-01-02,Betim/MG,0,1378,0,32683
11776,2022-01-03,Betim/MG,0,1378,0,32683
17373,2022-01-04,Betim/MG,0,1378,0,32683
22970,2022-01-05,Betim/MG,0,1378,0,32683
28567,2022-01-06,Betim/MG,0,1378,0,32683
34164,2022-01-07,Betim/MG,0,1378,74,32757
39761,2022-01-08,Betim/MG,0,1378,29,32786
45358,2022-01-09,Betim/MG,1,1379,0,32786
50955,2022-01-10,Betim/MG,0,1379,0,32786
56552,2022-01-11,Betim/MG,0,1379,14,32800
62149,2022-01-12,Betim/MG,0,1379,163,32963
67746,2022-01-13,Betim/MG,0,1379,0,32963
73343,2022-01-14,Betim/MG,0,1379,205,33168
78940,2022-01-15,Betim/MG,0,1379,122,33290
84537,2022-01-16,Betim/MG,0,1379,0,33290
90134,2022-01-17,Betim/MG,0,1379,0,33290
95731,2022-01-18,Betim/MG,0,1379,0,33290
101328,2022-01-19,Betim/MG,0,1379,303,33593
106925,2022-01-20,Betim/MG,0,1379,273,33866
112522,2022-01-21,Betim/MG,0,1379,343,34209
118119,2022-01-22,Betim/MG,0,1379,19,34228
123716,2022-01-23,Betim/MG,0,1379,0,34228
129313,2022-01-24,Betim/MG,0,1379,0,34228
134910,2022-01-25,Betim/MG,0,1379,252,34480
140507,2022-01-26,Betim/MG,0,1379,0,34480
146104,2022-01-27,Betim/MG,0,1379,0,34480
151701,2022-01-28,Betim/MG,0,1379,2067,36547
157298,2022-01-29,Betim/MG,3,1382,242,36789
162895,2022-01-30,Betim/MG,2,1384,0,36789
168492,2022-01-31,Betim/MG,0,1384,0,36789
174089,2022-02-01,Betim/MG,0,1384,786,37575
179686,2022-02-02,Betim/MG,0,1384,519,38094
185283,2022-02-03,Betim/MG,1,1385,260,38354
190880,2022-02-04,Betim/MG,1,1386,0,38354
196477,2022-02-05,Betim/MG,2,1388,0,38354
202074,2022-02-06,Betim/MG,1,1389,0,38354
207671,2022-02-07,Betim/MG,0,1389,0,38354
213268,2022-02-08,Betim/MG,2,1391,2035,40389
218865,2022-02-09,Betim/MG,1,1392,454,40843
224462,2022-02-10,Betim/MG,1,1393,352,41195
230059,2022-02-11,Betim/MG,3,1396,1085,42280
235656,2022-02-12,Betim/MG,0,1396,1811,44091
241253,2022-02-13,Betim/MG,0,1396,0,44091
246850,2022-02-14,Betim/MG,0,1396,0,44091
252447,2022-02-15,Betim/MG,0,1396,336,44427
258044,2022-02-16,Betim/MG,2,1398,114,44541
263641,2022-02-17,Betim/MG,0,1398,0,44541
269238,2022-02-18,Betim/MG,1,1399,0,44541
274835,2022-02-19,Betim/MG,4,1403,275,44816
280432,2022-02-20,Betim/MG,-1,1402,0,44816
286029,2022-02-21,Betim/MG,0,1402,0,44816
291626,2022-02-22,Betim/MG,0,1402,461,45277
297223,2022-02-23,Betim/MG,2,1404,0,45277
302820,2022-02-24,Betim/MG,1,1405,0,45277
308417,2022-02-25,Betim/MG,0,1405,0,45277
314014,2022-02-26,Betim/MG,2,1407,166,45443
319611,2022-02-27,Betim/MG,0,1407,0,45443
325208,2022-02-28,Betim/MG,0,1407,0,45443
330805,2022-03-01,Betim/MG,0,1407,0,45443
336402,2022-03-02,Betim/MG,0,1407,0,45443
341999,2022-03-03,Betim/MG,0,1407,0,45443
347596,2022-03-04,Betim/MG,0,1407,0,45443
353193,2022-03-05,Betim/MG,4,1411,192,45635
358790,2022-03-06,Betim/MG,0,1411,0,45635
364387,2022-03-07,Betim/MG,0,1411,0,45635
369984,2022-03-08,Betim/MG,1,1412,140,45775
375581,2022-03-09,Betim/MG,1,1413,0,45775
381178,2022-03-10,Betim/MG,2,1415,507,46282
386775,2022-03-11,Betim/MG,1,1416,54,46336
392372,2022-03-12,Betim/MG,3,1419,0,46336
397969,2022-03-13,Betim/MG,0,1419,0,46336
403566,2022-03-14,Betim/MG,0,1419,0,46336
409163,2022-03-15,Betim/MG,0,1419,31,46367
414760,2022-03-16,Betim/MG,0,1419,0,46367
420357,2022-03-17,Betim/MG,1,1420,0,46367
425954,2022-03-18,Betim/MG,0,1420,33,46400
431551,2022-03-19,Betim/MG,0,1420,32,46432
437148,2022-03-20,Betim/MG,0,1420,0,46432
442745,2022-03-21,Betim/MG,0,1420,0,46432
448342,2022-03-22,Betim/MG,1,1421,0,46432
453939,2022-03-23,Betim/MG,0,1421,24,46456
459536,2022-03-24,Betim/MG,0,1421,0,46456
465133,2022-03-25,Betim/MG,0,1421,3,46459
470730,2022-03-26,Betim/MG,0,1421,0,46459
476327,2022-03-27,Betim/MG,1,1422,0,46459
481924,2022-03-28,Betim/MG,0,1422,0,46459
487521,2022-03-29,Betim/MG,0,1422,2,46461
493118,2022-03-30,Betim/MG,1,1423,0,46461
498715,2022-03-31,Betim/MG,1,1424,3,46464
504312,2022-04-01,Betim/MG,0,1424,26,46490
509909,2022-04-02,Betim/MG,0,1424,0,46490
515506,2022-04-03,Betim/MG,0,1424,0,46490
521103,2022-04-04,Betim/MG,1,1425,0,46490
526700,2022-04-05,Betim/MG,0,1425,0,46490
532297,2022-04-06,Betim/MG,-1,1424,16,46506
537894,2022-04-07,Betim/MG,0,1424,0,46506
543491,2022-04-08,Betim/MG,0,1424,5,46511
549088,2022-04-09,Betim/MG,0,1424,0,46511
554685,2022-04-10,Betim/MG,0,1424,0,46511
560282,2022-04-11,Betim/MG,0,1424,0,46511
565879,2022-04-12,Betim/MG,0,1424,0,46511
571476,2022-04-13,Betim/MG,-1,1423,6,46517
577073,2022-04-14,Betim/MG,0,1423,0,46517
582670,2022-04-15,Betim/MG,0,1423,0,46517
588267,2022-04-16,Betim/MG,0,1423,0,46517
593864,2022-04-17,Betim/MG,0,1423,0,46517
599461,2022-04-18,Betim/MG,0,1423,0,46517
605058,2022-04-19,Betim/MG,0,1423,0,46517
610655,2022-04-20,Betim/MG,10,1433,4,46521
616252,2022-04-21,Betim/MG,0,1433,3,46524
621849,2022-04-22,Betim/MG,0,1433,0,46524
627446,2022-04-23,Betim/MG,0,1433,0,46524
633043,2022-04-24,Betim/MG,0,1433,0,46524
638640,2022-04-25,Betim/MG,0,1433,0,46524
644237,2022-04-26,Betim/MG,0,1433,0,46524
649834,2022-04-27,Betim/MG,1,1434,5,46529
655431,2022-04-28,Betim/MG,1,1435,2,46531
661028,2022-04-29,Betim/MG,0,1435,2,46533
666625,2022-04-30,Betim/MG,0,1435,0,46533
672222,2022-05-01,Betim/MG,0,1435,0,46533
677819,2022-05-02,Betim/MG,0,1435,0,46533
683416,2022-05-03,Betim/MG,0,1435,3,46536
689013,2022-05-04,Betim/MG,0,1435,6,46542
694610,2022-05-05,Betim/MG,0,1435,0,46542
700207,2022-05-06,Betim/MG,0,1435,0,46542
705804,2022-05-07,Betim/MG,0,1435,0,46542
711401,2022-05-08,Betim/MG,0,1435,0,46542
716998,2022-05-09,Betim/MG,1,1436,0,46542
722595,2022-05-10,Betim/MG,0,1436,0,46542
728192,2022-05-11,Betim/MG,2,1438,5,46547
733789,2022-05-12,Betim/MG,0,1438,9,46556
739386,2022-05-13,Betim/MG,0,1438,18,46574
744983,2022-05-14,Betim/MG,0,1438,0,46574
750580,2022-05-15,Betim/MG,0,1438,0,46574
756177,2022-05-16,Betim/MG,0,1438,0,46574
761774,2022-05-17,Betim/MG,0,1438,15,46589
767371,2022-05-18,Betim/MG,0,1438,10,46599
772968,2022-05-19,Betim/MG,0,1438,7,46606
778565,2022-05-20,Betim/MG,0,1438,18,46624
784162,2022-05-21,Betim/MG,0,1438,0,46624
789759,2022-05-22,Betim/MG,0,1438,0,46624
795356,2022-05-23,Betim/MG,-1,1437,7,46631
800953,2022-05-24,Betim/MG,0,1437,13,46644
806550,2022-05-25,Betim/MG,0,1437,9,46653
812147,2022-05-26,Betim/MG,0,1437,3,46656
817744,2022-05-27,Betim/MG,0,1437,0,46656
823341,2022-05-28,Betim/MG,0,1437,0,46656
828938,2022-05-29,Betim/MG,0,1437,0,46656
834535,2022-05-30,Betim/MG,0,1437,49,46705
840132,2022-05-31,Betim/MG,0,1437,19,46724
845729,2022-06-01,Betim/MG,0,1437,31,46755
851326,2022-06-02,Betim/MG,0,1437,0,46755
856923,2022-06-03,Betim/MG,0,1437,215,46970
862520,2022-06-04,Betim/MG,0,1437,0,46970
868117,2022-06-05,Betim/MG,0,1437,0,46970
873714,2022-06-06,Betim/MG,0,1437,0,46970
879311,2022-06-07,Betim/MG,0,1437,0,46970
884908,2022-06-08,Betim/MG,0,1437,0,46970
890505,2022-06-09,Betim/MG,0,1437,0,46970
896102,2022-06-10,Betim/MG,0,1437,0,46970
901699,2022-06-11,Betim/MG,0,1437,0,46970
907296,2022-06-12,Betim/MG,0,1437,0,46970
912893,2022-06-13,Betim/MG,0,1437,0,46970
918490,2022-06-14,Betim/MG,0,1437,0,46970
924087,2022-06-15,Betim/MG,1,1438,400,47370
929684,2022-06-16,Betim/MG,0,1438,0,47370
935281,2022-06-17,Betim/MG,0,1438,0,47370
940878,2022-06-18,Betim/MG,0,1438,0,47370
946475,2022-06-19,Betim/MG,0,1438,0,47370
952072,2022-06-20,Betim/MG,0,1438,865,48235
957669,2022-06-21,Betim/MG,1,1439,355,48590
963266,2022-06-22,Betim/MG,0,1439,170,48760
968863,2022-06-23,Betim/MG,0,1439,0,48760
974460,2022-06-24,Betim/MG,3,1442,151,48911
980057,2022-06-25,Betim/MG,0,1442,0,48911
985654,2022-06-26,Betim/MG,0,1442,0,48911
991251,2022-06-27,Betim/MG,-1,1441,63,48974
996848,2022-06-28,Betim/MG,0,1441,166,49140
1002445,2022-06-29,Betim/MG,0,1441,188,49328
1008042,2022-06-30,Betim/MG,0,1441,294,49622
1013639,2022-07-01,Betim/MG,1,1442,56,49678
1019236,2022-07-02,Betim/MG,0,1442,0,49678
1024833,2022-07-03,Betim/MG,0,1442,0,49678
1030430,2022-07-04,Betim/MG,1,1443,137,49815
1036027,2022-07-05,Betim/MG,1,1444,220,50035
1041624,2022-07-06,Betim/MG,2,1446,127,50162
1047221,2022-07-07,Betim/MG,1,1447,4,50166
1052818,2022-07-08,Betim/MG,0,1447,23,50189
1058415,2022-07-09,Betim/MG,0,1447,0,50189
1064012,2022-07-10,Betim/MG,0,1447,0,50189
1069609,2022-07-11,Betim/MG,0,1447,341,50530
1075206,2022-07-12,Betim/MG,-1,1446,148,50678
1080803,2022-07-13,Betim/MG,1,1447,0,50678
1086400,2022-07-14,Betim/MG,0,1447,0,50678
1091997,2022-07-15,Betim/MG,1,1448,0,50678
1097594,2022-07-16,Betim/MG,0,1448,0,50678
1103191,2022-07-17,Betim/MG,0,1448,0,50678
1108788,2022-07-18,Betim/MG,0,1448,156,50834
1114385,2022-07-19,Betim/MG,0,1448,0,50834
1119982,2022-07-20,Betim/MG,1,1449,-187,50647
1125579,2022-07-21,Betim/MG,0,1449,451,51098
1131176,2022-07-22,Betim/MG,0,1449,17,51115
1136773,2022-07-23,Betim/MG,0,1449,0,51115
1142370,2022-07-24,Betim/MG,0,1449,0,51115
1147967,2022-07-25,Betim/MG,0,1449,0,51115
1153564,2022-07-26,Betim/MG,1,1450,15,51130
1159161,2022-07-27,Betim/MG,1,1451,22,51152
1164758,2022-07-28,Betim/MG,1,1452,44,51196
1170355,2022-07-29,Betim/MG,0,1452,4,51200
1175952,2022-07-30,Betim/MG,0,1452,0,51200
1181549,2022-07-31,Betim/MG,0,1452,0,51200
1187146,2022-08-01,Betim/MG,1,1453,2,51202
1192743,2022-08-02,Betim/MG,0,1453,2,51204
1198340,2022-08-03,Betim/MG,0,1453,68,51272
1203937,2022-08-04,Betim/MG,1,1454,741,52013
1209534,2022-08-05,Betim/MG,0,1454,12,52025
1215131,2022-08-06,Betim/MG,0,1454,0,52025
1220728,2022-08-07,Betim/MG,0,1454,0,52025
1226325,2022-08-08,Betim/MG,2,1456,7,52032
1231922,2022-08-09,Betim/MG,0,1456,0,52032
1237519,2022-08-10,Betim/MG,1,1457,18,52050
1243116,2022-08-11,Betim/MG,0,1457,0,52050
1248713,2022-08-12,Betim/MG,0,1457,11,52061
1254310,2022-08-13,Betim/MG,0,1457,0,52061
1259907,2022-08-14,Betim/MG,0,1457,0,52061
1265504,2022-08-15,Betim/MG,0,1457,0,52061
1271101,2022-08-16,Betim/MG,1,1458,3,52064
1276698,2022-08-17,Betim/MG,1,1459,0,52064
1282295,2022-08-18,Betim/MG,1,1460,164,52228
1287892,2022-08-19,Betim/MG,1,1461,2,52230
1293489,2022-08-20,Betim/MG,0,1461,0,52230
1299086,2022-08-21,Betim/MG,0,1461,0,52230
1304683,2022-08-22,Betim/MG,0,1461,2,52232
1310280,2022-08-23,Betim/MG,0,1461,0,52232
1315877,2022-08-24,Betim/MG,0,1461,13,52245
1321474,2022-08-25,Betim/MG,0,1461,39,52284
1350,2022-01-01,Contagem/MG,0,1940,19,49414
6947,2022-01-02,Contagem/MG,0,1940,0,49414
12544,2022-01-03,Contagem/MG,0,1940,37,49451
18141,2022-01-04,Contagem/MG,0,1940,0,49451
23738,2022-01-05,Contagem/MG,0,1940,5,49456
29335,2022-01-06,Contagem/MG,0,1940,0,49456
34932,2022-01-07,Contagem/MG,0,1940,68,49524
40529,2022-01-08,Contagem/MG,3,1943,122,49646
46126,2022-01-09,Contagem/MG,0,1943,0,49646
51723,2022-01-10,Contagem/MG,0,1943,81,49727
57320,2022-01-11,Contagem/MG,0,1943,111,49838
62917,2022-01-12,Contagem/MG,1,1944,0,49838
68514,2022-01-13,Contagem/MG,3,1947,201,50039
74111,2022-01-14,Contagem/MG,6,1953,243,50282
79708,2022-01-15,Contagem/MG,0,1953,259,50541
85305,2022-01-16,Contagem/MG,0,1953,0,50541
90902,2022-01-17,Contagem/MG,0,1953,0,50541
96499,2022-01-18,Contagem/MG,0,1953,1129,51670
102096,2022-01-19,Contagem/MG,6,1959,0,51670
107693,2022-01-20,Contagem/MG,1,1960,0,51670
113290,2022-01-21,Contagem/MG,2,1962,0,51670
118887,2022-01-22,Contagem/MG,1,1963,0,51670
124484,2022-01-23,Contagem/MG,2,1965,1613,53283
130081,2022-01-24,Contagem/MG,0,1965,0,53283
135678,2022-01-25,Contagem/MG,0,1965,0,53283
141275,2022-01-26,Contagem/MG,0,1965,0,53283
146872,2022-01-27,Contagem/MG,2,1967,518,53801
152469,2022-01-28,Contagem/MG,0,1967,515,54316
158066,2022-01-29,Contagem/MG,2,1969,0,54316
163663,2022-01-30,Contagem/MG,5,1974,605,54921
169260,2022-01-31,Contagem/MG,0,1974,0,54921
174857,2022-02-01,Contagem/MG,0,1974,914,55835
180454,2022-02-02,Contagem/MG,3,1977,96,55931
186051,2022-02-03,Contagem/MG,3,1980,0,55931
191648,2022-02-04,Contagem/MG,3,1983,0,55931
197245,2022-02-05,Contagem/MG,0,1983,976,56907
202842,2022-02-06,Contagem/MG,4,1987,2276,59183
208439,2022-02-07,Contagem/MG,0,1987,1000,60183
214036,2022-02-08,Contagem/MG,4,1991,1000,61183
219633,2022-02-09,Contagem/MG,2,1993,1000,62183
225230,2022-02-10,Contagem/MG,4,1997,2039,64222
230827,2022-02-11,Contagem/MG,7,2004,284,64506
236424,2022-02-12,Contagem/MG,1,2005,294,64800
242021,2022-02-13,Contagem/MG,-6,1999,161,64961
247618,2022-02-14,Contagem/MG,8,2007,0,64961
253215,2022-02-15,Contagem/MG,0,2007,297,65258
258812,2022-02-16,Contagem/MG,4,2011,94,65352
264409,2022-02-17,Contagem/MG,8,2019,202,65554
270006,2022-02-18,Contagem/MG,7,2026,187,65741
275603,2022-02-19,Contagem/MG,3,2029,175,65916
281200,2022-02-20,Contagem/MG,5,2034,0,65916
286797,2022-02-21,Contagem/MG,0,2034,332,66248
292394,2022-02-22,Contagem/MG,0,2034,28,66276
297991,2022-02-23,Contagem/MG,4,2038,16,66292
303588,2022-02-24,Contagem/MG,1,2039,0,66292
309185,2022-02-25,Contagem/MG,2,2041,267,66559
314782,2022-02-26,Contagem/MG,2,2043,148,66707
320379,2022-02-27,Contagem/MG,2,2045,91,66798
325976,2022-02-28,Contagem/MG,0,2045,132,66930
331573,2022-03-01,Contagem/MG,0,2045,17,66947
337170,2022-03-02,Contagem/MG,3,2048,0,66947
342767,2022-03-03,Contagem/MG,6,2054,0,66947
348364,2022-03-04,Contagem/MG,0,2054,0,66947
353961,2022-03-05,Contagem/MG,1,2055,850,67797
359558,2022-03-06,Contagem/MG,5,2060,298,68095
365155,2022-03-07,Contagem/MG,1,2061,266,68361
370752,2022-03-08,Contagem/MG,0,2061,1564,69925
376349,2022-03-09,Contagem/MG,3,2064,61,69986
381946,2022-03-10,Contagem/MG,5,2069,0,69986
387543,2022-03-11,Contagem/MG,3,2072,182,70168
393140,2022-03-12,Contagem/MG,2,2074,46,70214
398737,2022-03-13,Contagem/MG,2,2076,50,70264
404334,2022-03-14,Contagem/MG,0,2076,0,70264
409931,2022-03-15,Contagem/MG,0,2076,0,70264
415528,2022-03-16,Contagem/MG,0,2076,75,70339
421125,2022-03-17,Contagem/MG,-1,2075,59,70398
426722,2022-03-18,Contagem/MG,1,2076,27,70425
432319,2022-03-19,Contagem/MG,1,2077,22,70447
437916,2022-03-20,Contagem/MG,3,2080,16,70463
443513,2022-03-21,Contagem/MG,0,2080,0,70463
449110,2022-03-22,Contagem/MG,0,2080,0,70463
454707,2022-03-23,Contagem/MG,0,2080,3,70466
460304,2022-03-24,Contagem/MG,2,2082,59,70525
465901,2022-03-25,Contagem/MG,2,2084,13,70538
471498,2022-03-26,Contagem/MG,2,2086,13,70551
477095,2022-03-27,Contagem/MG,1,2087,15,70566
482692,2022-03-28,Contagem/MG,0,2087,0,70566
488289,2022-03-29,Contagem/MG,0,2087,0,70566
493886,2022-03-30,Contagem/MG,3,2090,20,70586
499483,2022-03-31,Contagem/MG,1,2091,123,70709
505080,2022-04-01,Contagem/MG,1,2092,31,70740
510677,2022-04-02,Contagem/MG,0,2092,0,70740
516274,2022-04-03,Contagem/MG,0,2092,0,70740
521871,2022-04-04,Contagem/MG,2,2094,16,70756
527468,2022-04-05,Contagem/MG,1,2095,8,70764
533065,2022-04-06,Contagem/MG,2,2097,1,70765
538662,2022-04-07,Contagem/MG,1,2098,23,70788
544259,2022-04-08,Contagem/MG,2,2100,22,70810
549856,2022-04-09,Contagem/MG,2,2102,17,70827
555453,2022-04-10,Contagem/MG,0,2102,0,70827
561050,2022-04-11,Contagem/MG,0,2102,0,70827
566647,2022-04-12,Contagem/MG,0,2102,82,70909
572244,2022-04-13,Contagem/MG,2,2104,0,70909
577841,2022-04-14,Contagem/MG,1,2105,8,70917
583438,2022-04-15,Contagem/MG,1,2106,8,70925
589035,2022-04-16,Contagem/MG,1,2107,0,70925
594632,2022-04-17,Contagem/MG,0,2107,0,70925
600229,2022-04-18,Contagem/MG,0,2107,0,70925
605826,2022-04-19,Contagem/MG,0,2107,13,70938
611423,2022-04-20,Contagem/MG,9,2116,0,70938
617020,2022-04-21,Contagem/MG,0,2116,6,70944
622617,2022-04-22,Contagem/MG,0,2116,9,70953
628214,2022-04-23,Contagem/MG,0,2116,0,70953
633811,2022-04-24,Contagem/MG,0,2116,0,70953
639408,2022-04-25,Contagem/MG,0,2116,0,70953
645005,2022-04-26,Contagem/MG,1,2117,27,70980
650602,2022-04-27,Contagem/MG,-1,2116,0,70980
656199,2022-04-28,Contagem/MG,3,2119,0,70980
661796,2022-04-29,Contagem/MG,2,2121,0,70980
667393,2022-04-30,Contagem/MG,1,2122,0,70980
672990,2022-05-01,Contagem/MG,0,2122,0,70980
678587,2022-05-02,Contagem/MG,0,2122,0,70980
684184,2022-05-03,Contagem/MG,0,2122,163,71143
689781,2022-05-04,Contagem/MG,0,2122,22,71165
695378,2022-05-05,Contagem/MG,0,2122,15,71180
700975,2022-05-06,Contagem/MG,3,2125,14,71194
706572,2022-05-07,Contagem/MG,0,2125,0,71194
712169,2022-05-08,Contagem/MG,0,2125,0,71194
717766,2022-05-09,Contagem/MG,1,2126,6,71200
723363,2022-05-10,Contagem/MG,0,2126,0,71200
728960,2022-05-11,Contagem/MG,0,2126,24,71224
734557,2022-05-12,Contagem/MG,0,2126,53,71277
740154,2022-05-13,Contagem/MG,0,2126,41,71318
745751,2022-05-14,Contagem/MG,0,2126,0,71318
751348,2022-05-15,Contagem/MG,0,2126,0,71318
756945,2022-05-16,Contagem/MG,0,2126,36,71354
762542,2022-05-17,Contagem/MG,0,2126,0,71354
768139,2022-05-18,Contagem/MG,0,2126,19,71373
773736,2022-05-19,Contagem/MG,0,2126,0,71373
779333,2022-05-20,Contagem/MG,0,2126,0,71373
784930,2022-05-21,Contagem/MG,0,2126,0,71373
790527,2022-05-22,Contagem/MG,0,2126,0,71373
796124,2022-05-23,Contagem/MG,0,2126,0,71373
801721,2022-05-24,Contagem/MG,0,2126,0,71373
807318,2022-05-25,Contagem/MG,1,2127,0,71373
812915,2022-05-26,Contagem/MG,0,2127,140,71513
818512,2022-05-27,Contagem/MG,0,2127,47,71560
824109,2022-05-28,Contagem/MG,0,2127,0,71560
829706,2022-05-29,Contagem/MG,0,2127,0,71560
835303,2022-05-30,Contagem/MG,0,2127,40,71600
840900,2022-05-31,Contagem/MG,0,2127,0,71600
846497,2022-06-01,Contagem/MG,0,2127,96,71696
852094,2022-06-02,Contagem/MG,0,2127,24,71720
857691,2022-06-03,Contagem/MG,0,2127,123,71843
863288,2022-06-04,Contagem/MG,0,2127,0,71843
868885,2022-06-05,Contagem/MG,0,2127,0,71843
874482,2022-06-06,Contagem/MG,0,2127,86,71929
880079,2022-06-07,Contagem/MG,0,2127,0,71929
885676,2022-06-08,Contagem/MG,5,2132,220,72149
891273,2022-06-09,Contagem/MG,0,2132,268,72417
896870,2022-06-10,Contagem/MG,0,2132,0,72417
902467,2022-06-11,Contagem/MG,0,2132,0,72417
908064,2022-06-12,Contagem/MG,0,2132,0,72417
913661,2022-06-13,Contagem/MG,0,2132,376,72793
919258,2022-06-14,Contagem/MG,1,2133,0,72793
924855,2022-06-15,Contagem/MG,3,2136,344,73137
930452,2022-06-16,Contagem/MG,0,2136,0,73137
936049,2022-06-17,Contagem/MG,0,2136,0,73137
941646,2022-06-18,Contagem/MG,0,2136,0,73137
947243,2022-06-19,Contagem/MG,0,2136,0,73137
952840,2022-06-20,Contagem/MG,2,2138,368,73505
958437,2022-06-21,Contagem/MG,6,2144,0,73505
964034,2022-06-22,Contagem/MG,0,2144,0,73505
969631,2022-06-23,Contagem/MG,0,2144,565,74070
975228,2022-06-24,Contagem/MG,3,2147,230,74300
980825,2022-06-25,Contagem/MG,0,2147,0,74300
986422,2022-06-26,Contagem/MG,0,2147,0,74300
992019,2022-06-27,Contagem/MG,2,2149,177,74477
997616,2022-06-28,Contagem/MG,0,2149,0,74477
1003213,2022-06-29,Contagem/MG,1,2150,460,74937
1008810,2022-06-30,Contagem/MG,2,2152,0,74937
1014407,2022-07-01,Contagem/MG,2,2154,335,75272
1020004,2022-07-02,Contagem/MG,0,2154,0,75272
1025601,2022-07-03,Contagem/MG,0,2154,0,75272
1031198,2022-07-04,Contagem/MG,0,2154,165,75437
1036795,2022-07-05,Contagem/MG,2,2156,0,75437
1042392,2022-07-06,Contagem/MG,3,2159,496,75933
1047989,2022-07-07,Contagem/MG,1,2160,249,76182
1053586,2022-07-08,Contagem/MG,1,2161,183,76365
1059183,2022-07-09,Contagem/MG,0,2161,0,76365
1064780,2022-07-10,Contagem/MG,0,2161,0,76365
1070377,2022-07-11,Contagem/MG,0,2161,206,76571
1075974,2022-07-12,Contagem/MG,0,2161,0,76571
1081571,2022-07-13,Contagem/MG,3,2164,340,76911
1087168,2022-07-14,Contagem/MG,4,2168,142,77053
1092765,2022-07-15,Contagem/MG,1,2169,184,77237
1098362,2022-07-16,Contagem/MG,0,2169,0,77237
1103959,2022-07-17,Contagem/MG,0,2169,0,77237
1109556,2022-07-18,Contagem/MG,0,2169,172,77409
1115153,2022-07-19,Contagem/MG,0,2169,0,77409
1120750,2022-07-20,Contagem/MG,2,2171,0,77409
1126347,2022-07-21,Contagem/MG,2,2173,561,77970
1131944,2022-07-22,Contagem/MG,0,2173,95,78065
1137541,2022-07-23,Contagem/MG,0,2173,0,78065
1143138,2022-07-24,Contagem/MG,0,2173,0,78065
1148735,2022-07-25,Contagem/MG,4,2177,98,78163
1154332,2022-07-26,Contagem/MG,0,2177,73,78236
1159929,2022-07-27,Contagem/MG,1,2178,99,78335
1165526,2022-07-28,Contagem/MG,0,2178,0,78335
1171123,2022-07-29,Contagem/MG,1,2179,150,78485
1176720,2022-07-30,Contagem/MG,0,2179,0,78485
1182317,2022-07-31,Contagem/MG,0,2179,0,78485
1187914,2022-08-01,Contagem/MG,1,2180,0,78485
1193511,2022-08-02,Contagem/MG,1,2181,59,78544
1199108,2022-08-03,Contagem/MG,1,2182,0,78544
1204705,2022-08-04,Contagem/MG,2,2184,67,78611
1210302,2022-08-05,Contagem/MG,2,2186,23,78634
1215899,2022-08-06,Contagem/MG,0,2186,0,78634
1221496,2022-08-07,Contagem/MG,0,2186,0,78634
1227093,2022-08-08,Contagem/MG,1,2187,32,78666
1232690,2022-08-09,Contagem/MG,1,2188,24,78690
1238287,2022-08-10,Contagem/MG,1,2189,0,78690
1243884,2022-08-11,Contagem/MG,2,2191,0,78690
1249481,2022-08-12,Contagem/MG,0,2191,0,78690
1255078,2022-08-13,Contagem/MG,0,2191,0,78690
1260675,2022-08-14,Contagem/MG,0,2191,0,78690
1266272,2022-08-15,Contagem/MG,0,2191,0,78690
1271869,2022-08-16,Contagem/MG,2,2193,0,78690
1277466,2022-08-17,Contagem/MG,1,2194,0,78690
1283063,2022-08-18,Contagem/MG,3,2197,0,78690
1288660,2022-08-19,Contagem/MG,0,2197,0,78690
1294257,2022-08-20,Contagem/MG,0,2197,0,78690
1299854,2022-08-21,Contagem/MG,0,2197,0,78690
1305451,2022-08-22,Contagem/MG,0,2197,0,78690
1311048,2022-08-23,Contagem/MG,2,2199,0,78690
1316645,2022-08-24,Contagem/MG,0,2199,0,78690
1322242,2022-08-25,Contagem/MG,1,2200,0,78690
2602,2022-01-01,João Monlevade/MG,0,253,0,10837
8199,2022-01-02,João Monlevade/MG,0,253,0,10837
13796,2022-01-03,João Monlevade/MG,0,253,0,10837
19393,2022-01-04,João Monlevade/MG,0,253,0,10837
24990,2022-01-05,João Monlevade/MG,0,253,5,10842
30587,2022-01-06,João Monlevade/MG,0,253,22,10864
36184,2022-01-07,João Monlevade/MG,0,253,44,10908
41781,2022-01-08,João Monlevade/MG,0,253,35,10943
47378,2022-01-09,João Monlevade/MG,0,253,22,10965
52975,2022-01-10,João Monlevade/MG,0,253,0,10965
58572,2022-01-11,João Monlevade/MG,0,253,0,10965
64169,2022-01-12,João Monlevade/MG,0,253,60,11025
69766,2022-01-13,João Monlevade/MG,0,253,50,11075
75363,2022-01-14,João Monlevade/MG,0,253,94,11169
80960,2022-01-15,João Monlevade/MG,0,253,89,11258
86557,2022-01-16,João Monlevade/MG,0,253,0,11258
92154,2022-01-17,João Monlevade/MG,0,253,92,11350
97751,2022-01-18,João Monlevade/MG,0,253,0,11350
103348,2022-01-19,João Monlevade/MG,0,253,0,11350
108945,2022-01-20,João Monlevade/MG,0,253,162,11512
114542,2022-01-21,João Monlevade/MG,1,254,62,11574
120139,2022-01-22,João Monlevade/MG,0,254,105,11679
125736,2022-01-23,João Monlevade/MG,0,254,100,11779
131333,2022-01-24,João Monlevade/MG,0,254,34,11813
136930,2022-01-25,João Monlevade/MG,0,254,2,11815
142527,2022-01-26,João Monlevade/MG,0,254,101,11916
148124,2022-01-27,João Monlevade/MG,3,257,116,12032
153721,2022-01-28,João Monlevade/MG,0,257,128,12160
159318,2022-01-29,João Monlevade/MG,0,257,161,12321
164915,2022-01-30,João Monlevade/MG,0,257,149,12470
170512,2022-01-31,João Monlevade/MG,0,257,121,12591
176109,2022-02-01,João Monlevade/MG,0,257,41,12632
181706,2022-02-02,João Monlevade/MG,1,258,118,12750
187303,2022-02-03,João Monlevade/MG,0,258,122,12872
192900,2022-02-04,João Monlevade/MG,1,259,118,12990
198497,2022-02-05,João Monlevade/MG,0,259,86,13076
204094,2022-02-06,João Monlevade/MG,0,259,93,13169
209691,2022-02-07,João Monlevade/MG,0,259,0,13169
215288,2022-02-08,João Monlevade/MG,1,260,56,13225
220885,2022-02-09,João Monlevade/MG,1,261,45,13270
226482,2022-02-10,João Monlevade/MG,0,261,72,13342
232079,2022-02-11,João Monlevade/MG,0,261,65,13407
237676,2022-02-12,João Monlevade/MG,0,261,48,13455
243273,2022-02-13,João Monlevade/MG,0,261,49,13504
248870,2022-02-14,João Monlevade/MG,0,261,35,13539
254467,2022-02-15,João Monlevade/MG,0,261,49,13588
260064,2022-02-16,João Monlevade/MG,0,261,27,13615
265661,2022-02-17,João Monlevade/MG,0,261,26,13641
271258,2022-02-18,João Monlevade/MG,0,261,98,13739
276855,2022-02-19,João Monlevade/MG,0,261,44,13783
282452,2022-02-20,João Monlevade/MG,1,262,46,13829
288049,2022-02-21,João Monlevade/MG,0,262,2,13831
293646,2022-02-22,João Monlevade/MG,1,263,24,13855
299243,2022-02-23,João Monlevade/MG,0,263,28,13883
304840,2022-02-24,João Monlevade/MG,0,263,18,13901
310437,2022-02-25,João Monlevade/MG,0,263,0,13901
316034,2022-02-26,João Monlevade/MG,0,263,24,13925
321631,2022-02-27,João Monlevade/MG,0,263,20,13945
327228,2022-02-28,João Monlevade/MG,0,263,0,13945
332825,2022-03-01,João Monlevade/MG,0,263,0,13945
338422,2022-03-02,João Monlevade/MG,0,263,9,13954
344019,2022-03-03,João Monlevade/MG,0,263,0,13954
349616,2022-03-04,João Monlevade/MG,0,263,9,13963
355213,2022-03-05,João Monlevade/MG,0,263,6,13969
360810,2022-03-06,João Monlevade/MG,0,263,1,13970
366407,2022-03-07,João Monlevade/MG,0,263,3,13973
372004,2022-03-08,João Monlevade/MG,0,263,0,13973
377601,2022-03-09,João Monlevade/MG,0,263,6,13979
383198,2022-03-10,João Monlevade/MG,0,263,0,13979
388795,2022-03-11,João Monlevade/MG,0,263,14,13993
394392,2022-03-12,João Monlevade/MG,0,263,7,14000
399989,2022-03-13,João Monlevade/MG,0,263,3,14003
405586,2022-03-14,João Monlevade/MG,0,263,0,14003
411183,2022-03-15,João Monlevade/MG,0,263,0,14003
416780,2022-03-16,João Monlevade/MG,0,263,5,14008
422377,2022-03-17,João Monlevade/MG,0,263,6,14014
427974,2022-03-18,João Monlevade/MG,0,263,3,14017
433571,2022-03-19,João Monlevade/MG,0,263,2,14019
439168,2022-03-20,João Monlevade/MG,0,263,2,14021
444765,2022-03-21,João Monlevade/MG,0,263,0,14021
450362,2022-03-22,João Monlevade/MG,0,263,0,14021
455959,2022-03-23,João Monlevade/MG,0,263,4,14025
461556,2022-03-24,João Monlevade/MG,0,263,3,14028
467153,2022-03-25,João Monlevade/MG,0,263,0,14028
472750,2022-03-26,João Monlevade/MG,0,263,4,14032
478347,2022-03-27,João Monlevade/MG,0,263,1,14033
483944,2022-03-28,João Monlevade/MG,0,263,0,14033
489541,2022-03-29,João Monlevade/MG,0,263,0,14033
495138,2022-03-30,João Monlevade/MG,0,263,3,14036
500735,2022-03-31,João Monlevade/MG,1,264,3,14039
506332,2022-04-01,João Monlevade/MG,0,264,0,14039
511929,2022-04-02,João Monlevade/MG,0,264,0,14039
517526,2022-04-03,João Monlevade/MG,0,264,0,14039
523123,2022-04-04,João Monlevade/MG,1,265,5,14044
528720,2022-04-05,João Monlevade/MG,0,265,0,14044
534317,2022-04-06,João Monlevade/MG,-1,264,0,14044
539914,2022-04-07,João Monlevade/MG,1,265,0,14044
545511,2022-04-08,João Monlevade/MG,0,265,0,14044
551108,2022-04-09,João Monlevade/MG,0,265,1,14045
556705,2022-04-10,João Monlevade/MG,0,265,0,14045
562302,2022-04-11,João Monlevade/MG,0,265,0,14045
567899,2022-04-12,João Monlevade/MG,0,265,0,14045
573496,2022-04-13,João Monlevade/MG,0,265,0,14045
579093,2022-04-14,João Monlevade/MG,0,265,0,14045
584690,2022-04-15,João Monlevade/MG,0,265,1,14046
590287,2022-04-16,João Monlevade/MG,0,265,0,14046
595884,2022-04-17,João Monlevade/MG,0,265,0,14046
601481,2022-04-18,João Monlevade/MG,0,265,0,14046
607078,2022-04-19,João Monlevade/MG,0,265,0,14046
612675,2022-04-20,João Monlevade/MG,0,265,0,14046
618272,2022-04-21,João Monlevade/MG,0,265,0,14046
623869,2022-04-22,João Monlevade/MG,0,265,0,14046
629466,2022-04-23,João Monlevade/MG,0,265,0,14046
635063,2022-04-24,João Monlevade/MG,0,265,0,14046
640660,2022-04-25,João Monlevade/MG,0,265,0,14046
646257,2022-04-26,João Monlevade/MG,0,265,0,14046
651854,2022-04-27,João Monlevade/MG,0,265,1,14047
657451,2022-04-28,João Monlevade/MG,0,265,1,14048
663048,2022-04-29,João Monlevade/MG,0,265,0,14048
668645,2022-04-30,João Monlevade/MG,0,265,0,14048
674242,2022-05-01,João Monlevade/MG,0,265,0,14048
679839,2022-05-02,João Monlevade/MG,0,265,0,14048
685436,2022-05-03,João Monlevade/MG,0,265,0,14048
691033,2022-05-04,João Monlevade/MG,0,265,1,14049
696630,2022-05-05,João Monlevade/MG,1,266,0,14049
702227,2022-05-06,João Monlevade/MG,1,267,3,14052
707824,2022-05-07,João Monlevade/MG,0,267,0,14052
713421,2022-05-08,João Monlevade/MG,0,267,0,14052
719018,2022-05-09,João Monlevade/MG,0,267,3,14055
724615,2022-05-10,João Monlevade/MG,0,267,0,14055
730212,2022-05-11,João Monlevade/MG,0,267,0,14055
735809,2022-05-12,João Monlevade/MG,1,268,7,14062
741406,2022-05-13,João Monlevade/MG,0,268,9,14071
747003,2022-05-14,João Monlevade/MG,0,268,0,14071
752600,2022-05-15,João Monlevade/MG,0,268,0,14071
758197,2022-05-16,João Monlevade/MG,0,268,9,14080
763794,2022-05-17,João Monlevade/MG,0,268,0,14080
769391,2022-05-18,João Monlevade/MG,0,268,4,14084
774988,2022-05-19,João Monlevade/MG,0,268,3,14087
780585,2022-05-20,João Monlevade/MG,0,268,0,14087
786182,2022-05-21,João Monlevade/MG,0,268,0,14087
791779,2022-05-22,João Monlevade/MG,0,268,0,14087
797376,2022-05-23,João Monlevade/MG,0,268,2,14089
802973,2022-05-24,João Monlevade/MG,0,268,7,14096
808570,2022-05-25,João Monlevade/MG,0,268,12,14108
814167,2022-05-26,João Monlevade/MG,0,268,3,14111
819764,2022-05-27,João Monlevade/MG,0,268,4,14115
825361,2022-05-28,João Monlevade/MG,0,268,0,14115
830958,2022-05-29,João Monlevade/MG,0,268,0,14115
836555,2022-05-30,João Monlevade/MG,0,268,20,14135
842152,2022-05-31,João Monlevade/MG,0,268,0,14135
847749,2022-06-01,João Monlevade/MG,0,268,14,14149
853346,2022-06-02,João Monlevade/MG,0,268,21,14170
858943,2022-06-03,João Monlevade/MG,0,268,28,14198
864540,2022-06-04,João Monlevade/MG,0,268,0,14198
870137,2022-06-05,João Monlevade/MG,0,268,0,14198
875734,2022-06-06,João Monlevade/MG,0,268,28,14226
881331,2022-06-07,João Monlevade/MG,0,268,0,14226
886928,2022-06-08,João Monlevade/MG,1,269,28,14254
892525,2022-06-09,João Monlevade/MG,0,269,28,14282
898122,2022-06-10,João Monlevade/MG,0,269,4,14286
903719,2022-06-11,João Monlevade/MG,0,269,0,14286
909316,2022-06-12,João Monlevade/MG,0,269,0,14286
914913,2022-06-13,João Monlevade/MG,0,269,43,14329
920510,2022-06-14,João Monlevade/MG,0,269,0,14329
926107,2022-06-15,João Monlevade/MG,0,269,32,14361
931704,2022-06-16,João Monlevade/MG,0,269,0,14361
937301,2022-06-17,João Monlevade/MG,0,269,0,14361
942898,2022-06-18,João Monlevade/MG,0,269,0,14361
948495,2022-06-19,João Monlevade/MG,0,269,0,14361
954092,2022-06-20,João Monlevade/MG,0,269,38,14399
959689,2022-06-21,João Monlevade/MG,0,269,0,14399
965286,2022-06-22,João Monlevade/MG,0,269,103,14502
970883,2022-06-23,João Monlevade/MG,0,269,35,14537
976480,2022-06-24,João Monlevade/MG,1,270,28,14565
982077,2022-06-25,João Monlevade/MG,0,270,0,14565
987674,2022-06-26,João Monlevade/MG,0,270,0,14565
993271,2022-06-27,João Monlevade/MG,0,270,39,14604
998868,2022-06-28,João Monlevade/MG,0,270,0,14604
1004465,2022-06-29,João Monlevade/MG,1,271,47,14651
1010062,2022-06-30,João Monlevade/MG,0,271,38,14689
1015659,2022-07-01,João Monlevade/MG,0,271,0,14689
1021256,2022-07-02,João Monlevade/MG,0,271,0,14689
1026853,2022-07-03,João Monlevade/MG,0,271,0,14689
1032450,2022-07-04,João Monlevade/MG,0,271,91,14780
1038047,2022-07-05,João Monlevade/MG,0,271,0,14780
1043644,2022-07-06,João Monlevade/MG,0,271,59,14839
1049241,2022-07-07,João Monlevade/MG,0,271,15,14854
1054838,2022-07-08,João Monlevade/MG,0,271,30,14884
1060435,2022-07-09,João Monlevade/MG,0,271,0,14884
1066032,2022-07-10,João Monlevade/MG,0,271,0,14884
1071629,2022-07-11,João Monlevade/MG,0,271,53,14937
1077226,2022-07-12,João Monlevade/MG,0,271,0,14937
1082823,2022-07-13,João Monlevade/MG,0,271,49,14986
1088420,2022-07-14,João Monlevade/MG,0,271,42,15028
1094017,2022-07-15,João Monlevade/MG,0,271,42,15070
1099614,2022-07-16,João Monlevade/MG,0,271,0,15070
1105211,2022-07-17,João Monlevade/MG,0,271,0,15070
1110808,2022-07-18,João Monlevade/MG,0,271,80,15150
1116405,2022-07-19,João Monlevade/MG,0,271,0,15150
1122002,2022-07-20,João Monlevade/MG,0,271,33,15183
1127599,2022-07-21,João Monlevade/MG,0,271,0,15183
1133196,2022-07-22,João Monlevade/MG,0,271,103,15286
1138793,2022-07-23,João Monlevade/MG,0,271,0,15286
1144390,2022-07-24,João Monlevade/MG,0,271,0,15286
1149987,2022-07-25,João Monlevade/MG,0,271,31,15317
1155584,2022-07-26,João Monlevade/MG,0,271,0,15317
1161181,2022-07-27,João Monlevade/MG,0,271,0,15317
1166778,2022-07-28,João Monlevade/MG,0,271,0,15317
1172375,2022-07-29,João Monlevade/MG,0,271,58,15375
1177972,2022-07-30,João Monlevade/MG,0,271,0,15375
1183569,2022-07-31,João Monlevade/MG,0,271,0,15375
1189166,2022-08-01,João Monlevade/MG,2,273,39,15414
1194763,2022-08-02,João Monlevade/MG,0,273,0,15414
1200360,2022-08-03,João Monlevade/MG,1,274,0,15414
1205957,2022-08-04,João Monlevade/MG,0,274,67,15481
1211554,2022-08-05,João Monlevade/MG,0,274,34,15515
1217151,2022-08-06,João Monlevade/MG,0,274,0,15515
1222748,2022-08-07,João Monlevade/MG,0,274,0,15515
1228345,2022-08-08,João Monlevade/MG,0,274,59,15574
1233942,2022-08-09,João Monlevade/MG,0,274,0,15574
1239539,2022-08-10,João Monlevade/MG,1,275,0,15574
1245136,2022-08-11,João Monlevade/MG,0,275,55,15629
1250733,2022-08-12,João Monlevade/MG,0,275,0,15629
1256330,2022-08-13,João Monlevade/MG,0,275,0,15629
1261927,2022-08-14,João Monlevade/MG,0,275,0,15629
1267524,2022-08-15,João Monlevade/MG,0,275,0,15629
1273121,2022-08-16,João Monlevade/MG,1,276,38,15667
1278718,2022-08-17,João Monlevade/MG,1,277,0,15667
1284315,2022-08-18,João Monlevade/MG,1,278,11,15678
1289912,2022-08-19,João Monlevade/MG,0,278,8,15686
1295509,2022-08-20,João Monlevade/MG,0,278,0,15686
1301106,2022-08-21,João Monlevade/MG,0,278,0,15686
1306703,2022-08-22,João Monlevade/MG,0,278,2,15688
1312300,2022-08-23,João Monlevade/MG,0,278,1,15689
1317897,2022-08-24,João Monlevade/MG,0,278,3,15692
1323494,2022-08-25,João Monlevade/MG,0,278,0,15692
3471,2022-01-01,Ouro Preto/MG,0,131,0,6633
9068,2022-01-02,Ouro Preto/MG,0,131,0,6633
14665,2022-01-03,Ouro Preto/MG,0,131,0,6633
20262,2022-01-04,Ouro Preto/MG,1,132,0,6633
25859,2022-01-05,Ouro Preto/MG,0,132,64,6697
31456,2022-01-06,Ouro Preto/MG,0,132,33,6730
37053,2022-01-07,Ouro Preto/MG,0,132,42,6772
42650,2022-01-08,Ouro Preto/MG,0,132,0,6772
48247,2022-01-09,Ouro Preto/MG,0,132,202,6974
53844,2022-01-10,Ouro Preto/MG,0,132,-202,6772
59441,2022-01-11,Ouro Preto/MG,0,132,0,6772
65038,2022-01-12,Ouro Preto/MG,0,132,0,6772
70635,2022-01-13,Ouro Preto/MG,0,132,0,6772
76232,2022-01-14,Ouro Preto/MG,0,132,579,7351
81829,2022-01-15,Ouro Preto/MG,0,132,76,7427
87426,2022-01-16,Ouro Preto/MG,0,132,0,7427
93023,2022-01-17,Ouro Preto/MG,0,132,30,7457
98620,2022-01-18,Ouro Preto/MG,0,132,0,7457
104217,2022-01-19,Ouro Preto/MG,0,132,0,7457
109814,2022-01-20,Ouro Preto/MG,0,132,247,7704
115411,2022-01-21,Ouro Preto/MG,0,132,0,7704
121008,2022-01-22,Ouro Preto/MG,0,132,0,7704
126605,2022-01-23,Ouro Preto/MG,1,133,0,7704
132202,2022-01-24,Ouro Preto/MG,0,133,0,7704
137799,2022-01-25,Ouro Preto/MG,0,133,0,7704
143396,2022-01-26,Ouro Preto/MG,0,133,0,7704
148993,2022-01-27,Ouro Preto/MG,0,133,0,7704
154590,2022-01-28,Ouro Preto/MG,0,133,1766,9470
160187,2022-01-29,Ouro Preto/MG,1,134,512,9982
165784,2022-01-30,Ouro Preto/MG,0,134,256,10238
171381,2022-01-31,Ouro Preto/MG,0,134,0,10238
176978,2022-02-01,Ouro Preto/MG,0,134,0,10238
182575,2022-02-02,Ouro Preto/MG,1,135,0,10238
188172,2022-02-03,Ouro Preto/MG,0,135,679,10917
193769,2022-02-04,Ouro Preto/MG,0,135,178,11095
199366,2022-02-05,Ouro Preto/MG,1,136,0,11095
204963,2022-02-06,Ouro Preto/MG,0,136,0,11095
210560,2022-02-07,Ouro Preto/MG,0,136,0,11095
216157,2022-02-08,Ouro Preto/MG,0,136,0,11095
221754,2022-02-09,Ouro Preto/MG,1,137,0,11095
227351,2022-02-10,Ouro Preto/MG,0,137,448,11543
232948,2022-02-11,Ouro Preto/MG,0,137,0,11543
238545,2022-02-12,Ouro Preto/MG,0,137,0,11543
244142,2022-02-13,Ouro Preto/MG,0,137,0,11543
249739,2022-02-14,Ouro Preto/MG,0,137,0,11543
255336,2022-02-15,Ouro Preto/MG,0,137,0,11543
260933,2022-02-16,Ouro Preto/MG,0,137,0,11543
266530,2022-02-17,Ouro Preto/MG,0,137,0,11543
272127,2022-02-18,Ouro Preto/MG,0,137,0,11543
277724,2022-02-19,Ouro Preto/MG,1,138,853,12396
283321,2022-02-20,Ouro Preto/MG,0,138,97,12493
288918,2022-02-21,Ouro Preto/MG,0,138,0,12493
294515,2022-02-22,Ouro Preto/MG,0,138,0,12493
300112,2022-02-23,Ouro Preto/MG,0,138,0,12493
305709,2022-02-24,Ouro Preto/MG,0,138,0,12493
311306,2022-02-25,Ouro Preto/MG,0,138,0,12493
316903,2022-02-26,Ouro Preto/MG,0,138,0,12493
322500,2022-02-27,Ouro Preto/MG,1,139,189,12682
328097,2022-02-28,Ouro Preto/MG,0,139,0,12682
333694,2022-03-01,Ouro Preto/MG,0,139,0,12682
339291,2022-03-02,Ouro Preto/MG,0,139,0,12682
344888,2022-03-03,Ouro Preto/MG,0,139,0,12682
350485,2022-03-04,Ouro Preto/MG,0,139,75,12757
356082,2022-03-05,Ouro Preto/MG,0,139,0,12757
361679,2022-03-06,Ouro Preto/MG,1,140,0,12757
367276,2022-03-07,Ouro Preto/MG,0,140,0,12757
372873,2022-03-08,Ouro Preto/MG,0,140,0,12757
378470,2022-03-09,Ouro Preto/MG,0,140,0,12757
384067,2022-03-10,Ouro Preto/MG,0,140,0,12757
389664,2022-03-11,Ouro Preto/MG,0,140,0,12757
395261,2022-03-12,Ouro Preto/MG,0,140,0,12757
400858,2022-03-13,Ouro Preto/MG,0,140,0,12757
406455,2022-03-14,Ouro Preto/MG,0,140,0,12757
412052,2022-03-15,Ouro Preto/MG,0,140,0,12757
417649,2022-03-16,Ouro Preto/MG,1,141,0,12757
423246,2022-03-17,Ouro Preto/MG,0,141,0,12757
428843,2022-03-18,Ouro Preto/MG,0,141,0,12757
434440,2022-03-19,Ouro Preto/MG,0,141,0,12757
440037,2022-03-20,Ouro Preto/MG,0,141,0,12757
445634,2022-03-21,Ouro Preto/MG,0,141,0,12757
451231,2022-03-22,Ouro Preto/MG,0,141,0,12757
456828,2022-03-23,Ouro Preto/MG,0,141,0,12757
462425,2022-03-24,Ouro Preto/MG,0,141,0,12757
468022,2022-03-25,Ouro Preto/MG,0,141,0,12757
473619,2022-03-26,Ouro Preto/MG,0,141,0,12757
479216,2022-03-27,Ouro Preto/MG,0,141,0,12757
484813,2022-03-28,Ouro Preto/MG,0,141,0,12757
490410,2022-03-29,Ouro Preto/MG,0,141,0,12757
496007,2022-03-30,Ouro Preto/MG,0,141,0,12757
501604,2022-03-31,Ouro Preto/MG,0,141,0,12757
507201,2022-04-01,Ouro Preto/MG,1,142,0,12757
512798,2022-04-02,Ouro Preto/MG,0,142,0,12757
518395,2022-04-03,Ouro Preto/MG,0,142,0,12757
523992,2022-04-04,Ouro Preto/MG,0,142,0,12757
529589,2022-04-05,Ouro Preto/MG,0,142,0,12757
535186,2022-04-06,Ouro Preto/MG,0,142,0,12757
540783,2022-04-07,Ouro Preto/MG,0,142,0,12757
546380,2022-04-08,Ouro Preto/MG,0,142,0,12757
551977,2022-04-09,Ouro Preto/MG,0,142,0,12757
557574,2022-04-10,Ouro Preto/MG,0,142,0,12757
563171,2022-04-11,Ouro Preto/MG,0,142,0,12757
568768,2022-04-12,Ouro Preto/MG,0,142,0,12757
574365,2022-04-13,Ouro Preto/MG,0,142,0,12757
579962,2022-04-14,Ouro Preto/MG,0,142,0,12757
585559,2022-04-15,Ouro Preto/MG,0,142,0,12757
591156,2022-04-16,Ouro Preto/MG,0,142,0,12757
596753,2022-04-17,Ouro Preto/MG,0,142,0,12757
602350,2022-04-18,Ouro Preto/MG,0,142,0,12757
607947,2022-04-19,Ouro Preto/MG,0,142,0,12757
613544,2022-04-20,Ouro Preto/MG,0,142,0,12757
619141,2022-04-21,Ouro Preto/MG,0,142,0,12757
624738,2022-04-22,Ouro Preto/MG,0,142,0,12757
630335,2022-04-23,Ouro Preto/MG,0,142,0,12757
635932,2022-04-24,Ouro Preto/MG,0,142,0,12757
641529,2022-04-25,Ouro Preto/MG,0,142,0,12757
647126,2022-04-26,Ouro Preto/MG,0,142,0,12757
652723,2022-04-27,Ouro Preto/MG,0,142,0,12757
658320,2022-04-28,Ouro Preto/MG,0,142,0,12757
663917,2022-04-29,Ouro Preto/MG,0,142,0,12757
669514,2022-04-30,Ouro Preto/MG,0,142,0,12757
675111,2022-05-01,Ouro Preto/MG,0,142,0,12757
680708,2022-05-02,Ouro Preto/MG,0,142,0,12757
686305,2022-05-03,Ouro Preto/MG,0,142,0,12757
691902,2022-05-04,Ouro Preto/MG,0,142,0,12757
697499,2022-05-05,Ouro Preto/MG,0,142,0,12757
703096,2022-05-06,Ouro Preto/MG,0,142,0,12757
708693,2022-05-07,Ouro Preto/MG,0,142,0,12757
714290,2022-05-08,Ouro Preto/MG,0,142,0,12757
719887,2022-05-09,Ouro Preto/MG,0,142,0,12757
725484,2022-05-10,Ouro Preto/MG,0,142,0,12757
731081,2022-05-11,Ouro Preto/MG,0,142,0,12757
736678,2022-05-12,Ouro Preto/MG,0,142,0,12757
742275,2022-05-13,Ouro Preto/MG,0,142,0,12757
747872,2022-05-14,Ouro Preto/MG,0,142,0,12757
753469,2022-05-15,Ouro Preto/MG,0,142,0,12757
759066,2022-05-16,Ouro Preto/MG,0,142,0,12757
764663,2022-05-17,Ouro Preto/MG,0,142,0,12757
770260,2022-05-18,Ouro Preto/MG,0,142,0,12757
775857,2022-05-19,Ouro Preto/MG,0,142,0,12757
781454,2022-05-20,Ouro Preto/MG,0,142,0,12757
787051,2022-05-21,Ouro Preto/MG,0,142,0,12757
792648,2022-05-22,Ouro Preto/MG,0,142,0,12757
798245,2022-05-23,Ouro Preto/MG,0,142,0,12757
803842,2022-05-24,Ouro Preto/MG,0,142,0,12757
809439,2022-05-25,Ouro Preto/MG,0,142,0,12757
815036,2022-05-26,Ouro Preto/MG,0,142,0,12757
820633,2022-05-27,Ouro Preto/MG,0,142,0,12757
826230,2022-05-28,Ouro Preto/MG,0,142,0,12757
831827,2022-05-29,Ouro Preto/MG,0,142,0,12757
837424,2022-05-30,Ouro Preto/MG,0,142,0,12757
843021,2022-05-31,Ouro Preto/MG,0,142,0,12757
848618,2022-06-01,Ouro Preto/MG,0,142,0,12757
854215,2022-06-02,Ouro Preto/MG,0,142,0,12757
859812,2022-06-03,Ouro Preto/MG,0,142,0,12757
865409,2022-06-04,Ouro Preto/MG,0,142,0,12757
871006,2022-06-05,Ouro Preto/MG,0,142,0,12757
876603,2022-06-06,Ouro Preto/MG,0,142,0,12757
882200,2022-06-07,Ouro Preto/MG,0,142,0,12757
887797,2022-06-08,Ouro Preto/MG,0,142,0,12757
893394,2022-06-09,Ouro Preto/MG,0,142,0,12757
898991,2022-06-10,Ouro Preto/MG,0,142,0,12757
904588,2022-06-11,Ouro Preto/MG,0,142,0,12757
910185,2022-06-12,Ouro Preto/MG,0,142,0,12757
915782,2022-06-13,Ouro Preto/MG,0,142,0,12757
921379,2022-06-14,Ouro Preto/MG,0,142,0,12757
926976,2022-06-15,Ouro Preto/MG,0,142,0,12757
932573,2022-06-16,Ouro Preto/MG,0,142,0,12757
938170,2022-06-17,Ouro Preto/MG,0,142,0,12757
943767,2022-06-18,Ouro Preto/MG,0,142,0,12757
949364,2022-06-19,Ouro Preto/MG,0,142,0,12757
954961,2022-06-20,Ouro Preto/MG,0,142,0,12757
960558,2022-06-21,Ouro Preto/MG,0,142,0,12757
966155,2022-06-22,Ouro Preto/MG,0,142,0,12757
971752,2022-06-23,Ouro Preto/MG,0,142,0,12757
977349,2022-06-24,Ouro Preto/MG,0,142,0,12757
982946,2022-06-25,Ouro Preto/MG,0,142,0,12757
988543,2022-06-26,Ouro Preto/MG,0,142,0,12757
994140,2022-06-27,Ouro Preto/MG,1,143,0,12757
999737,2022-06-28,Ouro Preto/MG,0,143,0,12757
1005334,2022-06-29,Ouro Preto/MG,0,143,0,12757
1010931,2022-06-30,Ouro Preto/MG,0,143,0,12757
1016528,2022-07-01,Ouro Preto/MG,0,143,0,12757
1022125,2022-07-02,Ouro Preto/MG,0,143,0,12757
1027722,2022-07-03,Ouro Preto/MG,0,143,0,12757
1033319,2022-07-04,Ouro Preto/MG,0,143,0,12757
1038916,2022-07-05,Ouro Preto/MG,0,143,0,12757
1044513,2022-07-06,Ouro Preto/MG,0,143,0,12757
1050110,2022-07-07,Ouro Preto/MG,0,143,0,12757
1055707,2022-07-08,Ouro Preto/MG,0,143,0,12757
1061304,2022-07-09,Ouro Preto/MG,0,143,0,12757
1066901,2022-07-10,Ouro Preto/MG,0,143,0,12757
1072498,2022-07-11,Ouro Preto/MG,0,143,0,12757
1078095,2022-07-12,Ouro Preto/MG,0,143,0,12757
1083692,2022-07-13,Ouro Preto/MG,0,143,0,12757
1089289,2022-07-14,Ouro Preto/MG,0,143,0,12757
1094886,2022-07-15,Ouro Preto/MG,0,143,0,12757
1100483,2022-07-16,Ouro Preto/MG,0,143,0,12757
1106080,2022-07-17,Ouro Preto/MG,0,143,0,12757
1111677,2022-07-18,Ouro Preto/MG,0,143,0,12757
1117274,2022-07-19,Ouro Preto/MG,0,143,0,12757
1122871,2022-07-20,Ouro Preto/MG,0,143,0,12757
1128468,2022-07-21,Ouro Preto/MG,0,143,0,12757
1134065,2022-07-22,Ouro Preto/MG,0,143,0,12757
1139662,2022-07-23,Ouro Preto/MG,0,143,0,12757
1145259,2022-07-24,Ouro Preto/MG,0,143,0,12757
1150856,2022-07-25,Ouro Preto/MG,0,143,0,12757
1156453,2022-07-26,Ouro Preto/MG,0,143,0,12757
1162050,2022-07-27,Ouro Preto/MG,0,143,0,12757
1167647,2022-07-28,Ouro Preto/MG,1,144,0,12757
1173244,2022-07-29,Ouro Preto/MG,0,144,0,12757
1178841,2022-07-30,Ouro Preto/MG,0,144,0,12757
1184438,2022-07-31,Ouro Preto/MG,0,144,0,12757
1190035,2022-08-01,Ouro Preto/MG,0,144,0,12757
1195632,2022-08-02,Ouro Preto/MG,0,144,0,12757
1201229,2022-08-03,Ouro Preto/MG,0,144,0,12757
1206826,2022-08-04,Ouro Preto/MG,0,144,0,12757
1212423,2022-08-05,Ouro Preto/MG,0,144,0,12757
1218020,2022-08-06,Ouro Preto/MG,0,144,0,12757
1223617,2022-08-07,Ouro Preto/MG,0,144,0,12757
1229214,2022-08-08,Ouro Preto/MG,0,144,0,12757
1234811,2022-08-09,Ouro Preto/MG,0,144,0,12757
1240408,2022-08-10,Ouro Preto/MG,0,144,0,12757
1246005,2022-08-11,Ouro Preto/MG,0,144,0,12757
1251602,2022-08-12,Ouro Preto/MG,0,144,0,12757
1257199,2022-08-13,Ouro Preto/MG,0,144,0,12757
1262796,2022-08-14,Ouro Preto/MG,0,144,0,12757
1268393,2022-08-15,Ouro Preto/MG,0,144,0,12757
1273990,2022-08-16,Ouro Preto/MG,0,144,0,12757
1279587,2022-08-17,Ouro Preto/MG,0,144,0,12757
1285184,2022-08-18,Ouro Preto/MG,0,144,0,12757
1290781,2022-08-19,Ouro Preto/MG,0,144,0,12757
1296378,2022-08-20,Ouro Preto/MG,0,144,0,12757
1301975,2022-08-21,Ouro Preto/MG,0,144,0,12757
1307572,2022-08-22,Ouro Preto/MG,0,144,0,12757
1313169,2022-08-23,Ouro Preto/MG,0,144,0,12757
1318766,2022-08-24,Ouro Preto/MG,0,144,0,12757
1324363,2022-08-25,Ouro Preto/MG,0,144,0,12757
4678,2022-01-01,Sete Lagoas/MG,0,613,0,23782
10275,2022-01-02,Sete Lagoas/MG,0,613,0,23782
15872,2022-01-03,Sete Lagoas/MG,0,613,0,23782
21469,2022-01-04,Sete Lagoas/MG,0,613,38,23820
27066,2022-01-05,Sete Lagoas/MG,0,613,24,23844
32663,2022-01-06,Sete Lagoas/MG,0,613,51,23895
38260,2022-01-07,Sete Lagoas/MG,0,613,83,23978
43857,2022-01-08,Sete Lagoas/MG,0,613,82,24060
49454,2022-01-09,Sete Lagoas/MG,0,613,0,24060
55051,2022-01-10,Sete Lagoas/MG,0,613,0,24060
60648,2022-01-11,Sete Lagoas/MG,0,613,0,24060
66245,2022-01-12,Sete Lagoas/MG,0,613,27,24087
71842,2022-01-13,Sete Lagoas/MG,0,613,123,24210
77439,2022-01-14,Sete Lagoas/MG,0,613,208,24418
83036,2022-01-15,Sete Lagoas/MG,1,614,42,24460
88633,2022-01-16,Sete Lagoas/MG,0,614,0,24460
94230,2022-01-17,Sete Lagoas/MG,0,614,0,24460
99827,2022-01-18,Sete Lagoas/MG,0,614,176,24636
105424,2022-01-19,Sete Lagoas/MG,0,614,179,24815
111021,2022-01-20,Sete Lagoas/MG,3,617,288,25103
116618,2022-01-21,Sete Lagoas/MG,0,617,335,25438
122215,2022-01-22,Sete Lagoas/MG,0,617,263,25701
127812,2022-01-23,Sete Lagoas/MG,0,617,0,25701
133409,2022-01-24,Sete Lagoas/MG,0,617,0,25701
139006,2022-01-25,Sete Lagoas/MG,0,617,654,26355
144603,2022-01-26,Sete Lagoas/MG,0,617,298,26653
150200,2022-01-27,Sete Lagoas/MG,0,617,366,27019
155797,2022-01-28,Sete Lagoas/MG,2,619,0,27019
161394,2022-01-29,Sete Lagoas/MG,3,622,945,27964
166991,2022-01-30,Sete Lagoas/MG,1,623,0,27964
172588,2022-01-31,Sete Lagoas/MG,0,623,0,27964
178185,2022-02-01,Sete Lagoas/MG,0,623,801,28765
183782,2022-02-02,Sete Lagoas/MG,0,623,583,29348
189379,2022-02-03,Sete Lagoas/MG,3,626,453,29801
194976,2022-02-04,Sete Lagoas/MG,0,626,439,30240
200573,2022-02-05,Sete Lagoas/MG,5,631,461,30701
206170,2022-02-06,Sete Lagoas/MG,1,632,0,30701
211767,2022-02-07,Sete Lagoas/MG,0,632,0,30701
217364,2022-02-08,Sete Lagoas/MG,0,632,531,31232
222961,2022-02-09,Sete Lagoas/MG,3,635,452,31684
228558,2022-02-10,Sete Lagoas/MG,4,639,387,32071
234155,2022-02-11,Sete Lagoas/MG,3,642,243,32314
239752,2022-02-12,Sete Lagoas/MG,1,643,328,32642
245349,2022-02-13,Sete Lagoas/MG,-1,642,0,32642
250946,2022-02-14,Sete Lagoas/MG,2,644,0,32642
256543,2022-02-15,Sete Lagoas/MG,0,644,400,33042
262140,2022-02-16,Sete Lagoas/MG,1,645,171,33213
267737,2022-02-17,Sete Lagoas/MG,4,649,192,33405
273334,2022-02-18,Sete Lagoas/MG,1,650,168,33573
278931,2022-02-19,Sete Lagoas/MG,2,652,152,33725
284528,2022-02-20,Sete Lagoas/MG,2,654,0,33725
290125,2022-02-21,Sete Lagoas/MG,0,654,0,33725
295722,2022-02-22,Sete Lagoas/MG,0,654,231,33956
301319,2022-02-23,Sete Lagoas/MG,5,659,116,34072
306916,2022-02-24,Sete Lagoas/MG,0,659,108,34180
312513,2022-02-25,Sete Lagoas/MG,3,662,115,34295
318110,2022-02-26,Sete Lagoas/MG,0,662,104,34399
323707,2022-02-27,Sete Lagoas/MG,2,664,0,34399
329304,2022-02-28,Sete Lagoas/MG,0,664,0,34399
334901,2022-03-01,Sete Lagoas/MG,0,664,0,34399
340498,2022-03-02,Sete Lagoas/MG,0,664,0,34399
346095,2022-03-03,Sete Lagoas/MG,0,664,209,34608
351692,2022-03-04,Sete Lagoas/MG,2,666,81,34689
357289,2022-03-05,Sete Lagoas/MG,1,667,76,34765
362886,2022-03-06,Sete Lagoas/MG,0,667,0,34765
368483,2022-03-07,Sete Lagoas/MG,0,667,0,34765
374080,2022-03-08,Sete Lagoas/MG,0,667,103,34868
379677,2022-03-09,Sete Lagoas/MG,1,668,67,34935
385274,2022-03-10,Sete Lagoas/MG,0,668,62,34997
390871,2022-03-11,Sete Lagoas/MG,2,670,57,35054
396468,2022-03-12,Sete Lagoas/MG,0,670,0,35054
402065,2022-03-13,Sete Lagoas/MG,2,672,0,35054
407662,2022-03-14,Sete Lagoas/MG,0,672,0,35054
413259,2022-03-15,Sete Lagoas/MG,0,672,0,35054
418856,2022-03-16,Sete Lagoas/MG,0,672,183,35237
424453,2022-03-17,Sete Lagoas/MG,0,672,43,35280
430050,2022-03-18,Sete Lagoas/MG,0,672,36,35316
435647,2022-03-19,Sete Lagoas/MG,0,672,33,35349
441244,2022-03-20,Sete Lagoas/MG,0,672,0,35349
446841,2022-03-21,Sete Lagoas/MG,0,672,0,35349
452438,2022-03-22,Sete Lagoas/MG,0,672,6,35355
458035,2022-03-23,Sete Lagoas/MG,0,672,0,35355
463632,2022-03-24,Sete Lagoas/MG,0,672,41,35396
469229,2022-03-25,Sete Lagoas/MG,0,672,0,35396
474826,2022-03-26,Sete Lagoas/MG,0,672,13,35409
480423,2022-03-27,Sete Lagoas/MG,1,673,0,35409
486020,2022-03-28,Sete Lagoas/MG,0,673,0,35409
491617,2022-03-29,Sete Lagoas/MG,0,673,0,35409
497214,2022-03-30,Sete Lagoas/MG,0,673,24,35433
502811,2022-03-31,Sete Lagoas/MG,0,673,5,35438
508408,2022-04-01,Sete Lagoas/MG,0,673,3,35441
514005,2022-04-02,Sete Lagoas/MG,0,673,0,35441
519602,2022-04-03,Sete Lagoas/MG,0,673,0,35441
525199,2022-04-04,Sete Lagoas/MG,0,673,6,35447
530796,2022-04-05,Sete Lagoas/MG,0,673,16,35463
536393,2022-04-06,Sete Lagoas/MG,1,674,2,35465
541990,2022-04-07,Sete Lagoas/MG,0,674,5,35470
547587,2022-04-08,Sete Lagoas/MG,0,674,6,35476
553184,2022-04-09,Sete Lagoas/MG,0,674,5,35481
558781,2022-04-10,Sete Lagoas/MG,0,674,0,35481
564378,2022-04-11,Sete Lagoas/MG,0,674,0,35481
569975,2022-04-12,Sete Lagoas/MG,0,674,6,35487
575572,2022-04-13,Sete Lagoas/MG,1,675,4,35491
581169,2022-04-14,Sete Lagoas/MG,0,675,5,35496
586766,2022-04-15,Sete Lagoas/MG,1,676,0,35496
592363,2022-04-16,Sete Lagoas/MG,0,676,0,35496
597960,2022-04-17,Sete Lagoas/MG,0,676,0,35496
603557,2022-04-18,Sete Lagoas/MG,0,676,0,35496
609154,2022-04-19,Sete Lagoas/MG,0,676,12,35508
614751,2022-04-20,Sete Lagoas/MG,0,676,0,35508
620348,2022-04-21,Sete Lagoas/MG,0,676,4,35512
625945,2022-04-22,Sete Lagoas/MG,0,676,0,35512
631542,2022-04-23,Sete Lagoas/MG,0,676,0,35512
637139,2022-04-24,Sete Lagoas/MG,0,676,0,35512
642736,2022-04-25,Sete Lagoas/MG,0,676,0,35512
648333,2022-04-26,Sete Lagoas/MG,0,676,12,35524
653930,2022-04-27,Sete Lagoas/MG,0,676,6,35530
659527,2022-04-28,Sete Lagoas/MG,0,676,4,35534
665124,2022-04-29,Sete Lagoas/MG,0,676,2,35536
670721,2022-04-30,Sete Lagoas/MG,0,676,0,35536
676318,2022-05-01,Sete Lagoas/MG,0,676,0,35536
681915,2022-05-02,Sete Lagoas/MG,0,676,0,35536
687512,2022-05-03,Sete Lagoas/MG,0,676,11,35547
693109,2022-05-04,Sete Lagoas/MG,0,676,4,35551
698706,2022-05-05,Sete Lagoas/MG,0,676,7,35558
704303,2022-05-06,Sete Lagoas/MG,0,676,6,35564
709900,2022-05-07,Sete Lagoas/MG,0,676,0,35564
715497,2022-05-08,Sete Lagoas/MG,0,676,0,35564
721094,2022-05-09,Sete Lagoas/MG,0,676,6,35570
726691,2022-05-10,Sete Lagoas/MG,0,676,14,35584
732288,2022-05-11,Sete Lagoas/MG,1,677,6,35590
737885,2022-05-12,Sete Lagoas/MG,0,677,6,35596
743482,2022-05-13,Sete Lagoas/MG,0,677,8,35604
749079,2022-05-14,Sete Lagoas/MG,0,677,0,35604
754676,2022-05-15,Sete Lagoas/MG,0,677,0,35604
760273,2022-05-16,Sete Lagoas/MG,0,677,11,35615
765870,2022-05-17,Sete Lagoas/MG,0,677,16,35631
771467,2022-05-18,Sete Lagoas/MG,0,677,11,35642
777064,2022-05-19,Sete Lagoas/MG,0,677,13,35655
782661,2022-05-20,Sete Lagoas/MG,0,677,12,35667
788258,2022-05-21,Sete Lagoas/MG,0,677,0,35667
793855,2022-05-22,Sete Lagoas/MG,0,677,0,35667
799452,2022-05-23,Sete Lagoas/MG,0,677,9,35676
805049,2022-05-24,Sete Lagoas/MG,0,677,43,35719
810646,2022-05-25,Sete Lagoas/MG,0,677,49,35768
816243,2022-05-26,Sete Lagoas/MG,0,677,52,35820
821840,2022-05-27,Sete Lagoas/MG,0,677,41,35861
827437,2022-05-28,Sete Lagoas/MG,0,677,0,35861
833034,2022-05-29,Sete Lagoas/MG,0,677,0,35861
838631,2022-05-30,Sete Lagoas/MG,0,677,31,35892
844228,2022-05-31,Sete Lagoas/MG,0,677,66,35958
849825,2022-06-01,Sete Lagoas/MG,0,677,78,36036
855422,2022-06-02,Sete Lagoas/MG,0,677,61,36097
861019,2022-06-03,Sete Lagoas/MG,0,677,63,36160
866616,2022-06-04,Sete Lagoas/MG,0,677,0,36160
872213,2022-06-05,Sete Lagoas/MG,0,677,0,36160
877810,2022-06-06,Sete Lagoas/MG,0,677,78,36238
883407,2022-06-07,Sete Lagoas/MG,0,677,130,36368
889004,2022-06-08,Sete Lagoas/MG,0,677,113,36481
894601,2022-06-09,Sete Lagoas/MG,0,677,134,36615
900198,2022-06-10,Sete Lagoas/MG,0,677,125,36740
905795,2022-06-11,Sete Lagoas/MG,0,677,0,36740
911392,2022-06-12,Sete Lagoas/MG,0,677,0,36740
916989,2022-06-13,Sete Lagoas/MG,0,677,109,36849
922586,2022-06-14,Sete Lagoas/MG,0,677,0,36849
928183,2022-06-15,Sete Lagoas/MG,0,677,211,37060
933780,2022-06-16,Sete Lagoas/MG,0,677,0,37060
939377,2022-06-17,Sete Lagoas/MG,0,677,0,37060
944974,2022-06-18,Sete Lagoas/MG,0,677,0,37060
950571,2022-06-19,Sete Lagoas/MG,0,677,0,37060
956168,2022-06-20,Sete Lagoas/MG,0,677,124,37184
961765,2022-06-21,Sete Lagoas/MG,1,678,227,37411
967362,2022-06-22,Sete Lagoas/MG,0,678,123,37534
972959,2022-06-23,Sete Lagoas/MG,0,678,121,37655
978556,2022-06-24,Sete Lagoas/MG,1,679,107,37762
984153,2022-06-25,Sete Lagoas/MG,0,679,0,37762
989750,2022-06-26,Sete Lagoas/MG,0,679,0,37762
995347,2022-06-27,Sete Lagoas/MG,0,679,138,37900
1000944,2022-06-28,Sete Lagoas/MG,0,679,178,38078
1006541,2022-06-29,Sete Lagoas/MG,3,682,170,38248
1012138,2022-06-30,Sete Lagoas/MG,1,683,163,38411
1017735,2022-07-01,Sete Lagoas/MG,0,683,147,38558
1023332,2022-07-02,Sete Lagoas/MG,0,683,0,38558
1028929,2022-07-03,Sete Lagoas/MG,0,683,0,38558
1034526,2022-07-04,Sete Lagoas/MG,1,684,153,38711
1040123,2022-07-05,Sete Lagoas/MG,0,684,222,38933
1045720,2022-07-06,Sete Lagoas/MG,0,684,129,39062
1051317,2022-07-07,Sete Lagoas/MG,0,684,137,39199
1056914,2022-07-08,Sete Lagoas/MG,0,684,158,39357
1062511,2022-07-09,Sete Lagoas/MG,0,684,0,39357
1068108,2022-07-10,Sete Lagoas/MG,0,684,0,39357
1073705,2022-07-11,Sete Lagoas/MG,0,684,161,39518
1079302,2022-07-12,Sete Lagoas/MG,0,684,206,39724
1084899,2022-07-13,Sete Lagoas/MG,0,684,149,39873
1090496,2022-07-14,Sete Lagoas/MG,0,684,111,39984
1096093,2022-07-15,Sete Lagoas/MG,1,685,96,40080
1101690,2022-07-16,Sete Lagoas/MG,0,685,0,40080
1107287,2022-07-17,Sete Lagoas/MG,0,685,0,40080
1112884,2022-07-18,Sete Lagoas/MG,0,685,102,40182
1118481,2022-07-19,Sete Lagoas/MG,0,685,153,40335
1124078,2022-07-20,Sete Lagoas/MG,0,685,102,40437
1129675,2022-07-21,Sete Lagoas/MG,1,686,95,40532
1135272,2022-07-22,Sete Lagoas/MG,0,686,74,40606
1140869,2022-07-23,Sete Lagoas/MG,0,686,0,40606
1146466,2022-07-24,Sete Lagoas/MG,0,686,0,40606
1152063,2022-07-25,Sete Lagoas/MG,0,686,99,40705
1157660,2022-07-26,Sete Lagoas/MG,0,686,94,40799
1163257,2022-07-27,Sete Lagoas/MG,0,686,79,40878
1168854,2022-07-28,Sete Lagoas/MG,0,686,82,40960
1174451,2022-07-29,Sete Lagoas/MG,1,687,73,41033
1180048,2022-07-30,Sete Lagoas/MG,0,687,0,41033
1185645,2022-07-31,Sete Lagoas/MG,0,687,0,41033
1191242,2022-08-01,Sete Lagoas/MG,0,687,68,41101
1196839,2022-08-02,Sete Lagoas/MG,0,687,109,41210
1202436,2022-08-03,Sete Lagoas/MG,0,687,67,41277
1208033,2022-08-04,Sete Lagoas/MG,0,687,58,41335
1213630,2022-08-05,Sete Lagoas/MG,0,687,61,41396
1219227,2022-08-06,Sete Lagoas/MG,0,687,0,41396
1224824,2022-08-07,Sete Lagoas/MG,0,687,0,41396
1230421,2022-08-08,Sete Lagoas/MG,0,687,52,41448
1236018,2022-08-09,Sete Lagoas/MG,1,688,51,41499
1241615,2022-08-10,Sete Lagoas/MG,0,688,48,41547
1247212,2022-08-11,Sete Lagoas/MG,1,689,44,41591
1252809,2022-08-12,Sete Lagoas/MG,1,690,38,41629
1258406,2022-08-13,Sete Lagoas/MG,0,690,0,41629
1264003,2022-08-14,Sete Lagoas/MG,0,690,0,41629
1269600,2022-08-15,Sete Lagoas/MG,0,690,0,41629
1275197,2022-08-16,Sete Lagoas/MG,0,690,94,41723
1280794,2022-08-17,Sete Lagoas/MG,0,690,36,41759
1286391,2022-08-18,Sete Lagoas/MG,0,690,35,41794
1291988,2022-08-19,Sete Lagoas/MG,0,690,32,41826
1297585,2022-08-20,Sete Lagoas/MG,0,690,0,41826
1303182,2022-08-21,Sete Lagoas/MG,0,690,0,41826
1308779,2022-08-22,Sete Lagoas/MG,0,690,37,41863
1314376,2022-08-23,Sete Lagoas/MG,0,690,46,41909
1319973,2022-08-24,Sete Lagoas/MG,0,690,28,41937
1325570,2022-08-25,Sete Lagoas/MG,0,690,31,41968
161,2022-01-01,Americana/SP,0,851,0,27282
5758,2022-01-02,Americana/SP,0,851,0,27282
11355,2022-01-03,Americana/SP,0,851,0,27282
16952,2022-01-04,Americana/SP,0,851,3,27285
22549,2022-01-05,Americana/SP,2,853,2,27287
28146,2022-01-06,Americana/SP,1,854,0,27287
33743,2022-01-07,Americana/SP,0,854,1,27288
39340,2022-01-08,Americana/SP,1,855,4,27292
44937,2022-01-09,Americana/SP,0,855,0,27292
50534,2022-01-10,Americana/SP,0,855,0,27292
56131,2022-01-11,Americana/SP,1,856,0,27292
61728,2022-01-12,Americana/SP,0,856,0,27292
67325,2022-01-13,Americana/SP,0,856,5,27297
72922,2022-01-14,Americana/SP,2,858,6,27303
78519,2022-01-15,Americana/SP,0,858,1,27304
84116,2022-01-16,Americana/SP,0,858,-1,27303
89713,2022-01-17,Americana/SP,0,858,-1,27302
95310,2022-01-18,Americana/SP,0,858,1,27303
100907,2022-01-19,Americana/SP,0,858,0,27303
106504,2022-01-20,Americana/SP,3,861,9,27312
112101,2022-01-21,Americana/SP,0,861,4,27316
117698,2022-01-22,Americana/SP,0,861,0,27316
123295,2022-01-23,Americana/SP,0,861,8,27324
128892,2022-01-24,Americana/SP,0,861,0,27324
134489,2022-01-25,Americana/SP,0,861,3,27327
140086,2022-01-26,Americana/SP,1,862,9,27336
145683,2022-01-27,Americana/SP,0,862,4,27340
151280,2022-01-28,Americana/SP,1,863,5,27345
156877,2022-01-29,Americana/SP,14,877,14,27359
162474,2022-01-30,Americana/SP,0,877,1,27360
168071,2022-01-31,Americana/SP,0,877,0,27360
173668,2022-02-01,Americana/SP,3,880,5,27365
179265,2022-02-02,Americana/SP,0,880,1,27366
184862,2022-02-03,Americana/SP,6,886,57,27423
190459,2022-02-04,Americana/SP,0,886,0,27423
196056,2022-02-05,Americana/SP,7,893,38,27461
201653,2022-02-06,Americana/SP,0,893,30,27491
207250,2022-02-07,Americana/SP,0,893,1,27492
212847,2022-02-08,Americana/SP,2,895,27,27519
218444,2022-02-09,Americana/SP,1,896,1,27520
224041,2022-02-10,Americana/SP,13,909,47,27567
229638,2022-02-11,Americana/SP,4,913,11,27578
235235,2022-02-12,Americana/SP,2,915,8,27586
240832,2022-02-13,Americana/SP,0,915,0,27586
246429,2022-02-14,Americana/SP,1,916,1,27587
252026,2022-02-15,Americana/SP,5,921,24,27611
257623,2022-02-16,Americana/SP,5,926,22,27633
263220,2022-02-17,Americana/SP,1,927,5,27638
268817,2022-02-18,Americana/SP,1,928,3,27641
274414,2022-02-19,Americana/SP,2,930,9,27650
280011,2022-02-20,Americana/SP,0,930,1,27651
285608,2022-02-21,Americana/SP,0,930,-1,27650
291205,2022-02-22,Americana/SP,0,930,7,27657
296802,2022-02-23,Americana/SP,6,936,14,27671
302399,2022-02-24,Americana/SP,1,937,21,27692
307996,2022-02-25,Americana/SP,0,937,5,27697
313593,2022-02-26,Americana/SP,0,937,3,27700
319190,2022-02-27,Americana/SP,0,937,1,27701
324787,2022-02-28,Americana/SP,0,937,0,27701
330384,2022-03-01,Americana/SP,0,937,0,27701
335981,2022-03-02,Americana/SP,0,937,0,27701
341578,2022-03-03,Americana/SP,0,937,24,27725
347175,2022-03-04,Americana/SP,6,943,19,27744
352772,2022-03-05,Americana/SP,1,944,0,27744
358369,2022-03-06,Americana/SP,0,944,0,27744
363966,2022-03-07,Americana/SP,0,944,0,27744
369563,2022-03-08,Americana/SP,0,944,9,27753
375160,2022-03-09,Americana/SP,0,944,31,27784
380757,2022-03-10,Americana/SP,0,944,5,27789
386354,2022-03-11,Americana/SP,1,945,4,27793
391951,2022-03-12,Americana/SP,1,946,6,27799
397548,2022-03-13,Americana/SP,0,946,0,27799
403145,2022-03-14,Americana/SP,-1,945,-1,27798
408742,2022-03-15,Americana/SP,0,945,14,27812
414339,2022-03-16,Americana/SP,0,945,5,27817
419936,2022-03-17,Americana/SP,2,947,5,27822
425533,2022-03-18,Americana/SP,-1,946,3,27825
431130,2022-03-19,Americana/SP,0,946,1,27826
436727,2022-03-20,Americana/SP,0,946,34,27860
442324,2022-03-21,Americana/SP,0,946,0,27860
447921,2022-03-22,Americana/SP,2,948,4,27864
453518,2022-03-23,Americana/SP,0,948,2,27866
459115,2022-03-24,Americana/SP,1,949,3,27869
464712,2022-03-25,Americana/SP,1,950,3,27872
470309,2022-03-26,Americana/SP,2,952,1,27873
475906,2022-03-27,Americana/SP,0,952,1,27874
481503,2022-03-28,Americana/SP,0,952,0,27874
487100,2022-03-29,Americana/SP,0,952,4,27878
492697,2022-03-30,Americana/SP,0,952,1,27879
498294,2022-03-31,Americana/SP,0,952,0,27879
503891,2022-04-01,Americana/SP,0,952,1,27880
509488,2022-04-02,Americana/SP,0,952,28,27908
515085,2022-04-03,Americana/SP,0,952,0,27908
520682,2022-04-04,Americana/SP,0,952,1,27909
526279,2022-04-05,Americana/SP,0,952,1,27910
531876,2022-04-06,Americana/SP,0,952,0,27910
537473,2022-04-07,Americana/SP,1,953,0,27910
543070,2022-04-08,Americana/SP,0,953,0,27910
548667,2022-04-09,Americana/SP,0,953,5,27915
554264,2022-04-10,Americana/SP,0,953,0,27915
559861,2022-04-11,Americana/SP,0,953,2,27917
565458,2022-04-12,Americana/SP,-1,952,2,27919
571055,2022-04-13,Americana/SP,0,952,2,27921
576652,2022-04-14,Americana/SP,0,952,-1,27920
582249,2022-04-15,Americana/SP,0,952,0,27920
587846,2022-04-16,Americana/SP,0,952,0,27920
593443,2022-04-17,Americana/SP,0,952,0,27920
599040,2022-04-18,Americana/SP,0,952,1,27921
604637,2022-04-19,Americana/SP,0,952,0,27921
610234,2022-04-20,Americana/SP,0,952,1,27922
615831,2022-04-21,Americana/SP,0,952,0,27922
621428,2022-04-22,Americana/SP,0,952,0,27922
627025,2022-04-23,Americana/SP,0,952,0,27922
632622,2022-04-24,Americana/SP,0,952,0,27922
638219,2022-04-25,Americana/SP,0,952,0,27922
643816,2022-04-26,Americana/SP,0,952,4,27926
649413,2022-04-27,Americana/SP,0,952,1,27927
655010,2022-04-28,Americana/SP,0,952,0,27927
660607,2022-04-29,Americana/SP,0,952,0,27927
666204,2022-04-30,Americana/SP,0,952,0,27927
671801,2022-05-01,Americana/SP,0,952,0,27927
677398,2022-05-02,Americana/SP,0,952,0,27927
682995,2022-05-03,Americana/SP,0,952,1,27928
688592,2022-05-04,Americana/SP,0,952,0,27928
694189,2022-05-05,Americana/SP,0,952,0,27928
699786,2022-05-06,Americana/SP,0,952,-1,27927
705383,2022-05-07,Americana/SP,1,953,2,27929
710980,2022-05-08,Americana/SP,0,953,0,27929
716577,2022-05-09,Americana/SP,0,953,0,27929
722174,2022-05-10,Americana/SP,0,953,0,27929
727771,2022-05-11,Americana/SP,0,953,0,27929
733368,2022-05-12,Americana/SP,0,953,2,27931
738965,2022-05-13,Americana/SP,0,953,0,27931
744562,2022-05-14,Americana/SP,0,953,1,27932
750159,2022-05-15,Americana/SP,0,953,2,27934
755756,2022-05-16,Americana/SP,0,953,0,27934
761353,2022-05-17,Americana/SP,0,953,0,27934
766950,2022-05-18,Americana/SP,0,953,1,27935
772547,2022-05-19,Americana/SP,0,953,0,27935
778144,2022-05-20,Americana/SP,0,953,0,27935
783741,2022-05-21,Americana/SP,0,953,0,27935
789338,2022-05-22,Americana/SP,0,953,0,27935
794935,2022-05-23,Americana/SP,0,953,0,27935
800532,2022-05-24,Americana/SP,0,953,16,27951
806129,2022-05-25,Americana/SP,0,953,1,27952
811726,2022-05-26,Americana/SP,0,953,1,27953
817323,2022-05-27,Americana/SP,0,953,2,27955
822920,2022-05-28,Americana/SP,0,953,0,27955
828517,2022-05-29,Americana/SP,0,953,1,27956
834114,2022-05-30,Americana/SP,0,953,0,27956
839711,2022-05-31,Americana/SP,0,953,1,27957
845308,2022-06-01,Americana/SP,0,953,6,27963
850905,2022-06-02,Americana/SP,2,955,2,27965
856502,2022-06-03,Americana/SP,0,955,0,27965
862099,2022-06-04,Americana/SP,0,955,0,27965
867696,2022-06-05,Americana/SP,0,955,0,27965
873293,2022-06-06,Americana/SP,0,955,0,27965
878890,2022-06-07,Americana/SP,0,955,7,27972
884487,2022-06-08,Americana/SP,0,955,10,27982
890084,2022-06-09,Americana/SP,0,955,6,27988
895681,2022-06-10,Americana/SP,0,955,7,27995
901278,2022-06-11,Americana/SP,1,956,8,28003
906875,2022-06-12,Americana/SP,0,956,0,28003
912472,2022-06-13,Americana/SP,0,956,0,28003
918069,2022-06-14,Americana/SP,0,956,0,28003
923666,2022-06-15,Americana/SP,0,956,11,28014
929263,2022-06-16,Americana/SP,0,956,-1,28013
934860,2022-06-17,Americana/SP,0,956,0,28013
940457,2022-06-18,Americana/SP,0,956,0,28013
946054,2022-06-19,Americana/SP,0,956,0,28013
951651,2022-06-20,Americana/SP,0,956,0,28013
957248,2022-06-21,Americana/SP,1,957,4,28017
962845,2022-06-22,Americana/SP,0,957,4,28021
968442,2022-06-23,Americana/SP,0,957,1,28022
974039,2022-06-24,Americana/SP,0,957,0,28022
979636,2022-06-25,Americana/SP,2,959,2,28024
985233,2022-06-26,Americana/SP,0,959,0,28024
990830,2022-06-27,Americana/SP,0,959,0,28024
996427,2022-06-28,Americana/SP,0,959,4,28028
1002024,2022-06-29,Americana/SP,0,959,3,28031
1007621,2022-06-30,Americana/SP,3,962,5,28036
1013218,2022-07-01,Americana/SP,2,964,4,28040
1018815,2022-07-02,Americana/SP,1,965,3,28043
1024412,2022-07-03,Americana/SP,0,965,1,28044
1030009,2022-07-04,Americana/SP,0,965,0,28044
1035606,2022-07-05,Americana/SP,3,968,4,28048
1041203,2022-07-06,Americana/SP,1,969,4,28052
1046800,2022-07-07,Americana/SP,0,969,2,28054
1052397,2022-07-08,Americana/SP,1,970,4,28058
1057994,2022-07-09,Americana/SP,0,970,4,28062
1063591,2022-07-10,Americana/SP,0,970,1,28063
1069188,2022-07-11,Americana/SP,0,970,1,28064
1074785,2022-07-12,Americana/SP,0,970,2,28066
1080382,2022-07-13,Americana/SP,0,970,3,28069
1085979,2022-07-14,Americana/SP,2,972,4,28073
1091576,2022-07-15,Americana/SP,0,972,3,28076
1097173,2022-07-16,Americana/SP,0,972,1,28077
1102770,2022-07-17,Americana/SP,0,972,2,28079
1108367,2022-07-18,Americana/SP,0,972,0,28079
1113964,2022-07-19,Americana/SP,0,972,5,28084
1119561,2022-07-20,Americana/SP,0,972,2,28086
1125158,2022-07-21,Americana/SP,1,973,8,28094
1130755,2022-07-22,Americana/SP,0,973,4,28098
1136352,2022-07-23,Americana/SP,1,974,2,28100
1141949,2022-07-24,Americana/SP,0,974,0,28100
1147546,2022-07-25,Americana/SP,0,974,0,28100
1153143,2022-07-26,Americana/SP,3,977,1,28101
1158740,2022-07-27,Americana/SP,0,977,3,28104
1164337,2022-07-28,Americana/SP,0,977,2,28106
1169934,2022-07-29,Americana/SP,2,979,0,28106
1175531,2022-07-30,Americana/SP,1,980,2,28108
1181128,2022-07-31,Americana/SP,0,980,0,28108
1186725,2022-08-01,Americana/SP,0,980,0,28108
1192322,2022-08-02,Americana/SP,0,980,1,28109
1197919,2022-08-03,Americana/SP,0,980,8,28117
1203516,2022-08-04,Americana/SP,1,981,21,28138
1209113,2022-08-05,Americana/SP,0,981,14,28152
1214710,2022-08-06,Americana/SP,0,981,3,28155
1220307,2022-08-07,Americana/SP,0,981,-1,28154
1225904,2022-08-08,Americana/SP,0,981,0,28154
1231501,2022-08-09,Americana/SP,1,982,-1,28153
1237098,2022-08-10,Americana/SP,0,982,0,28153
1242695,2022-08-11,Americana/SP,0,982,1,28154
1248292,2022-08-12,Americana/SP,0,982,1,28155
1253889,2022-08-13,Americana/SP,0,982,1,28156
1259486,2022-08-14,Americana/SP,0,982,1,28157
1265083,2022-08-15,Americana/SP,0,982,0,28157
1270680,2022-08-16,Americana/SP,1,983,3,28160
1276277,2022-08-17,Americana/SP,0,983,1,28161
1281874,2022-08-18,Americana/SP,0,983,2,28163
1287471,2022-08-19,Americana/SP,2,985,4,28167
1293068,2022-08-20,Americana/SP,0,985,0,28167
1298665,2022-08-21,Americana/SP,0,985,0,28167
1304262,2022-08-22,Americana/SP,0,985,0,28167
1309859,2022-08-23,Americana/SP,1,986,1,28168
1315456,2022-08-24,Americana/SP,1,987,0,28168
1321053,2022-08-25,Americana/SP,0,987,2,28170
169,2022-01-01,Amparo/SP,0,221,6,7906
5766,2022-01-02,Amparo/SP,0,221,0,7906
11363,2022-01-03,Amparo/SP,0,221,0,7906
16960,2022-01-04,Amparo/SP,0,221,8,7914
22557,2022-01-05,Amparo/SP,0,221,24,7938
28154,2022-01-06,Amparo/SP,0,221,8,7946
33751,2022-01-07,Amparo/SP,0,221,4,7950
39348,2022-01-08,Amparo/SP,0,221,0,7950
44945,2022-01-09,Amparo/SP,0,221,3,7953
50542,2022-01-10,Amparo/SP,0,221,0,7953
56139,2022-01-11,Amparo/SP,0,221,87,8040
61736,2022-01-12,Amparo/SP,0,221,51,8091
67333,2022-01-13,Amparo/SP,1,222,72,8163
72930,2022-01-14,Amparo/SP,0,222,55,8218
78527,2022-01-15,Amparo/SP,0,222,3,8221
84124,2022-01-16,Amparo/SP,0,222,0,8221
89721,2022-01-17,Amparo/SP,0,222,0,8221
95318,2022-01-18,Amparo/SP,0,222,96,8317
100915,2022-01-19,Amparo/SP,1,223,73,8390
106512,2022-01-20,Amparo/SP,1,224,65,8455
112109,2022-01-21,Amparo/SP,2,226,59,8514
117706,2022-01-22,Amparo/SP,0,226,0,8514
123303,2022-01-23,Amparo/SP,1,227,69,8583
128900,2022-01-24,Amparo/SP,0,227,0,8583
134497,2022-01-25,Amparo/SP,0,227,68,8651
140094,2022-01-26,Amparo/SP,1,228,74,8725
145691,2022-01-27,Amparo/SP,0,228,100,8825
151288,2022-01-28,Amparo/SP,1,229,90,8915
156885,2022-01-29,Amparo/SP,0,229,122,9037
162482,2022-01-30,Amparo/SP,0,229,51,9088
168079,2022-01-31,Amparo/SP,0,229,0,9088
173676,2022-02-01,Amparo/SP,0,229,112,9200
179273,2022-02-02,Amparo/SP,4,233,6,9206
184870,2022-02-03,Amparo/SP,1,234,135,9341
190467,2022-02-04,Amparo/SP,0,234,0,9341
196064,2022-02-05,Amparo/SP,4,238,180,9521
201661,2022-02-06,Amparo/SP,0,238,0,9521
207258,2022-02-07,Amparo/SP,0,238,0,9521
212855,2022-02-08,Amparo/SP,0,238,58,9579
218452,2022-02-09,Amparo/SP,0,238,65,9644
224049,2022-02-10,Amparo/SP,0,238,46,9690
229646,2022-02-11,Amparo/SP,0,238,82,9772
235243,2022-02-12,Amparo/SP,1,239,67,9839
240840,2022-02-13,Amparo/SP,0,239,0,9839
246437,2022-02-14,Amparo/SP,0,239,0,9839
252034,2022-02-15,Amparo/SP,1,240,3,9842
257631,2022-02-16,Amparo/SP,1,241,5,9847
263228,2022-02-17,Amparo/SP,0,241,0,9847
268825,2022-02-18,Amparo/SP,0,241,1,9848
274422,2022-02-19,Amparo/SP,0,241,1,9849
280019,2022-02-20,Amparo/SP,0,241,19,9868
285616,2022-02-21,Amparo/SP,0,241,0,9868
291213,2022-02-22,Amparo/SP,0,241,1,9869
296810,2022-02-23,Amparo/SP,0,241,0,9869
302407,2022-02-24,Amparo/SP,0,241,-1,9868
308004,2022-02-25,Amparo/SP,0,241,3,9871
313601,2022-02-26,Amparo/SP,1,242,3,9874
319198,2022-02-27,Amparo/SP,0,242,0,9874
324795,2022-02-28,Amparo/SP,0,242,0,9874
330392,2022-03-01,Amparo/SP,0,242,3,9877
335989,2022-03-02,Amparo/SP,0,242,1,9878
341586,2022-03-03,Amparo/SP,1,243,7,9885
347183,2022-03-04,Amparo/SP,1,244,6,9891
352780,2022-03-05,Amparo/SP,0,244,3,9894
358377,2022-03-06,Amparo/SP,0,244,0,9894
363974,2022-03-07,Amparo/SP,0,244,0,9894
369571,2022-03-08,Amparo/SP,0,244,0,9894
375168,2022-03-09,Amparo/SP,0,244,0,9894
380765,2022-03-10,Amparo/SP,0,244,3,9897
386362,2022-03-11,Amparo/SP,0,244,9,9906
391959,2022-03-12,Amparo/SP,0,244,1,9907
397556,2022-03-13,Amparo/SP,0,244,-1,9906
403153,2022-03-14,Amparo/SP,0,244,0,9906
408750,2022-03-15,Amparo/SP,0,244,1,9907
414347,2022-03-16,Amparo/SP,1,245,0,9907
419944,2022-03-17,Amparo/SP,0,245,1,9908
425541,2022-03-18,Amparo/SP,0,245,0,9908
431138,2022-03-19,Amparo/SP,0,245,1,9909
436735,2022-03-20,Amparo/SP,0,245,2,9911
442332,2022-03-21,Amparo/SP,0,245,0,9911
447929,2022-03-22,Amparo/SP,0,245,0,9911
453526,2022-03-23,Amparo/SP,0,245,0,9911
459123,2022-03-24,Amparo/SP,0,245,0,9911
464720,2022-03-25,Amparo/SP,1,246,1,9912
470317,2022-03-26,Amparo/SP,0,246,0,9912
475914,2022-03-27,Amparo/SP,0,246,0,9912
481511,2022-03-28,Amparo/SP,0,246,0,9912
487108,2022-03-29,Amparo/SP,1,247,1,9913
492705,2022-03-30,Amparo/SP,0,247,0,9913
498302,2022-03-31,Amparo/SP,0,247,-1,9912
503899,2022-04-01,Amparo/SP,0,247,0,9912
509496,2022-04-02,Amparo/SP,0,247,3,9915
515093,2022-04-03,Amparo/SP,0,247,0,9915
520690,2022-04-04,Amparo/SP,0,247,0,9915
526287,2022-04-05,Amparo/SP,0,247,0,9915
531884,2022-04-06,Amparo/SP,0,247,2,9917
537481,2022-04-07,Amparo/SP,0,247,0,9917
543078,2022-04-08,Amparo/SP,0,247,0,9917
548675,2022-04-09,Amparo/SP,0,247,0,9917
554272,2022-04-10,Amparo/SP,0,247,0,9917
559869,2022-04-11,Amparo/SP,0,247,0,9917
565466,2022-04-12,Amparo/SP,0,247,0,9917
571063,2022-04-13,Amparo/SP,0,247,1,9918
576660,2022-04-14,Amparo/SP,0,247,0,9918
582257,2022-04-15,Amparo/SP,0,247,0,9918
587854,2022-04-16,Amparo/SP,0,247,0,9918
593451,2022-04-17,Amparo/SP,0,247,0,9918
599048,2022-04-18,Amparo/SP,0,247,0,9918
604645,2022-04-19,Amparo/SP,0,247,0,9918
610242,2022-04-20,Amparo/SP,0,247,2,9920
615839,2022-04-21,Amparo/SP,0,247,0,9920
621436,2022-04-22,Amparo/SP,0,247,0,9920
627033,2022-04-23,Amparo/SP,0,247,0,9920
632630,2022-04-24,Amparo/SP,0,247,0,9920
638227,2022-04-25,Amparo/SP,0,247,0,9920
643824,2022-04-26,Amparo/SP,0,247,8,9928
649421,2022-04-27,Amparo/SP,0,247,2,9930
655018,2022-04-28,Amparo/SP,0,247,7,9937
660615,2022-04-29,Amparo/SP,0,247,2,9939
666212,2022-04-30,Amparo/SP,0,247,0,9939
671809,2022-05-01,Amparo/SP,0,247,0,9939
677406,2022-05-02,Amparo/SP,0,247,0,9939
683003,2022-05-03,Amparo/SP,0,247,0,9939
688600,2022-05-04,Amparo/SP,0,247,3,9942
694197,2022-05-05,Amparo/SP,0,247,1,9943
699794,2022-05-06,Amparo/SP,0,247,1,9944
705391,2022-05-07,Amparo/SP,0,247,1,9945
710988,2022-05-08,Amparo/SP,0,247,0,9945
716585,2022-05-09,Amparo/SP,0,247,0,9945
722182,2022-05-10,Amparo/SP,0,247,-1,9944
727779,2022-05-11,Amparo/SP,0,247,24,9968
733376,2022-05-12,Amparo/SP,0,247,2,9970
738973,2022-05-13,Amparo/SP,0,247,6,9976
744570,2022-05-14,Amparo/SP,0,247,0,9976
750167,2022-05-15,Amparo/SP,0,247,0,9976
755764,2022-05-16,Amparo/SP,0,247,0,9976
761361,2022-05-17,Amparo/SP,0,247,14,9990
766958,2022-05-18,Amparo/SP,0,247,0,9990
772555,2022-05-19,Amparo/SP,0,247,0,9990
778152,2022-05-20,Amparo/SP,0,247,0,9990
783749,2022-05-21,Amparo/SP,0,247,0,9990
789346,2022-05-22,Amparo/SP,0,247,1,9991
794943,2022-05-23,Amparo/SP,0,247,0,9991
800540,2022-05-24,Amparo/SP,0,247,1,9992
806137,2022-05-25,Amparo/SP,0,247,1,9993
811734,2022-05-26,Amparo/SP,2,249,5,9998
817331,2022-05-27,Amparo/SP,0,249,0,9998
822928,2022-05-28,Amparo/SP,0,249,1,9999
828525,2022-05-29,Amparo/SP,0,249,0,9999
834122,2022-05-30,Amparo/SP,0,249,0,9999
839719,2022-05-31,Amparo/SP,0,249,0,9999
845316,2022-06-01,Amparo/SP,0,249,1,10000
850913,2022-06-02,Amparo/SP,0,249,1,10001
856510,2022-06-03,Amparo/SP,0,249,0,10001
862107,2022-06-04,Amparo/SP,0,249,0,10001
867704,2022-06-05,Amparo/SP,0,249,0,10001
873301,2022-06-06,Amparo/SP,0,249,0,10001
878898,2022-06-07,Amparo/SP,0,249,39,10040
884495,2022-06-08,Amparo/SP,2,251,3,10043
890092,2022-06-09,Amparo/SP,0,251,0,10043
895689,2022-06-10,Amparo/SP,0,251,1,10044
901286,2022-06-11,Amparo/SP,0,251,0,10044
906883,2022-06-12,Amparo/SP,0,251,0,10044
912480,2022-06-13,Amparo/SP,0,251,0,10044
918077,2022-06-14,Amparo/SP,0,251,0,10044
923674,2022-06-15,Amparo/SP,1,252,56,10100
929271,2022-06-16,Amparo/SP,0,252,39,10139
934868,2022-06-17,Amparo/SP,0,252,0,10139
940465,2022-06-18,Amparo/SP,0,252,0,10139
946062,2022-06-19,Amparo/SP,0,252,0,10139
951659,2022-06-20,Amparo/SP,0,252,0,10139
957256,2022-06-21,Amparo/SP,0,252,0,10139
962853,2022-06-22,Amparo/SP,0,252,0,10139
968450,2022-06-23,Amparo/SP,1,253,8,10147
974047,2022-06-24,Amparo/SP,0,253,3,10150
979644,2022-06-25,Amparo/SP,0,253,-1,10149
985241,2022-06-26,Amparo/SP,0,253,0,10149
990838,2022-06-27,Amparo/SP,0,253,0,10149
996435,2022-06-28,Amparo/SP,0,253,0,10149
1002032,2022-06-29,Amparo/SP,1,254,5,10154
1007629,2022-06-30,Amparo/SP,0,254,4,10158
1013226,2022-07-01,Amparo/SP,1,255,1,10159
1018823,2022-07-02,Amparo/SP,0,255,3,10162
1024420,2022-07-03,Amparo/SP,0,255,0,10162
1030017,2022-07-04,Amparo/SP,0,255,0,10162
1035614,2022-07-05,Amparo/SP,0,255,7,10169
1041211,2022-07-06,Amparo/SP,0,255,2,10171
1046808,2022-07-07,Amparo/SP,0,255,1,10172
1052405,2022-07-08,Amparo/SP,0,255,1,10173
1058002,2022-07-09,Amparo/SP,0,255,4,10177
1063599,2022-07-10,Amparo/SP,0,255,0,10177
1069196,2022-07-11,Amparo/SP,0,255,0,10177
1074793,2022-07-12,Amparo/SP,1,256,4,10181
1080390,2022-07-13,Amparo/SP,0,256,0,10181
1085987,2022-07-14,Amparo/SP,0,256,0,10181
1091584,2022-07-15,Amparo/SP,0,256,0,10181
1097181,2022-07-16,Amparo/SP,0,256,0,10181
1102778,2022-07-17,Amparo/SP,0,256,0,10181
1108375,2022-07-18,Amparo/SP,0,256,0,10181
1113972,2022-07-19,Amparo/SP,0,256,2,10183
1119569,2022-07-20,Amparo/SP,0,256,2,10185
1125166,2022-07-21,Amparo/SP,0,256,9,10194
1130763,2022-07-22,Amparo/SP,0,256,3,10197
1136360,2022-07-23,Amparo/SP,0,256,39,10236
1141957,2022-07-24,Amparo/SP,0,256,0,10236
1147554,2022-07-25,Amparo/SP,0,256,0,10236
1153151,2022-07-26,Amparo/SP,0,256,57,10293
1158748,2022-07-27,Amparo/SP,0,256,19,10312
1164345,2022-07-28,Amparo/SP,0,256,60,10372
1169942,2022-07-29,Amparo/SP,0,256,52,10424
1175539,2022-07-30,Amparo/SP,0,256,58,10482
1181136,2022-07-31,Amparo/SP,0,256,0,10482
1186733,2022-08-01,Amparo/SP,0,256,0,10482
1192330,2022-08-02,Amparo/SP,2,258,33,10515
1197927,2022-08-03,Amparo/SP,0,258,47,10562
1203524,2022-08-04,Amparo/SP,0,258,39,10601
1209121,2022-08-05,Amparo/SP,0,258,0,10601
1214718,2022-08-06,Amparo/SP,0,258,1,10602
1220315,2022-08-07,Amparo/SP,0,258,0,10602
1225912,2022-08-08,Amparo/SP,0,258,0,10602
1231509,2022-08-09,Amparo/SP,0,258,1,10603
1237106,2022-08-10,Amparo/SP,0,258,0,10603
1242703,2022-08-11,Amparo/SP,0,258,1,10604
1248300,2022-08-12,Amparo/SP,0,258,0,10604
1253897,2022-08-13,Amparo/SP,0,258,0,10604
1259494,2022-08-14,Amparo/SP,0,258,0,10604
1265091,2022-08-15,Amparo/SP,0,258,0,10604
1270688,2022-08-16,Amparo/SP,0,258,0,10604
1276285,2022-08-17,Amparo/SP,0,258,0,10604
1281882,2022-08-18,Amparo/SP,0,258,2,10606
1287479,2022-08-19,Amparo/SP,0,258,0,10606
1293076,2022-08-20,Amparo/SP,0,258,1,10607
1298673,2022-08-21,Amparo/SP,0,258,0,10607
1304270,2022-08-22,Amparo/SP,0,258,0,10607
1309867,2022-08-23,Amparo/SP,1,259,1,10608
1315464,2022-08-24,Amparo/SP,0,259,1,10609
1321061,2022-08-25,Amparo/SP,0,259,0,10609
851,2022-01-01,Caconde/SP,0,39,0,1479
6448,2022-01-02,Caconde/SP,0,39,0,1479
12045,2022-01-03,Caconde/SP,0,39,0,1479
17642,2022-01-04,Caconde/SP,0,39,0,1479
23239,2022-01-05,Caconde/SP,0,39,6,1485
28836,2022-01-06,Caconde/SP,0,39,0,1485
34433,2022-01-07,Caconde/SP,0,39,25,1510
40030,2022-01-08,Caconde/SP,0,39,3,1513
45627,2022-01-09,Caconde/SP,0,39,0,1513
51224,2022-01-10,Caconde/SP,0,39,0,1513
56821,2022-01-11,Caconde/SP,0,39,6,1519
62418,2022-01-12,Caconde/SP,0,39,15,1534
68015,2022-01-13,Caconde/SP,0,39,24,1558
73612,2022-01-14,Caconde/SP,0,39,17,1575
79209,2022-01-15,Caconde/SP,0,39,0,1575
84806,2022-01-16,Caconde/SP,0,39,0,1575
90403,2022-01-17,Caconde/SP,0,39,0,1575
96000,2022-01-18,Caconde/SP,0,39,0,1575
101597,2022-01-19,Caconde/SP,0,39,1,1576
107194,2022-01-20,Caconde/SP,0,39,20,1596
112791,2022-01-21,Caconde/SP,0,39,28,1624
118388,2022-01-22,Caconde/SP,0,39,0,1624
123985,2022-01-23,Caconde/SP,0,39,11,1635
129582,2022-01-24,Caconde/SP,0,39,0,1635
135179,2022-01-25,Caconde/SP,0,39,44,1679
140776,2022-01-26,Caconde/SP,0,39,20,1699
146373,2022-01-27,Caconde/SP,0,39,22,1721
151970,2022-01-28,Caconde/SP,0,39,19,1740
157567,2022-01-29,Caconde/SP,0,39,24,1764
163164,2022-01-30,Caconde/SP,0,39,0,1764
168761,2022-01-31,Caconde/SP,0,39,0,1764
174358,2022-02-01,Caconde/SP,0,39,19,1783
179955,2022-02-02,Caconde/SP,0,39,0,1783
185552,2022-02-03,Caconde/SP,0,39,10,1793
191149,2022-02-04,Caconde/SP,0,39,0,1793
196746,2022-02-05,Caconde/SP,0,39,20,1813
202343,2022-02-06,Caconde/SP,0,39,0,1813
207940,2022-02-07,Caconde/SP,0,39,0,1813
213537,2022-02-08,Caconde/SP,1,40,10,1823
219134,2022-02-09,Caconde/SP,0,40,0,1823
224731,2022-02-10,Caconde/SP,0,40,44,1867
230328,2022-02-11,Caconde/SP,1,41,36,1903
235925,2022-02-12,Caconde/SP,0,41,42,1945
241522,2022-02-13,Caconde/SP,0,41,34,1979
247119,2022-02-14,Caconde/SP,0,41,0,1979
252716,2022-02-15,Caconde/SP,2,43,37,2016
258313,2022-02-16,Caconde/SP,0,43,30,2046
263910,2022-02-17,Caconde/SP,0,43,20,2066
269507,2022-02-18,Caconde/SP,0,43,84,2150
275104,2022-02-19,Caconde/SP,0,43,46,2196
280701,2022-02-20,Caconde/SP,0,43,0,2196
286298,2022-02-21,Caconde/SP,0,43,0,2196
291895,2022-02-22,Caconde/SP,0,43,45,2241
297492,2022-02-23,Caconde/SP,0,43,23,2264
303089,2022-02-24,Caconde/SP,0,43,24,2288
308686,2022-02-25,Caconde/SP,0,43,30,2318
314283,2022-02-26,Caconde/SP,0,43,45,2363
319880,2022-02-27,Caconde/SP,0,43,0,2363
325477,2022-02-28,Caconde/SP,0,43,0,2363
331074,2022-03-01,Caconde/SP,0,43,1,2364
336671,2022-03-02,Caconde/SP,0,43,0,2364
342268,2022-03-03,Caconde/SP,1,44,13,2377
347865,2022-03-04,Caconde/SP,0,44,11,2388
353462,2022-03-05,Caconde/SP,0,44,6,2394
359059,2022-03-06,Caconde/SP,0,44,0,2394
364656,2022-03-07,Caconde/SP,0,44,0,2394
370253,2022-03-08,Caconde/SP,0,44,10,2404
375850,2022-03-09,Caconde/SP,0,44,14,2418
381447,2022-03-10,Caconde/SP,0,44,1,2419
387044,2022-03-11,Caconde/SP,0,44,20,2439
392641,2022-03-12,Caconde/SP,0,44,4,2443
398238,2022-03-13,Caconde/SP,0,44,0,2443
403835,2022-03-14,Caconde/SP,1,45,0,2443
409432,2022-03-15,Caconde/SP,0,45,2,2445
415029,2022-03-16,Caconde/SP,0,45,7,2452
420626,2022-03-17,Caconde/SP,0,45,3,2455
426223,2022-03-18,Caconde/SP,0,45,0,2455
431820,2022-03-19,Caconde/SP,0,45,3,2458
437417,2022-03-20,Caconde/SP,0,45,0,2458
443014,2022-03-21,Caconde/SP,0,45,0,2458
448611,2022-03-22,Caconde/SP,0,45,1,2459
454208,2022-03-23,Caconde/SP,0,45,6,2465
459805,2022-03-24,Caconde/SP,0,45,2,2467
465402,2022-03-25,Caconde/SP,0,45,2,2469
470999,2022-03-26,Caconde/SP,0,45,0,2469
476596,2022-03-27,Caconde/SP,0,45,0,2469
482193,2022-03-28,Caconde/SP,0,45,0,2469
487790,2022-03-29,Caconde/SP,0,45,5,2474
493387,2022-03-30,Caconde/SP,0,45,9,2483
498984,2022-03-31,Caconde/SP,0,45,3,2486
504581,2022-04-01,Caconde/SP,0,45,0,2486
510178,2022-04-02,Caconde/SP,0,45,2,2488
515775,2022-04-03,Caconde/SP,0,45,0,2488
521372,2022-04-04,Caconde/SP,0,45,0,2488
526969,2022-04-05,Caconde/SP,0,45,1,2489
532566,2022-04-06,Caconde/SP,0,45,0,2489
538163,2022-04-07,Caconde/SP,0,45,2,2491
543760,2022-04-08,Caconde/SP,0,45,2,2493
549357,2022-04-09,Caconde/SP,0,45,3,2496
554954,2022-04-10,Caconde/SP,0,45,0,2496
560551,2022-04-11,Caconde/SP,0,45,0,2496
566148,2022-04-12,Caconde/SP,0,45,4,2500
571745,2022-04-13,Caconde/SP,0,45,4,2504
577342,2022-04-14,Caconde/SP,0,45,5,2509
582939,2022-04-15,Caconde/SP,0,45,0,2509
588536,2022-04-16,Caconde/SP,0,45,0,2509
594133,2022-04-17,Caconde/SP,0,45,0,2509
599730,2022-04-18,Caconde/SP,0,45,0,2509
605327,2022-04-19,Caconde/SP,0,45,0,2509
610924,2022-04-20,Caconde/SP,0,45,21,2530
616521,2022-04-21,Caconde/SP,0,45,5,2535
622118,2022-04-22,Caconde/SP,0,45,0,2535
627715,2022-04-23,Caconde/SP,0,45,0,2535
633312,2022-04-24,Caconde/SP,0,45,0,2535
638909,2022-04-25,Caconde/SP,0,45,0,2535
644506,2022-04-26,Caconde/SP,0,45,0,2535
650103,2022-04-27,Caconde/SP,0,45,7,2542
655700,2022-04-28,Caconde/SP,0,45,0,2542
661297,2022-04-29,Caconde/SP,0,45,4,2546
666894,2022-04-30,Caconde/SP,0,45,0,2546
672491,2022-05-01,Caconde/SP,0,45,0,2546
678088,2022-05-02,Caconde/SP,0,45,0,2546
683685,2022-05-03,Caconde/SP,0,45,3,2549
689282,2022-05-04,Caconde/SP,0,45,1,2550
694879,2022-05-05,Caconde/SP,0,45,1,2551
700476,2022-05-06,Caconde/SP,0,45,0,2551
706073,2022-05-07,Caconde/SP,0,45,1,2552
711670,2022-05-08,Caconde/SP,0,45,0,2552
717267,2022-05-09,Caconde/SP,0,45,0,2552
722864,2022-05-10,Caconde/SP,0,45,0,2552
728461,2022-05-11,Caconde/SP,0,45,1,2553
734058,2022-05-12,Caconde/SP,0,45,6,2559
739655,2022-05-13,Caconde/SP,0,45,7,2566
745252,2022-05-14,Caconde/SP,0,45,6,2572
750849,2022-05-15,Caconde/SP,0,45,0,2572
756446,2022-05-16,Caconde/SP,0,45,0,2572
762043,2022-05-17,Caconde/SP,0,45,6,2578
767640,2022-05-18,Caconde/SP,0,45,0,2578
773237,2022-05-19,Caconde/SP,0,45,0,2578
778834,2022-05-20,Caconde/SP,0,45,0,2578
784431,2022-05-21,Caconde/SP,0,45,0,2578
790028,2022-05-22,Caconde/SP,0,45,3,2581
795625,2022-05-23,Caconde/SP,0,45,0,2581
801222,2022-05-24,Caconde/SP,0,45,3,2584
806819,2022-05-25,Caconde/SP,0,45,21,2605
812416,2022-05-26,Caconde/SP,0,45,0,2605
818013,2022-05-27,Caconde/SP,0,45,8,2613
823610,2022-05-28,Caconde/SP,0,45,7,2620
829207,2022-05-29,Caconde/SP,0,45,2,2622
834804,2022-05-30,Caconde/SP,0,45,0,2622
840401,2022-05-31,Caconde/SP,1,46,34,2656
845998,2022-06-01,Caconde/SP,0,46,47,2703
851595,2022-06-02,Caconde/SP,0,46,10,2713
857192,2022-06-03,Caconde/SP,0,46,0,2713
862789,2022-06-04,Caconde/SP,0,46,0,2713
868386,2022-06-05,Caconde/SP,0,46,0,2713
873983,2022-06-06,Caconde/SP,0,46,0,2713
879580,2022-06-07,Caconde/SP,0,46,52,2765
885177,2022-06-08,Caconde/SP,0,46,37,2802
890774,2022-06-09,Caconde/SP,0,46,14,2816
896371,2022-06-10,Caconde/SP,0,46,9,2825
901968,2022-06-11,Caconde/SP,0,46,26,2851
907565,2022-06-12,Caconde/SP,0,46,0,2851
913162,2022-06-13,Caconde/SP,0,46,0,2851
918759,2022-06-14,Caconde/SP,0,46,0,2851
924356,2022-06-15,Caconde/SP,0,46,27,2878
929953,2022-06-16,Caconde/SP,0,46,5,2883
935550,2022-06-17,Caconde/SP,0,46,0,2883
941147,2022-06-18,Caconde/SP,0,46,0,2883
946744,2022-06-19,Caconde/SP,0,46,0,2883
952341,2022-06-20,Caconde/SP,0,46,0,2883
957938,2022-06-21,Caconde/SP,0,46,1,2884
963535,2022-06-22,Caconde/SP,0,46,9,2893
969132,2022-06-23,Caconde/SP,0,46,2,2895
974729,2022-06-24,Caconde/SP,1,47,0,2895
980326,2022-06-25,Caconde/SP,0,47,58,2953
985923,2022-06-26,Caconde/SP,0,47,0,2953
991520,2022-06-27,Caconde/SP,0,47,0,2953
997117,2022-06-28,Caconde/SP,0,47,1,2954
1002714,2022-06-29,Caconde/SP,0,47,21,2975
1008311,2022-06-30,Caconde/SP,0,47,19,2994
1013908,2022-07-01,Caconde/SP,0,47,18,3012
1019505,2022-07-02,Caconde/SP,0,47,-1,3011
1025102,2022-07-03,Caconde/SP,0,47,0,3011
1030699,2022-07-04,Caconde/SP,0,47,0,3011
1036296,2022-07-05,Caconde/SP,0,47,0,3011
1041893,2022-07-06,Caconde/SP,-1,46,40,3051
1047490,2022-07-07,Caconde/SP,0,46,24,3075
1053087,2022-07-08,Caconde/SP,0,46,1,3076
1058684,2022-07-09,Caconde/SP,0,46,11,3087
1064281,2022-07-10,Caconde/SP,0,46,0,3087
1069878,2022-07-11,Caconde/SP,0,46,0,3087
1075475,2022-07-12,Caconde/SP,0,46,11,3098
1081072,2022-07-13,Caconde/SP,0,46,13,3111
1086669,2022-07-14,Caconde/SP,0,46,3,3114
1092266,2022-07-15,Caconde/SP,0,46,8,3122
1097863,2022-07-16,Caconde/SP,0,46,6,3128
1103460,2022-07-17,Caconde/SP,0,46,0,3128
1109057,2022-07-18,Caconde/SP,0,46,0,3128
1114654,2022-07-19,Caconde/SP,0,46,12,3140
1120251,2022-07-20,Caconde/SP,0,46,0,3140
1125848,2022-07-21,Caconde/SP,0,46,3,3143
1131445,2022-07-22,Caconde/SP,0,46,38,3181
1137042,2022-07-23,Caconde/SP,0,46,6,3187
1142639,2022-07-24,Caconde/SP,0,46,0,3187
1148236,2022-07-25,Caconde/SP,0,46,0,3187
1153833,2022-07-26,Caconde/SP,0,46,12,3199
1159430,2022-07-27,Caconde/SP,0,46,6,3205
1165027,2022-07-28,Caconde/SP,0,46,3,3208
1170624,2022-07-29,Caconde/SP,0,46,2,3210
1176221,2022-07-30,Caconde/SP,0,46,0,3210
1181818,2022-07-31,Caconde/SP,0,46,0,3210
1187415,2022-08-01,Caconde/SP,0,46,0,3210
1193012,2022-08-02,Caconde/SP,0,46,13,3223
1198609,2022-08-03,Caconde/SP,0,46,13,3236
1204206,2022-08-04,Caconde/SP,0,46,2,3238
1209803,2022-08-05,Caconde/SP,0,46,21,3259
1215400,2022-08-06,Caconde/SP,0,46,9,3268
1220997,2022-08-07,Caconde/SP,0,46,0,3268
1226594,2022-08-08,Caconde/SP,0,46,0,3268
1232191,2022-08-09,Caconde/SP,0,46,11,3279
1237788,2022-08-10,Caconde/SP,0,46,3,3282
1243385,2022-08-11,Caconde/SP,0,46,0,3282
1248982,2022-08-12,Caconde/SP,0,46,0,3282
1254579,2022-08-13,Caconde/SP,0,46,5,3287
1260176,2022-08-14,Caconde/SP,0,46,0,3287
1265773,2022-08-15,Caconde/SP,0,46,0,3287
1271370,2022-08-16,Caconde/SP,0,46,0,3287
1276967,2022-08-17,Caconde/SP,0,46,3,3290
1282564,2022-08-18,Caconde/SP,0,46,2,3292
1288161,2022-08-19,Caconde/SP,0,46,6,3298
1293758,2022-08-20,Caconde/SP,0,46,2,3300
1299355,2022-08-21,Caconde/SP,0,46,0,3300
1304952,2022-08-22,Caconde/SP,0,46,0,3300
1310549,2022-08-23,Caconde/SP,0,46,4,3304
1316146,2022-08-24,Caconde/SP,0,46,2,3306
1321743,2022-08-25,Caconde/SP,0,46,0,3306
936,2022-01-01,Campinas/SP,0,4632,-1,117413
6533,2022-01-02,Campinas/SP,0,4632,2,117415
12130,2022-01-03,Campinas/SP,0,4632,1,117416
17727,2022-01-04,Campinas/SP,1,4633,35,117451
23324,2022-01-05,Campinas/SP,0,4633,113,117564
28921,2022-01-06,Campinas/SP,1,4634,23,117587
34518,2022-01-07,Campinas/SP,0,4634,126,117713
40115,2022-01-08,Campinas/SP,0,4634,152,117865
45712,2022-01-09,Campinas/SP,0,4634,43,117908
51309,2022-01-10,Campinas/SP,0,4634,44,117952
56906,2022-01-11,Campinas/SP,0,4634,145,118097
62503,2022-01-12,Campinas/SP,1,4635,102,118199
68100,2022-01-13,Campinas/SP,2,4637,151,118350
73697,2022-01-14,Campinas/SP,4,4641,361,118711
79294,2022-01-15,Campinas/SP,0,4641,6,118717
84891,2022-01-16,Campinas/SP,0,4641,11,118728
90488,2022-01-17,Campinas/SP,0,4641,2,118730
96085,2022-01-18,Campinas/SP,4,4645,327,119057
101682,2022-01-19,Campinas/SP,2,4647,346,119403
107279,2022-01-20,Campinas/SP,8,4655,465,119868
112876,2022-01-21,Campinas/SP,3,4658,317,120185
118473,2022-01-22,Campinas/SP,0,4658,0,120185
124070,2022-01-23,Campinas/SP,6,4664,377,120562
129667,2022-01-24,Campinas/SP,1,4665,34,120596
135264,2022-01-25,Campinas/SP,3,4668,417,121013
140861,2022-01-26,Campinas/SP,3,4671,207,121220
146458,2022-01-27,Campinas/SP,8,4679,146,121366
152055,2022-01-28,Campinas/SP,7,4686,244,121610
157652,2022-01-29,Campinas/SP,11,4697,209,121819
163249,2022-01-30,Campinas/SP,1,4698,1281,123100
168846,2022-01-31,Campinas/SP,0,4698,0,123100
174443,2022-02-01,Campinas/SP,12,4710,649,123749
180040,2022-02-02,Campinas/SP,13,4723,45,123794
185637,2022-02-03,Campinas/SP,12,4735,2101,125895
191234,2022-02-04,Campinas/SP,0,4735,0,125895
196831,2022-02-05,Campinas/SP,22,4757,1135,127030
202428,2022-02-06,Campinas/SP,2,4759,13,127043
208025,2022-02-07,Campinas/SP,0,4759,19,127062
213622,2022-02-08,Campinas/SP,22,4781,460,127522
219219,2022-02-09,Campinas/SP,20,4801,150,127672
224816,2022-02-10,Campinas/SP,13,4814,93,127765
230413,2022-02-11,Campinas/SP,17,4831,366,128131
236010,2022-02-12,Campinas/SP,17,4848,290,128421
241607,2022-02-13,Campinas/SP,4,4852,95,128516
247204,2022-02-14,Campinas/SP,0,4852,14,128530
252801,2022-02-15,Campinas/SP,14,4866,294,128824
258398,2022-02-16,Campinas/SP,5,4871,675,129499
263995,2022-02-17,Campinas/SP,6,4877,635,130134
269592,2022-02-18,Campinas/SP,3,4880,167,130301
275189,2022-02-19,Campinas/SP,6,4886,463,130764
280786,2022-02-20,Campinas/SP,1,4887,38,130802
286383,2022-02-21,Campinas/SP,0,4887,1,130803
291980,2022-02-22,Campinas/SP,7,4894,290,131093
297577,2022-02-23,Campinas/SP,12,4906,304,131397
303174,2022-02-24,Campinas/SP,6,4912,250,131647
308771,2022-02-25,Campinas/SP,5,4917,125,131772
314368,2022-02-26,Campinas/SP,18,4935,132,131904
319965,2022-02-27,Campinas/SP,0,4935,7,131911
325562,2022-02-28,Campinas/SP,0,4935,1,131912
331159,2022-03-01,Campinas/SP,1,4936,11,131923
336756,2022-03-02,Campinas/SP,0,4936,4,131927
342353,2022-03-03,Campinas/SP,10,4946,84,132011
347950,2022-03-04,Campinas/SP,9,4955,417,132428
353547,2022-03-05,Campinas/SP,2,4957,189,132617
359144,2022-03-06,Campinas/SP,0,4957,14,132631
364741,2022-03-07,Campinas/SP,0,4957,8,132639
370338,2022-03-08,Campinas/SP,7,4964,118,132757
375935,2022-03-09,Campinas/SP,6,4970,96,132853
381532,2022-03-10,Campinas/SP,5,4975,130,132983
387129,2022-03-11,Campinas/SP,0,4975,699,133682
392726,2022-03-12,Campinas/SP,5,4980,818,134500
398323,2022-03-13,Campinas/SP,0,4980,1315,135815
403920,2022-03-14,Campinas/SP,5,4985,469,136284
409517,2022-03-15,Campinas/SP,1,4986,1616,137900
415114,2022-03-16,Campinas/SP,8,4994,791,138691
420711,2022-03-17,Campinas/SP,-1,4993,1086,139777
426308,2022-03-18,Campinas/SP,4,4997,1077,140854
431905,2022-03-19,Campinas/SP,3,5000,977,141831
437502,2022-03-20,Campinas/SP,0,5000,1703,143534
443099,2022-03-21,Campinas/SP,0,5000,259,143793
448696,2022-03-22,Campinas/SP,1,5001,1444,145237
454293,2022-03-23,Campinas/SP,6,5007,1164,146401
459890,2022-03-24,Campinas/SP,2,5009,1024,147425
465487,2022-03-25,Campinas/SP,4,5013,928,148353
471084,2022-03-26,Campinas/SP,1,5014,1124,149477
476681,2022-03-27,Campinas/SP,0,5014,40,149517
482278,2022-03-28,Campinas/SP,0,5014,116,149633
487875,2022-03-29,Campinas/SP,4,5018,461,150094
493472,2022-03-30,Campinas/SP,2,5020,481,150575
499069,2022-03-31,Campinas/SP,3,5023,555,151130
504666,2022-04-01,Campinas/SP,5,5028,477,151607
510263,2022-04-02,Campinas/SP,4,5032,882,152489
515860,2022-04-03,Campinas/SP,0,5032,925,153414
521457,2022-04-04,Campinas/SP,1,5033,69,153483
527054,2022-04-05,Campinas/SP,2,5035,358,153841
532651,2022-04-06,Campinas/SP,3,5038,68,153909
538248,2022-04-07,Campinas/SP,6,5044,117,154026
543845,2022-04-08,Campinas/SP,6,5050,72,154098
549442,2022-04-09,Campinas/SP,0,5050,146,154244
555039,2022-04-10,Campinas/SP,0,5050,8,154252
560636,2022-04-11,Campinas/SP,0,5050,0,154252
566233,2022-04-12,Campinas/SP,2,5052,463,154715
571830,2022-04-13,Campinas/SP,4,5056,206,154921
577427,2022-04-14,Campinas/SP,3,5059,125,155046
583024,2022-04-15,Campinas/SP,3,5062,392,155438
588621,2022-04-16,Campinas/SP,0,5062,0,155438
594218,2022-04-17,Campinas/SP,0,5062,0,155438
599815,2022-04-18,Campinas/SP,1,5063,0,155438
605412,2022-04-19,Campinas/SP,0,5063,0,155438
611009,2022-04-20,Campinas/SP,1,5064,1009,156447
616606,2022-04-21,Campinas/SP,0,5064,447,156894
622203,2022-04-22,Campinas/SP,0,5064,14,156908
627800,2022-04-23,Campinas/SP,0,5064,3,156911
633397,2022-04-24,Campinas/SP,0,5064,1,156912
638994,2022-04-25,Campinas/SP,0,5064,-1,156911
644591,2022-04-26,Campinas/SP,0,5064,150,157061
650188,2022-04-27,Campinas/SP,1,5065,173,157234
655785,2022-04-28,Campinas/SP,0,5065,181,157415
661382,2022-04-29,Campinas/SP,2,5067,169,157584
666979,2022-04-30,Campinas/SP,0,5067,358,157942
672576,2022-05-01,Campinas/SP,0,5067,1361,159303
678173,2022-05-02,Campinas/SP,0,5067,420,159723
683770,2022-05-03,Campinas/SP,2,5069,1274,160997
689367,2022-05-04,Campinas/SP,3,5072,1052,162049
694964,2022-05-05,Campinas/SP,0,5072,645,162694
700561,2022-05-06,Campinas/SP,0,5072,696,163390
706158,2022-05-07,Campinas/SP,0,5072,428,163818
711755,2022-05-08,Campinas/SP,0,5072,952,164770
717352,2022-05-09,Campinas/SP,0,5072,207,164977
722949,2022-05-10,Campinas/SP,1,5073,458,165435
728546,2022-05-11,Campinas/SP,4,5077,291,165726
734143,2022-05-12,Campinas/SP,2,5079,499,166225
739740,2022-05-13,Campinas/SP,2,5081,514,166739
745337,2022-05-14,Campinas/SP,0,5081,183,166922
750934,2022-05-15,Campinas/SP,0,5081,488,167410
756531,2022-05-16,Campinas/SP,0,5081,484,167894
762128,2022-05-17,Campinas/SP,1,5082,177,168071
767725,2022-05-18,Campinas/SP,0,5082,55,168126
773322,2022-05-19,Campinas/SP,1,5083,17,168143
778919,2022-05-20,Campinas/SP,0,5083,0,168143
784516,2022-05-21,Campinas/SP,0,5083,0,168143
790113,2022-05-22,Campinas/SP,3,5086,460,168603
795710,2022-05-23,Campinas/SP,0,5086,125,168728
801307,2022-05-24,Campinas/SP,2,5088,248,168976
806904,2022-05-25,Campinas/SP,1,5089,315,169291
812501,2022-05-26,Campinas/SP,1,5090,520,169811
818098,2022-05-27,Campinas/SP,2,5092,74,169885
823695,2022-05-28,Campinas/SP,1,5093,252,170137
829292,2022-05-29,Campinas/SP,0,5093,262,170399
834889,2022-05-30,Campinas/SP,0,5093,103,170502
840486,2022-05-31,Campinas/SP,3,5096,480,170982
846083,2022-06-01,Campinas/SP,2,5098,673,171655
851680,2022-06-02,Campinas/SP,2,5100,640,172295
857277,2022-06-03,Campinas/SP,0,5100,0,172295
862874,2022-06-04,Campinas/SP,0,5100,0,172295
868471,2022-06-05,Campinas/SP,0,5100,0,172295
874068,2022-06-06,Campinas/SP,0,5100,0,172295
879665,2022-06-07,Campinas/SP,4,5104,1696,173991
885262,2022-06-08,Campinas/SP,0,5104,513,174504
890859,2022-06-09,Campinas/SP,2,5106,163,174667
896456,2022-06-10,Campinas/SP,1,5107,236,174903
902053,2022-06-11,Campinas/SP,0,5107,205,175108
907650,2022-06-12,Campinas/SP,0,5107,202,175310
913247,2022-06-13,Campinas/SP,0,5107,7,175317
918844,2022-06-14,Campinas/SP,0,5107,0,175317
924441,2022-06-15,Campinas/SP,6,5113,932,176249
930038,2022-06-16,Campinas/SP,7,5120,187,176436
935635,2022-06-17,Campinas/SP,0,5120,40,176476
941232,2022-06-18,Campinas/SP,0,5120,107,176583
946829,2022-06-19,Campinas/SP,1,5121,24,176607
952426,2022-06-20,Campinas/SP,0,5121,1,176608
958023,2022-06-21,Campinas/SP,1,5122,317,176925
963620,2022-06-22,Campinas/SP,0,5122,199,177124
969217,2022-06-23,Campinas/SP,10,5132,335,177459
974814,2022-06-24,Campinas/SP,4,5136,15,177474
980411,2022-06-25,Campinas/SP,2,5138,810,178284
986008,2022-06-26,Campinas/SP,0,5138,18,178302
991605,2022-06-27,Campinas/SP,0,5138,1,178303
997202,2022-06-28,Campinas/SP,2,5140,375,178678
1002799,2022-06-29,Campinas/SP,1,5141,412,179090
1008396,2022-06-30,Campinas/SP,5,5146,691,179781
1013993,2022-07-01,Campinas/SP,3,5149,300,180081
1019590,2022-07-02,Campinas/SP,3,5152,249,180330
1025187,2022-07-03,Campinas/SP,1,5153,131,180461
1030784,2022-07-04,Campinas/SP,0,5153,1,180462
1036381,2022-07-05,Campinas/SP,5,5158,201,180663
1041978,2022-07-06,Campinas/SP,6,5164,333,180996
1047575,2022-07-07,Campinas/SP,7,5171,610,181606
1053172,2022-07-08,Campinas/SP,2,5173,131,181737
1058769,2022-07-09,Campinas/SP,7,5180,158,181895
1064366,2022-07-10,Campinas/SP,0,5180,16,181911
1069963,2022-07-11,Campinas/SP,0,5180,3,181914
1075560,2022-07-12,Campinas/SP,6,5186,259,182173
1081157,2022-07-13,Campinas/SP,4,5190,322,182495
1086754,2022-07-14,Campinas/SP,2,5192,116,182611
1092351,2022-07-15,Campinas/SP,6,5198,236,182847
1097948,2022-07-16,Campinas/SP,6,5204,255,183102
1103545,2022-07-17,Campinas/SP,1,5205,16,183118
1109142,2022-07-18,Campinas/SP,0,5205,9,183127
1114739,2022-07-19,Campinas/SP,7,5212,316,183443
1120336,2022-07-20,Campinas/SP,2,5214,459,183902
1125933,2022-07-21,Campinas/SP,8,5222,221,184123
1131530,2022-07-22,Campinas/SP,1,5223,230,184353
1137127,2022-07-23,Campinas/SP,3,5226,221,184574
1142724,2022-07-24,Campinas/SP,0,5226,-1,184573
1148321,2022-07-25,Campinas/SP,0,5226,0,184573
1153918,2022-07-26,Campinas/SP,5,5231,184,184757
1159515,2022-07-27,Campinas/SP,3,5234,311,185068
1165112,2022-07-28,Campinas/SP,2,5236,231,185299
1170709,2022-07-29,Campinas/SP,1,5237,88,185387
1176306,2022-07-30,Campinas/SP,1,5238,202,185589
1181903,2022-07-31,Campinas/SP,0,5238,5,185594
1187500,2022-08-01,Campinas/SP,0,5238,1,185595
1193097,2022-08-02,Campinas/SP,7,5245,228,185823
1198694,2022-08-03,Campinas/SP,1,5246,171,185994
1204291,2022-08-04,Campinas/SP,3,5249,202,186196
1209888,2022-08-05,Campinas/SP,2,5251,178,186374
1215485,2022-08-06,Campinas/SP,2,5253,238,186612
1221082,2022-08-07,Campinas/SP,0,5253,2,186614
1226679,2022-08-08,Campinas/SP,0,5253,0,186614
1232276,2022-08-09,Campinas/SP,2,5255,125,186739
1237873,2022-08-10,Campinas/SP,1,5256,130,186869
1243470,2022-08-11,Campinas/SP,0,5256,135,187004
1249067,2022-08-12,Campinas/SP,4,5260,41,187045
1254664,2022-08-13,Campinas/SP,1,5261,31,187076
1260261,2022-08-14,Campinas/SP,0,5261,3,187079
1265858,2022-08-15,Campinas/SP,0,5261,1,187080
1271455,2022-08-16,Campinas/SP,2,5263,185,187265
1277052,2022-08-17,Campinas/SP,4,5267,106,187371
1282649,2022-08-18,Campinas/SP,0,5267,104,187475
1288246,2022-08-19,Campinas/SP,1,5268,43,187518
1293843,2022-08-20,Campinas/SP,0,5268,226,187744
1299440,2022-08-21,Campinas/SP,0,5268,1,187745
1305037,2022-08-22,Campinas/SP,0,5268,0,187745
1310634,2022-08-23,Campinas/SP,1,5269,107,187852
1316231,2022-08-24,Campinas/SP,1,5270,108,187960
1321828,2022-08-25,Campinas/SP,0,5270,122,188082
1135,2022-01-01,Casa Branca/SP,0,109,0,3300
6732,2022-01-02,Casa Branca/SP,0,109,0,3300
12329,2022-01-03,Casa Branca/SP,0,109,0,3300
17926,2022-01-04,Casa Branca/SP,0,109,6,3306
23523,2022-01-05,Casa Branca/SP,0,109,0,3306
29120,2022-01-06,Casa Branca/SP,0,109,22,3328
34717,2022-01-07,Casa Branca/SP,0,109,0,3328
40314,2022-01-08,Casa Branca/SP,0,109,0,3328
45911,2022-01-09,Casa Branca/SP,0,109,0,3328
51508,2022-01-10,Casa Branca/SP,0,109,0,3328
57105,2022-01-11,Casa Branca/SP,0,109,0,3328
62702,2022-01-12,Casa Branca/SP,0,109,0,3328
68299,2022-01-13,Casa Branca/SP,0,109,43,3371
73896,2022-01-14,Casa Branca/SP,0,109,29,3400
79493,2022-01-15,Casa Branca/SP,0,109,0,3400
85090,2022-01-16,Casa Branca/SP,0,109,0,3400
90687,2022-01-17,Casa Branca/SP,0,109,0,3400
96284,2022-01-18,Casa Branca/SP,0,109,27,3427
101881,2022-01-19,Casa Branca/SP,0,109,62,3489
107478,2022-01-20,Casa Branca/SP,0,109,100,3589
113075,2022-01-21,Casa Branca/SP,0,109,61,3650
118672,2022-01-22,Casa Branca/SP,0,109,0,3650
124269,2022-01-23,Casa Branca/SP,0,109,54,3704
129866,2022-01-24,Casa Branca/SP,0,109,0,3704
135463,2022-01-25,Casa Branca/SP,0,109,9,3713
141060,2022-01-26,Casa Branca/SP,0,109,54,3767
146657,2022-01-27,Casa Branca/SP,0,109,94,3861
152254,2022-01-28,Casa Branca/SP,1,110,50,3911
157851,2022-01-29,Casa Branca/SP,0,110,16,3927
163448,2022-01-30,Casa Branca/SP,0,110,1,3928
169045,2022-01-31,Casa Branca/SP,0,110,0,3928
174642,2022-02-01,Casa Branca/SP,0,110,15,3943
180239,2022-02-02,Casa Branca/SP,0,110,0,3943
185836,2022-02-03,Casa Branca/SP,0,110,72,4015
191433,2022-02-04,Casa Branca/SP,0,110,0,4015
197030,2022-02-05,Casa Branca/SP,0,110,64,4079
202627,2022-02-06,Casa Branca/SP,0,110,0,4079
208224,2022-02-07,Casa Branca/SP,0,110,0,4079
213821,2022-02-08,Casa Branca/SP,0,110,24,4103
219418,2022-02-09,Casa Branca/SP,0,110,82,4185
225015,2022-02-10,Casa Branca/SP,0,110,43,4228
230612,2022-02-11,Casa Branca/SP,0,110,4,4232
236209,2022-02-12,Casa Branca/SP,1,111,45,4277
241806,2022-02-13,Casa Branca/SP,0,111,0,4277
247403,2022-02-14,Casa Branca/SP,0,111,0,4277
253000,2022-02-15,Casa Branca/SP,0,111,41,4318
258597,2022-02-16,Casa Branca/SP,0,111,14,4332
264194,2022-02-17,Casa Branca/SP,0,111,57,4389
269791,2022-02-18,Casa Branca/SP,0,111,46,4435
275388,2022-02-19,Casa Branca/SP,0,111,3,4438
280985,2022-02-20,Casa Branca/SP,0,111,0,4438
286582,2022-02-21,Casa Branca/SP,0,111,1,4439
292179,2022-02-22,Casa Branca/SP,0,111,40,4479
297776,2022-02-23,Casa Branca/SP,0,111,39,4518
303373,2022-02-24,Casa Branca/SP,0,111,23,4541
308970,2022-02-25,Casa Branca/SP,1,112,19,4560
314567,2022-02-26,Casa Branca/SP,0,112,18,4578
320164,2022-02-27,Casa Branca/SP,0,112,1,4579
325761,2022-02-28,Casa Branca/SP,0,112,0,4579
331358,2022-03-01,Casa Branca/SP,0,112,0,4579
336955,2022-03-02,Casa Branca/SP,0,112,0,4579
342552,2022-03-03,Casa Branca/SP,0,112,30,4609
348149,2022-03-04,Casa Branca/SP,0,112,8,4617
353746,2022-03-05,Casa Branca/SP,0,112,9,4626
359343,2022-03-06,Casa Branca/SP,0,112,0,4626
364940,2022-03-07,Casa Branca/SP,0,112,0,4626
370537,2022-03-08,Casa Branca/SP,0,112,24,4650
376134,2022-03-09,Casa Branca/SP,1,113,4,4654
381731,2022-03-10,Casa Branca/SP,2,115,9,4663
387328,2022-03-11,Casa Branca/SP,0,115,3,4666
392925,2022-03-12,Casa Branca/SP,0,115,8,4674
398522,2022-03-13,Casa Branca/SP,0,115,0,4674
404119,2022-03-14,Casa Branca/SP,0,115,0,4674
409716,2022-03-15,Casa Branca/SP,0,115,16,4690
415313,2022-03-16,Casa Branca/SP,2,117,10,4700
420910,2022-03-17,Casa Branca/SP,2,119,14,4714
426507,2022-03-18,Casa Branca/SP,0,119,1,4715
432104,2022-03-19,Casa Branca/SP,0,119,2,4717
437701,2022-03-20,Casa Branca/SP,0,119,0,4717
443298,2022-03-21,Casa Branca/SP,0,119,0,4717
448895,2022-03-22,Casa Branca/SP,0,119,10,4727
454492,2022-03-23,Casa Branca/SP,0,119,3,4730
460089,2022-03-24,Casa Branca/SP,0,119,2,4732
465686,2022-03-25,Casa Branca/SP,0,119,8,4740
471283,2022-03-26,Casa Branca/SP,1,120,4,4744
476880,2022-03-27,Casa Branca/SP,0,120,0,4744
482477,2022-03-28,Casa Branca/SP,0,120,0,4744
488074,2022-03-29,Casa Branca/SP,0,120,4,4748
493671,2022-03-30,Casa Branca/SP,0,120,1,4749
499268,2022-03-31,Casa Branca/SP,0,120,2,4751
504865,2022-04-01,Casa Branca/SP,0,120,1,4752
510462,2022-04-02,Casa Branca/SP,0,120,2,4754
516059,2022-04-03,Casa Branca/SP,0,120,0,4754
521656,2022-04-04,Casa Branca/SP,0,120,0,4754
527253,2022-04-05,Casa Branca/SP,0,120,1,4755
532850,2022-04-06,Casa Branca/SP,0,120,1,4756
538447,2022-04-07,Casa Branca/SP,0,120,0,4756
544044,2022-04-08,Casa Branca/SP,0,120,0,4756
549641,2022-04-09,Casa Branca/SP,0,120,0,4756
555238,2022-04-10,Casa Branca/SP,0,120,0,4756
560835,2022-04-11,Casa Branca/SP,0,120,0,4756
566432,2022-04-12,Casa Branca/SP,0,120,2,4758
572029,2022-04-13,Casa Branca/SP,0,120,7,4765
577626,2022-04-14,Casa Branca/SP,0,120,1,4766
583223,2022-04-15,Casa Branca/SP,0,120,7,4773
588820,2022-04-16,Casa Branca/SP,0,120,0,4773
594417,2022-04-17,Casa Branca/SP,0,120,0,4773
600014,2022-04-18,Casa Branca/SP,0,120,0,4773
605611,2022-04-19,Casa Branca/SP,0,120,0,4773
611208,2022-04-20,Casa Branca/SP,0,120,3,4776
616805,2022-04-21,Casa Branca/SP,0,120,0,4776
622402,2022-04-22,Casa Branca/SP,0,120,0,4776
627999,2022-04-23,Casa Branca/SP,0,120,0,4776
633596,2022-04-24,Casa Branca/SP,0,120,0,4776
639193,2022-04-25,Casa Branca/SP,0,120,0,4776
644790,2022-04-26,Casa Branca/SP,0,120,8,4784
650387,2022-04-27,Casa Branca/SP,0,120,3,4787
655984,2022-04-28,Casa Branca/SP,0,120,4,4791
661581,2022-04-29,Casa Branca/SP,0,120,1,4792
667178,2022-04-30,Casa Branca/SP,0,120,2,4794
672775,2022-05-01,Casa Branca/SP,0,120,0,4794
678372,2022-05-02,Casa Branca/SP,0,120,0,4794
683969,2022-05-03,Casa Branca/SP,0,120,17,4811
689566,2022-05-04,Casa Branca/SP,0,120,5,4816
695163,2022-05-05,Casa Branca/SP,0,120,7,4823
700760,2022-05-06,Casa Branca/SP,0,120,2,4825
706357,2022-05-07,Casa Branca/SP,0,120,8,4833
711954,2022-05-08,Casa Branca/SP,0,120,0,4833
717551,2022-05-09,Casa Branca/SP,0,120,0,4833
723148,2022-05-10,Casa Branca/SP,0,120,13,4846
728745,2022-05-11,Casa Branca/SP,0,120,9,4855
734342,2022-05-12,Casa Branca/SP,0,120,4,4859
739939,2022-05-13,Casa Branca/SP,0,120,2,4861
745536,2022-05-14,Casa Branca/SP,0,120,14,4875
751133,2022-05-15,Casa Branca/SP,0,120,0,4875
756730,2022-05-16,Casa Branca/SP,0,120,0,4875
762327,2022-05-17,Casa Branca/SP,0,120,5,4880
767924,2022-05-18,Casa Branca/SP,0,120,25,4905
773521,2022-05-19,Casa Branca/SP,0,120,9,4914
779118,2022-05-20,Casa Branca/SP,0,120,0,4914
784715,2022-05-21,Casa Branca/SP,0,120,0,4914
790312,2022-05-22,Casa Branca/SP,0,120,20,4934
795909,2022-05-23,Casa Branca/SP,0,120,0,4934
801506,2022-05-24,Casa Branca/SP,0,120,21,4955
807103,2022-05-25,Casa Branca/SP,0,120,26,4981
812700,2022-05-26,Casa Branca/SP,0,120,13,4994
818297,2022-05-27,Casa Branca/SP,0,120,12,5006
823894,2022-05-28,Casa Branca/SP,0,120,7,5013
829491,2022-05-29,Casa Branca/SP,0,120,3,5016
835088,2022-05-30,Casa Branca/SP,0,120,0,5016
840685,2022-05-31,Casa Branca/SP,0,120,21,5037
846282,2022-06-01,Casa Branca/SP,0,120,22,5059
851879,2022-06-02,Casa Branca/SP,0,120,2,5061
857476,2022-06-03,Casa Branca/SP,0,120,0,5061
863073,2022-06-04,Casa Branca/SP,0,120,0,5061
868670,2022-06-05,Casa Branca/SP,0,120,0,5061
874267,2022-06-06,Casa Branca/SP,0,120,0,5061
879864,2022-06-07,Casa Branca/SP,1,121,69,5130
885461,2022-06-08,Casa Branca/SP,1,122,5,5135
891058,2022-06-09,Casa Branca/SP,0,122,3,5138
896655,2022-06-10,Casa Branca/SP,0,122,12,5150
902252,2022-06-11,Casa Branca/SP,0,122,19,5169
907849,2022-06-12,Casa Branca/SP,0,122,0,5169
913446,2022-06-13,Casa Branca/SP,0,122,0,5169
919043,2022-06-14,Casa Branca/SP,0,122,0,5169
924640,2022-06-15,Casa Branca/SP,0,122,26,5195
930237,2022-06-16,Casa Branca/SP,0,122,17,5212
935834,2022-06-17,Casa Branca/SP,0,122,0,5212
941431,2022-06-18,Casa Branca/SP,0,122,0,5212
947028,2022-06-19,Casa Branca/SP,0,122,0,5212
952625,2022-06-20,Casa Branca/SP,0,122,0,5212
958222,2022-06-21,Casa Branca/SP,0,122,36,5248
963819,2022-06-22,Casa Branca/SP,0,122,12,5260
969416,2022-06-23,Casa Branca/SP,0,122,7,5267
975013,2022-06-24,Casa Branca/SP,0,122,0,5267
980610,2022-06-25,Casa Branca/SP,0,122,31,5298
986207,2022-06-26,Casa Branca/SP,0,122,0,5298
991804,2022-06-27,Casa Branca/SP,0,122,0,5298
997401,2022-06-28,Casa Branca/SP,0,122,33,5331
1002998,2022-06-29,Casa Branca/SP,0,122,24,5355
1008595,2022-06-30,Casa Branca/SP,0,122,17,5372
1014192,2022-07-01,Casa Branca/SP,0,122,0,5372
1019789,2022-07-02,Casa Branca/SP,0,122,15,5387
1025386,2022-07-03,Casa Branca/SP,0,122,0,5387
1030983,2022-07-04,Casa Branca/SP,0,122,0,5387
1036580,2022-07-05,Casa Branca/SP,0,122,41,5428
1042177,2022-07-06,Casa Branca/SP,1,123,18,5446
1047774,2022-07-07,Casa Branca/SP,0,123,28,5474
1053371,2022-07-08,Casa Branca/SP,0,123,12,5486
1058968,2022-07-09,Casa Branca/SP,0,123,29,5515
1064565,2022-07-10,Casa Branca/SP,0,123,0,5515
1070162,2022-07-11,Casa Branca/SP,0,123,0,5515
1075759,2022-07-12,Casa Branca/SP,0,123,28,5543
1081356,2022-07-13,Casa Branca/SP,0,123,31,5574
1086953,2022-07-14,Casa Branca/SP,0,123,18,5592
1092550,2022-07-15,Casa Branca/SP,0,123,14,5606
1098147,2022-07-16,Casa Branca/SP,1,124,15,5621
1103744,2022-07-17,Casa Branca/SP,0,124,0,5621
1109341,2022-07-18,Casa Branca/SP,0,124,0,5621
1114938,2022-07-19,Casa Branca/SP,0,124,26,5647
1120535,2022-07-20,Casa Branca/SP,0,124,11,5658
1126132,2022-07-21,Casa Branca/SP,0,124,11,5669
1131729,2022-07-22,Casa Branca/SP,0,124,13,5682
1137326,2022-07-23,Casa Branca/SP,0,124,20,5702
1142923,2022-07-24,Casa Branca/SP,0,124,0,5702
1148520,2022-07-25,Casa Branca/SP,0,124,0,5702
1154117,2022-07-26,Casa Branca/SP,1,125,23,5725
1159714,2022-07-27,Casa Branca/SP,0,125,17,5742
1165311,2022-07-28,Casa Branca/SP,0,125,7,5749
1170908,2022-07-29,Casa Branca/SP,0,125,16,5765
1176505,2022-07-30,Casa Branca/SP,0,125,15,5780
1182102,2022-07-31,Casa Branca/SP,0,125,0,5780
1187699,2022-08-01,Casa Branca/SP,0,125,0,5780
1193296,2022-08-02,Casa Branca/SP,0,125,16,5796
1198893,2022-08-03,Casa Branca/SP,0,125,6,5802
1204490,2022-08-04,Casa Branca/SP,0,125,19,5821
1210087,2022-08-05,Casa Branca/SP,0,125,12,5833
1215684,2022-08-06,Casa Branca/SP,0,125,7,5840
1221281,2022-08-07,Casa Branca/SP,0,125,0,5840
1226878,2022-08-08,Casa Branca/SP,0,125,0,5840
1232475,2022-08-09,Casa Branca/SP,0,125,23,5863
1238072,2022-08-10,Casa Branca/SP,0,125,8,5871
1243669,2022-08-11,Casa Branca/SP,0,125,3,5874
1249266,2022-08-12,Casa Branca/SP,0,125,4,5878
1254863,2022-08-13,Casa Branca/SP,2,127,6,5884
1260460,2022-08-14,Casa Branca/SP,0,127,0,5884
1266057,2022-08-15,Casa Branca/SP,0,127,0,5884
1271654,2022-08-16,Casa Branca/SP,0,127,10,5894
1277251,2022-08-17,Casa Branca/SP,1,128,10,5904
1282848,2022-08-18,Casa Branca/SP,0,128,5,5909
1288445,2022-08-19,Casa Branca/SP,0,128,5,5914
1294042,2022-08-20,Casa Branca/SP,1,129,2,5916
1299639,2022-08-21,Casa Branca/SP,0,129,0,5916
1305236,2022-08-22,Casa Branca/SP,0,129,0,5916
1310833,2022-08-23,Casa Branca/SP,1,130,1,5917
1316430,2022-08-24,Casa Branca/SP,0,130,0,5917
1322027,2022-08-25,Casa Branca/SP,0,130,5,5922
1563,2022-01-01,Divinolândia/SP,0,48,0,1383
7160,2022-01-02,Divinolândia/SP,0,48,0,1383
12757,2022-01-03,Divinolândia/SP,0,48,0,1383
18354,2022-01-04,Divinolândia/SP,0,48,0,1383
23951,2022-01-05,Divinolândia/SP,0,48,0,1383
29548,2022-01-06,Divinolândia/SP,0,48,0,1383
35145,2022-01-07,Divinolândia/SP,0,48,0,1383
40742,2022-01-08,Divinolândia/SP,0,48,0,1383
46339,2022-01-09,Divinolândia/SP,0,48,0,1383
51936,2022-01-10,Divinolândia/SP,0,48,0,1383
57533,2022-01-11,Divinolândia/SP,0,48,0,1383
63130,2022-01-12,Divinolândia/SP,0,48,0,1383
68727,2022-01-13,Divinolândia/SP,0,48,0,1383
74324,2022-01-14,Divinolândia/SP,0,48,0,1383
79921,2022-01-15,Divinolândia/SP,0,48,0,1383
85518,2022-01-16,Divinolândia/SP,0,48,0,1383
91115,2022-01-17,Divinolândia/SP,0,48,0,1383
96712,2022-01-18,Divinolândia/SP,0,48,0,1383
102309,2022-01-19,Divinolândia/SP,0,48,2,1385
107906,2022-01-20,Divinolândia/SP,0,48,-2,1383
113503,2022-01-21,Divinolândia/SP,0,48,0,1383
119100,2022-01-22,Divinolândia/SP,0,48,0,1383
124697,2022-01-23,Divinolândia/SP,0,48,0,1383
130294,2022-01-24,Divinolândia/SP,0,48,0,1383
135891,2022-01-25,Divinolândia/SP,0,48,0,1383
141488,2022-01-26,Divinolândia/SP,0,48,1,1384
147085,2022-01-27,Divinolândia/SP,0,48,0,1384
152682,2022-01-28,Divinolândia/SP,0,48,0,1384
158279,2022-01-29,Divinolândia/SP,0,48,0,1384
163876,2022-01-30,Divinolândia/SP,0,48,0,1384
169473,2022-01-31,Divinolândia/SP,0,48,0,1384
175070,2022-02-01,Divinolândia/SP,0,48,1,1385
180667,2022-02-02,Divinolândia/SP,0,48,0,1385
186264,2022-02-03,Divinolândia/SP,0,48,0,1385
191861,2022-02-04,Divinolândia/SP,0,48,0,1385
197458,2022-02-05,Divinolândia/SP,0,48,1,1386
203055,2022-02-06,Divinolândia/SP,0,48,0,1386
208652,2022-02-07,Divinolândia/SP,0,48,0,1386
214249,2022-02-08,Divinolândia/SP,0,48,0,1386
219846,2022-02-09,Divinolândia/SP,0,48,10,1396
225443,2022-02-10,Divinolândia/SP,0,48,0,1396
231040,2022-02-11,Divinolândia/SP,0,48,34,1430
236637,2022-02-12,Divinolândia/SP,0,48,15,1445
242234,2022-02-13,Divinolândia/SP,0,48,0,1445
247831,2022-02-14,Divinolândia/SP,0,48,0,1445
253428,2022-02-15,Divinolândia/SP,0,48,54,1499
259025,2022-02-16,Divinolândia/SP,0,48,10,1509
264622,2022-02-17,Divinolândia/SP,0,48,0,1509
270219,2022-02-18,Divinolândia/SP,0,48,-1,1508
275816,2022-02-19,Divinolândia/SP,0,48,58,1566
281413,2022-02-20,Divinolândia/SP,0,48,206,1772
287010,2022-02-21,Divinolândia/SP,0,48,0,1772
292607,2022-02-22,Divinolândia/SP,0,48,10,1782
298204,2022-02-23,Divinolândia/SP,0,48,109,1891
303801,2022-02-24,Divinolândia/SP,0,48,21,1912
309398,2022-02-25,Divinolândia/SP,0,48,0,1912
314995,2022-02-26,Divinolândia/SP,0,48,30,1942
320592,2022-02-27,Divinolândia/SP,0,48,0,1942
326189,2022-02-28,Divinolândia/SP,0,48,0,1942
331786,2022-03-01,Divinolândia/SP,0,48,143,2085
337383,2022-03-02,Divinolândia/SP,0,48,0,2085
342980,2022-03-03,Divinolândia/SP,0,48,144,2229
348577,2022-03-04,Divinolândia/SP,0,48,8,2237
354174,2022-03-05,Divinolândia/SP,0,48,0,2237
359771,2022-03-06,Divinolândia/SP,0,48,0,2237
365368,2022-03-07,Divinolândia/SP,0,48,0,2237
370965,2022-03-08,Divinolândia/SP,0,48,6,2243
376562,2022-03-09,Divinolândia/SP,0,48,7,2250
382159,2022-03-10,Divinolândia/SP,0,48,2,2252
387756,2022-03-11,Divinolândia/SP,0,48,10,2262
393353,2022-03-12,Divinolândia/SP,0,48,8,2270
398950,2022-03-13,Divinolândia/SP,0,48,0,2270
404547,2022-03-14,Divinolândia/SP,0,48,0,2270
410144,2022-03-15,Divinolândia/SP,0,48,2,2272
415741,2022-03-16,Divinolândia/SP,0,48,0,2272
421338,2022-03-17,Divinolândia/SP,0,48,1,2273
426935,2022-03-18,Divinolândia/SP,0,48,0,2273
432532,2022-03-19,Divinolândia/SP,0,48,0,2273
438129,2022-03-20,Divinolândia/SP,0,48,0,2273
443726,2022-03-21,Divinolândia/SP,0,48,0,2273
449323,2022-03-22,Divinolândia/SP,0,48,1,2274
454920,2022-03-23,Divinolândia/SP,0,48,0,2274
460517,2022-03-24,Divinolândia/SP,0,48,0,2274
466114,2022-03-25,Divinolândia/SP,0,48,0,2274
471711,2022-03-26,Divinolândia/SP,0,48,0,2274
477308,2022-03-27,Divinolândia/SP,0,48,0,2274
482905,2022-03-28,Divinolândia/SP,0,48,0,2274
488502,2022-03-29,Divinolândia/SP,0,48,0,2274
494099,2022-03-30,Divinolândia/SP,0,48,0,2274
499696,2022-03-31,Divinolândia/SP,0,48,0,2274
505293,2022-04-01,Divinolândia/SP,0,48,0,2274
510890,2022-04-02,Divinolândia/SP,0,48,0,2274
516487,2022-04-03,Divinolândia/SP,0,48,0,2274
522084,2022-04-04,Divinolândia/SP,0,48,0,2274
527681,2022-04-05,Divinolândia/SP,0,48,0,2274
533278,2022-04-06,Divinolândia/SP,0,48,0,2274
538875,2022-04-07,Divinolândia/SP,0,48,0,2274
544472,2022-04-08,Divinolândia/SP,0,48,0,2274
550069,2022-04-09,Divinolândia/SP,0,48,0,2274
555666,2022-04-10,Divinolândia/SP,0,48,0,2274
561263,2022-04-11,Divinolândia/SP,0,48,0,2274
566860,2022-04-12,Divinolândia/SP,0,48,0,2274
572457,2022-04-13,Divinolândia/SP,0,48,0,2274
578054,2022-04-14,Divinolândia/SP,0,48,0,2274
583651,2022-04-15,Divinolândia/SP,0,48,0,2274
589248,2022-04-16,Divinolândia/SP,0,48,0,2274
594845,2022-04-17,Divinolândia/SP,0,48,0,2274
600442,2022-04-18,Divinolândia/SP,0,48,0,2274
606039,2022-04-19,Divinolândia/SP,0,48,0,2274
611636,2022-04-20,Divinolândia/SP,0,48,0,2274
617233,2022-04-21,Divinolândia/SP,0,48,0,2274
622830,2022-04-22,Divinolândia/SP,0,48,0,2274
628427,2022-04-23,Divinolândia/SP,0,48,0,2274
634024,2022-04-24,Divinolândia/SP,0,48,0,2274
639621,2022-04-25,Divinolândia/SP,0,48,0,2274
645218,2022-04-26,Divinolândia/SP,0,48,0,2274
650815,2022-04-27,Divinolândia/SP,0,48,0,2274
656412,2022-04-28,Divinolândia/SP,0,48,0,2274
662009,2022-04-29,Divinolândia/SP,0,48,0,2274
667606,2022-04-30,Divinolândia/SP,0,48,0,2274
673203,2022-05-01,Divinolândia/SP,0,48,0,2274
678800,2022-05-02,Divinolândia/SP,0,48,0,2274
684397,2022-05-03,Divinolândia/SP,0,48,0,2274
689994,2022-05-04,Divinolândia/SP,0,48,0,2274
695591,2022-05-05,Divinolândia/SP,0,48,0,2274
701188,2022-05-06,Divinolândia/SP,0,48,0,2274
706785,2022-05-07,Divinolândia/SP,0,48,1,2275
712382,2022-05-08,Divinolândia/SP,0,48,0,2275
717979,2022-05-09,Divinolândia/SP,0,48,0,2275
723576,2022-05-10,Divinolândia/SP,0,48,0,2275
729173,2022-05-11,Divinolândia/SP,0,48,0,2275
734770,2022-05-12,Divinolândia/SP,0,48,0,2275
740367,2022-05-13,Divinolândia/SP,0,48,0,2275
745964,2022-05-14,Divinolândia/SP,0,48,0,2275
751561,2022-05-15,Divinolândia/SP,0,48,0,2275
757158,2022-05-16,Divinolândia/SP,0,48,0,2275
762755,2022-05-17,Divinolândia/SP,0,48,0,2275
768352,2022-05-18,Divinolândia/SP,0,48,0,2275
773949,2022-05-19,Divinolândia/SP,0,48,0,2275
779546,2022-05-20,Divinolândia/SP,0,48,0,2275
785143,2022-05-21,Divinolândia/SP,0,48,0,2275
790740,2022-05-22,Divinolândia/SP,0,48,-1,2274
796337,2022-05-23,Divinolândia/SP,0,48,0,2274
801934,2022-05-24,Divinolândia/SP,0,48,0,2274
807531,2022-05-25,Divinolândia/SP,0,48,0,2274
813128,2022-05-26,Divinolândia/SP,0,48,0,2274
818725,2022-05-27,Divinolândia/SP,0,48,0,2274
824322,2022-05-28,Divinolândia/SP,0,48,0,2274
829919,2022-05-29,Divinolândia/SP,0,48,0,2274
835516,2022-05-30,Divinolândia/SP,0,48,0,2274
841113,2022-05-31,Divinolândia/SP,0,48,0,2274
846710,2022-06-01,Divinolândia/SP,0,48,0,2274
852307,2022-06-02,Divinolândia/SP,0,48,0,2274
857904,2022-06-03,Divinolândia/SP,0,48,0,2274
863501,2022-06-04,Divinolândia/SP,0,48,0,2274
869098,2022-06-05,Divinolândia/SP,0,48,0,2274
874695,2022-06-06,Divinolândia/SP,0,48,0,2274
880292,2022-06-07,Divinolândia/SP,0,48,0,2274
885889,2022-06-08,Divinolândia/SP,0,48,0,2274
891486,2022-06-09,Divinolândia/SP,0,48,0,2274
897083,2022-06-10,Divinolândia/SP,0,48,0,2274
902680,2022-06-11,Divinolândia/SP,0,48,0,2274
908277,2022-06-12,Divinolândia/SP,0,48,0,2274
913874,2022-06-13,Divinolândia/SP,0,48,0,2274
919471,2022-06-14,Divinolândia/SP,0,48,0,2274
925068,2022-06-15,Divinolândia/SP,0,48,1,2275
930665,2022-06-16,Divinolândia/SP,0,48,0,2275
936262,2022-06-17,Divinolândia/SP,0,48,0,2275
941859,2022-06-18,Divinolândia/SP,0,48,0,2275
947456,2022-06-19,Divinolândia/SP,0,48,0,2275
953053,2022-06-20,Divinolândia/SP,0,48,0,2275
958650,2022-06-21,Divinolândia/SP,0,48,0,2275
964247,2022-06-22,Divinolândia/SP,0,48,0,2275
969844,2022-06-23,Divinolândia/SP,0,48,0,2275
975441,2022-06-24,Divinolândia/SP,0,48,0,2275
981038,2022-06-25,Divinolândia/SP,0,48,0,2275
986635,2022-06-26,Divinolândia/SP,0,48,0,2275
992232,2022-06-27,Divinolândia/SP,0,48,0,2275
997829,2022-06-28,Divinolândia/SP,0,48,0,2275
1003426,2022-06-29,Divinolândia/SP,0,48,0,2275
1009023,2022-06-30,Divinolândia/SP,0,48,0,2275
1014620,2022-07-01,Divinolândia/SP,0,48,0,2275
1020217,2022-07-02,Divinolândia/SP,0,48,0,2275
1025814,2022-07-03,Divinolândia/SP,0,48,0,2275
1031411,2022-07-04,Divinolândia/SP,0,48,0,2275
1037008,2022-07-05,Divinolândia/SP,0,48,0,2275
1042605,2022-07-06,Divinolândia/SP,0,48,0,2275
1048202,2022-07-07,Divinolândia/SP,0,48,0,2275
1053799,2022-07-08,Divinolândia/SP,0,48,0,2275
1059396,2022-07-09,Divinolândia/SP,0,48,0,2275
1064993,2022-07-10,Divinolândia/SP,0,48,0,2275
1070590,2022-07-11,Divinolândia/SP,0,48,0,2275
1076187,2022-07-12,Divinolândia/SP,0,48,1,2276
1081784,2022-07-13,Divinolândia/SP,0,48,0,2276
1087381,2022-07-14,Divinolândia/SP,0,48,0,2276
1092978,2022-07-15,Divinolândia/SP,0,48,0,2276
1098575,2022-07-16,Divinolândia/SP,0,48,0,2276
1104172,2022-07-17,Divinolândia/SP,0,48,0,2276
1109769,2022-07-18,Divinolândia/SP,0,48,0,2276
1115366,2022-07-19,Divinolândia/SP,0,48,0,2276
1120963,2022-07-20,Divinolândia/SP,0,48,-1,2275
1126560,2022-07-21,Divinolândia/SP,0,48,0,2275
1132157,2022-07-22,Divinolândia/SP,0,48,0,2275
1137754,2022-07-23,Divinolândia/SP,0,48,0,2275
1143351,2022-07-24,Divinolândia/SP,0,48,0,2275
1148948,2022-07-25,Divinolândia/SP,0,48,0,2275
1154545,2022-07-26,Divinolândia/SP,0,48,1,2276
1160142,2022-07-27,Divinolândia/SP,0,48,0,2276
1165739,2022-07-28,Divinolândia/SP,0,48,0,2276
1171336,2022-07-29,Divinolândia/SP,0,48,0,2276
1176933,2022-07-30,Divinolândia/SP,0,48,0,2276
1182530,2022-07-31,Divinolândia/SP,0,48,0,2276
1188127,2022-08-01,Divinolândia/SP,0,48,0,2276
1193724,2022-08-02,Divinolândia/SP,0,48,0,2276
1199321,2022-08-03,Divinolândia/SP,0,48,0,2276
1204918,2022-08-04,Divinolândia/SP,0,48,0,2276
1210515,2022-08-05,Divinolândia/SP,0,48,0,2276
1216112,2022-08-06,Divinolândia/SP,0,48,0,2276
1221709,2022-08-07,Divinolândia/SP,0,48,0,2276
1227306,2022-08-08,Divinolândia/SP,0,48,0,2276
1232903,2022-08-09,Divinolândia/SP,0,48,0,2276
1238500,2022-08-10,Divinolândia/SP,0,48,0,2276
1244097,2022-08-11,Divinolândia/SP,0,48,0,2276
1249694,2022-08-12,Divinolândia/SP,0,48,0,2276
1255291,2022-08-13,Divinolândia/SP,0,48,0,2276
1260888,2022-08-14,Divinolândia/SP,0,48,0,2276
1266485,2022-08-15,Divinolândia/SP,0,48,0,2276
1272082,2022-08-16,Divinolândia/SP,0,48,0,2276
1277679,2022-08-17,Divinolândia/SP,0,48,0,2276
1283276,2022-08-18,Divinolândia/SP,0,48,0,2276
1288873,2022-08-19,Divinolândia/SP,0,48,0,2276
1294470,2022-08-20,Divinolândia/SP,0,48,0,2276
1300067,2022-08-21,Divinolândia/SP,0,48,0,2276
1305664,2022-08-22,Divinolândia/SP,0,48,0,2276
1311261,2022-08-23,Divinolândia/SP,0,48,0,2276
1316858,2022-08-24,Divinolândia/SP,0,48,0,2276
1322455,2022-08-25,Divinolândia/SP,0,48,0,2276
1697,2022-01-01,Espírito Santo do Pinhal/SP,0,109,2,5019
7294,2022-01-02,Espírito Santo do Pinhal/SP,0,109,0,5019
12891,2022-01-03,Espírito Santo do Pinhal/SP,0,109,0,5019
18488,2022-01-04,Espírito Santo do Pinhal/SP,0,109,16,5035
24085,2022-01-05,Espírito Santo do Pinhal/SP,0,109,1,5036
29682,2022-01-06,Espírito Santo do Pinhal/SP,0,109,1,5037
35279,2022-01-07,Espírito Santo do Pinhal/SP,0,109,0,5037
40876,2022-01-08,Espírito Santo do Pinhal/SP,0,109,0,5037
46473,2022-01-09,Espírito Santo do Pinhal/SP,0,109,47,5084
52070,2022-01-10,Espírito Santo do Pinhal/SP,0,109,24,5108
57667,2022-01-11,Espírito Santo do Pinhal/SP,0,109,14,5122
63264,2022-01-12,Espírito Santo do Pinhal/SP,0,109,33,5155
68861,2022-01-13,Espírito Santo do Pinhal/SP,1,110,1,5156
74458,2022-01-14,Espírito Santo do Pinhal/SP,1,111,1,5157
80055,2022-01-15,Espírito Santo do Pinhal/SP,0,111,0,5157
85652,2022-01-16,Espírito Santo do Pinhal/SP,0,111,0,5157
91249,2022-01-17,Espírito Santo do Pinhal/SP,0,111,50,5207
96846,2022-01-18,Espírito Santo do Pinhal/SP,0,111,3,5210
102443,2022-01-19,Espírito Santo do Pinhal/SP,0,111,4,5214
108040,2022-01-20,Espírito Santo do Pinhal/SP,0,111,0,5214
113637,2022-01-21,Espírito Santo do Pinhal/SP,0,111,1,5215
119234,2022-01-22,Espírito Santo do Pinhal/SP,0,111,0,5215
124831,2022-01-23,Espírito Santo do Pinhal/SP,0,111,17,5232
130428,2022-01-24,Espírito Santo do Pinhal/SP,0,111,0,5232
136025,2022-01-25,Espírito Santo do Pinhal/SP,3,114,9,5241
141622,2022-01-26,Espírito Santo do Pinhal/SP,0,114,4,5245
147219,2022-01-27,Espírito Santo do Pinhal/SP,0,114,5,5250
152816,2022-01-28,Espírito Santo do Pinhal/SP,0,114,1,5251
158413,2022-01-29,Espírito Santo do Pinhal/SP,0,114,0,5251
164010,2022-01-30,Espírito Santo do Pinhal/SP,0,114,55,5306
169607,2022-01-31,Espírito Santo do Pinhal/SP,0,114,0,5306
175204,2022-02-01,Espírito Santo do Pinhal/SP,0,114,103,5409
180801,2022-02-02,Espírito Santo do Pinhal/SP,2,116,6,5415
186398,2022-02-03,Espírito Santo do Pinhal/SP,0,116,373,5788
191995,2022-02-04,Espírito Santo do Pinhal/SP,0,116,0,5788
197592,2022-02-05,Espírito Santo do Pinhal/SP,1,117,166,5954
203189,2022-02-06,Espírito Santo do Pinhal/SP,0,117,47,6001
208786,2022-02-07,Espírito Santo do Pinhal/SP,0,117,0,6001
214383,2022-02-08,Espírito Santo do Pinhal/SP,1,118,83,6084
219980,2022-02-09,Espírito Santo do Pinhal/SP,1,119,75,6159
225577,2022-02-10,Espírito Santo do Pinhal/SP,1,120,112,6271
231174,2022-02-11,Espírito Santo do Pinhal/SP,0,120,125,6396
236771,2022-02-12,Espírito Santo do Pinhal/SP,0,120,92,6488
242368,2022-02-13,Espírito Santo do Pinhal/SP,0,120,55,6543
247965,2022-02-14,Espírito Santo do Pinhal/SP,0,120,18,6561
253562,2022-02-15,Espírito Santo do Pinhal/SP,1,121,117,6678
259159,2022-02-16,Espírito Santo do Pinhal/SP,0,121,110,6788
264756,2022-02-17,Espírito Santo do Pinhal/SP,0,121,90,6878
270353,2022-02-18,Espírito Santo do Pinhal/SP,1,122,116,6994
275950,2022-02-19,Espírito Santo do Pinhal/SP,0,122,209,7203
281547,2022-02-20,Espírito Santo do Pinhal/SP,0,122,172,7375
287144,2022-02-21,Espírito Santo do Pinhal/SP,0,122,77,7452
292741,2022-02-22,Espírito Santo do Pinhal/SP,0,122,200,7652
298338,2022-02-23,Espírito Santo do Pinhal/SP,0,122,136,7788
303935,2022-02-24,Espírito Santo do Pinhal/SP,0,122,70,7858
309532,2022-02-25,Espírito Santo do Pinhal/SP,0,122,62,7920
315129,2022-02-26,Espírito Santo do Pinhal/SP,0,122,58,7978
320726,2022-02-27,Espírito Santo do Pinhal/SP,0,122,0,7978
326323,2022-02-28,Espírito Santo do Pinhal/SP,0,122,0,7978
331920,2022-03-01,Espírito Santo do Pinhal/SP,0,122,0,7978
337517,2022-03-02,Espírito Santo do Pinhal/SP,0,122,0,7978
343114,2022-03-03,Espírito Santo do Pinhal/SP,0,122,16,7994
348711,2022-03-04,Espírito Santo do Pinhal/SP,0,122,40,8034
354308,2022-03-05,Espírito Santo do Pinhal/SP,1,123,72,8106
359905,2022-03-06,Espírito Santo do Pinhal/SP,0,123,0,8106
365502,2022-03-07,Espírito Santo do Pinhal/SP,0,123,0,8106
371099,2022-03-08,Espírito Santo do Pinhal/SP,0,123,80,8186
376696,2022-03-09,Espírito Santo do Pinhal/SP,0,123,102,8288
382293,2022-03-10,Espírito Santo do Pinhal/SP,0,123,148,8436
387890,2022-03-11,Espírito Santo do Pinhal/SP,1,124,96,8532
393487,2022-03-12,Espírito Santo do Pinhal/SP,0,124,105,8637
399084,2022-03-13,Espírito Santo do Pinhal/SP,0,124,0,8637
404681,2022-03-14,Espírito Santo do Pinhal/SP,0,124,1,8638
410278,2022-03-15,Espírito Santo do Pinhal/SP,0,124,86,8724
415875,2022-03-16,Espírito Santo do Pinhal/SP,0,124,99,8823
421472,2022-03-17,Espírito Santo do Pinhal/SP,0,124,106,8929
427069,2022-03-18,Espírito Santo do Pinhal/SP,0,124,48,8977
432666,2022-03-19,Espírito Santo do Pinhal/SP,0,124,42,9019
438263,2022-03-20,Espírito Santo do Pinhal/SP,0,124,0,9019
443860,2022-03-21,Espírito Santo do Pinhal/SP,0,124,0,9019
449457,2022-03-22,Espírito Santo do Pinhal/SP,0,124,35,9054
455054,2022-03-23,Espírito Santo do Pinhal/SP,0,124,50,9104
460651,2022-03-24,Espírito Santo do Pinhal/SP,0,124,25,9129
466248,2022-03-25,Espírito Santo do Pinhal/SP,0,124,25,9154
471845,2022-03-26,Espírito Santo do Pinhal/SP,0,124,21,9175
477442,2022-03-27,Espírito Santo do Pinhal/SP,0,124,0,9175
483039,2022-03-28,Espírito Santo do Pinhal/SP,0,124,0,9175
488636,2022-03-29,Espírito Santo do Pinhal/SP,0,124,11,9186
494233,2022-03-30,Espírito Santo do Pinhal/SP,1,125,34,9220
499830,2022-03-31,Espírito Santo do Pinhal/SP,0,125,38,9258
505427,2022-04-01,Espírito Santo do Pinhal/SP,0,125,41,9299
511024,2022-04-02,Espírito Santo do Pinhal/SP,0,125,16,9315
516621,2022-04-03,Espírito Santo do Pinhal/SP,0,125,2,9317
522218,2022-04-04,Espírito Santo do Pinhal/SP,0,125,0,9317
527815,2022-04-05,Espírito Santo do Pinhal/SP,0,125,7,9324
533412,2022-04-06,Espírito Santo do Pinhal/SP,0,125,4,9328
539009,2022-04-07,Espírito Santo do Pinhal/SP,0,125,5,9333
544606,2022-04-08,Espírito Santo do Pinhal/SP,0,125,11,9344
550203,2022-04-09,Espírito Santo do Pinhal/SP,0,125,6,9350
555800,2022-04-10,Espírito Santo do Pinhal/SP,0,125,0,9350
561397,2022-04-11,Espírito Santo do Pinhal/SP,0,125,0,9350
566994,2022-04-12,Espírito Santo do Pinhal/SP,0,125,4,9354
572591,2022-04-13,Espírito Santo do Pinhal/SP,0,125,1,9355
578188,2022-04-14,Espírito Santo do Pinhal/SP,0,125,1,9356
583785,2022-04-15,Espírito Santo do Pinhal/SP,0,125,2,9358
589382,2022-04-16,Espírito Santo do Pinhal/SP,0,125,0,9358
594979,2022-04-17,Espírito Santo do Pinhal/SP,0,125,0,9358
600576,2022-04-18,Espírito Santo do Pinhal/SP,0,125,0,9358
606173,2022-04-19,Espírito Santo do Pinhal/SP,0,125,0,9358
611770,2022-04-20,Espírito Santo do Pinhal/SP,2,127,21,9379
617367,2022-04-21,Espírito Santo do Pinhal/SP,0,127,3,9382
622964,2022-04-22,Espírito Santo do Pinhal/SP,0,127,0,9382
628561,2022-04-23,Espírito Santo do Pinhal/SP,0,127,0,9382
634158,2022-04-24,Espírito Santo do Pinhal/SP,0,127,0,9382
639755,2022-04-25,Espírito Santo do Pinhal/SP,0,127,0,9382
645352,2022-04-26,Espírito Santo do Pinhal/SP,0,127,13,9395
650949,2022-04-27,Espírito Santo do Pinhal/SP,0,127,4,9399
656546,2022-04-28,Espírito Santo do Pinhal/SP,0,127,3,9402
662143,2022-04-29,Espírito Santo do Pinhal/SP,0,127,0,9402
667740,2022-04-30,Espírito Santo do Pinhal/SP,0,127,16,9418
673337,2022-05-01,Espírito Santo do Pinhal/SP,0,127,0,9418
678934,2022-05-02,Espírito Santo do Pinhal/SP,0,127,0,9418
684531,2022-05-03,Espírito Santo do Pinhal/SP,0,127,68,9486
690128,2022-05-04,Espírito Santo do Pinhal/SP,0,127,84,9570
695725,2022-05-05,Espírito Santo do Pinhal/SP,0,127,92,9662
701322,2022-05-06,Espírito Santo do Pinhal/SP,0,127,47,9709
706919,2022-05-07,Espírito Santo do Pinhal/SP,0,127,3,9712
712516,2022-05-08,Espírito Santo do Pinhal/SP,0,127,0,9712
718113,2022-05-09,Espírito Santo do Pinhal/SP,0,127,0,9712
723710,2022-05-10,Espírito Santo do Pinhal/SP,1,128,21,9733
729307,2022-05-11,Espírito Santo do Pinhal/SP,0,128,43,9776
734904,2022-05-12,Espírito Santo do Pinhal/SP,0,128,62,9838
740501,2022-05-13,Espírito Santo do Pinhal/SP,0,128,33,9871
746098,2022-05-14,Espírito Santo do Pinhal/SP,0,128,37,9908
751695,2022-05-15,Espírito Santo do Pinhal/SP,0,128,0,9908
757292,2022-05-16,Espírito Santo do Pinhal/SP,0,128,0,9908
762889,2022-05-17,Espírito Santo do Pinhal/SP,0,128,0,9908
768486,2022-05-18,Espírito Santo do Pinhal/SP,0,128,0,9908
774083,2022-05-19,Espírito Santo do Pinhal/SP,0,128,1,9909
779680,2022-05-20,Espírito Santo do Pinhal/SP,0,128,0,9909
785277,2022-05-21,Espírito Santo do Pinhal/SP,0,128,0,9909
790874,2022-05-22,Espírito Santo do Pinhal/SP,0,128,14,9923
796471,2022-05-23,Espírito Santo do Pinhal/SP,0,128,0,9923
802068,2022-05-24,Espírito Santo do Pinhal/SP,0,128,11,9934
807665,2022-05-25,Espírito Santo do Pinhal/SP,0,128,33,9967
813262,2022-05-26,Espírito Santo do Pinhal/SP,0,128,48,10015
818859,2022-05-27,Espírito Santo do Pinhal/SP,0,128,21,10036
824456,2022-05-28,Espírito Santo do Pinhal/SP,0,128,48,10084
830053,2022-05-29,Espírito Santo do Pinhal/SP,0,128,5,10089
835650,2022-05-30,Espírito Santo do Pinhal/SP,0,128,0,10089
841247,2022-05-31,Espírito Santo do Pinhal/SP,0,128,81,10170
846844,2022-06-01,Espírito Santo do Pinhal/SP,0,128,44,10214
852441,2022-06-02,Espírito Santo do Pinhal/SP,0,128,44,10258
858038,2022-06-03,Espírito Santo do Pinhal/SP,0,128,0,10258
863635,2022-06-04,Espírito Santo do Pinhal/SP,0,128,0,10258
869232,2022-06-05,Espírito Santo do Pinhal/SP,0,128,0,10258
874829,2022-06-06,Espírito Santo do Pinhal/SP,0,128,0,10258
880426,2022-06-07,Espírito Santo do Pinhal/SP,0,128,18,10276
886023,2022-06-08,Espírito Santo do Pinhal/SP,0,128,0,10276
891620,2022-06-09,Espírito Santo do Pinhal/SP,0,128,2,10278
897217,2022-06-10,Espírito Santo do Pinhal/SP,0,128,3,10281
902814,2022-06-11,Espírito Santo do Pinhal/SP,0,128,21,10302
908411,2022-06-12,Espírito Santo do Pinhal/SP,0,128,0,10302
914008,2022-06-13,Espírito Santo do Pinhal/SP,0,128,0,10302
919605,2022-06-14,Espírito Santo do Pinhal/SP,0,128,0,10302
925202,2022-06-15,Espírito Santo do Pinhal/SP,0,128,119,10421
930799,2022-06-16,Espírito Santo do Pinhal/SP,0,128,83,10504
936396,2022-06-17,Espírito Santo do Pinhal/SP,0,128,0,10504
941993,2022-06-18,Espírito Santo do Pinhal/SP,0,128,0,10504
947590,2022-06-19,Espírito Santo do Pinhal/SP,0,128,0,10504
953187,2022-06-20,Espírito Santo do Pinhal/SP,0,128,0,10504
958784,2022-06-21,Espírito Santo do Pinhal/SP,0,128,28,10532
964381,2022-06-22,Espírito Santo do Pinhal/SP,0,128,12,10544
969978,2022-06-23,Espírito Santo do Pinhal/SP,0,128,52,10596
975575,2022-06-24,Espírito Santo do Pinhal/SP,0,128,0,10596
981172,2022-06-25,Espírito Santo do Pinhal/SP,0,128,58,10654
986769,2022-06-26,Espírito Santo do Pinhal/SP,0,128,66,10720
992366,2022-06-27,Espírito Santo do Pinhal/SP,0,128,0,10720
997963,2022-06-28,Espírito Santo do Pinhal/SP,1,129,52,10772
1003560,2022-06-29,Espírito Santo do Pinhal/SP,0,129,-1,10771
1009157,2022-06-30,Espírito Santo do Pinhal/SP,1,130,22,10793
1014754,2022-07-01,Espírito Santo do Pinhal/SP,0,130,15,10808
1020351,2022-07-02,Espírito Santo do Pinhal/SP,0,130,37,10845
1025948,2022-07-03,Espírito Santo do Pinhal/SP,0,130,52,10897
1031545,2022-07-04,Espírito Santo do Pinhal/SP,0,130,0,10897
1037142,2022-07-05,Espírito Santo do Pinhal/SP,1,131,13,10910
1042739,2022-07-06,Espírito Santo do Pinhal/SP,0,131,16,10926
1048336,2022-07-07,Espírito Santo do Pinhal/SP,0,131,28,10954
1053933,2022-07-08,Espírito Santo do Pinhal/SP,0,131,45,10999
1059530,2022-07-09,Espírito Santo do Pinhal/SP,0,131,112,11111
1065127,2022-07-10,Espírito Santo do Pinhal/SP,0,131,63,11174
1070724,2022-07-11,Espírito Santo do Pinhal/SP,0,131,0,11174
1076321,2022-07-12,Espírito Santo do Pinhal/SP,1,132,25,11199
1081918,2022-07-13,Espírito Santo do Pinhal/SP,0,132,49,11248
1087515,2022-07-14,Espírito Santo do Pinhal/SP,0,132,9,11257
1093112,2022-07-15,Espírito Santo do Pinhal/SP,0,132,15,11272
1098709,2022-07-16,Espírito Santo do Pinhal/SP,0,132,26,11298
1104306,2022-07-17,Espírito Santo do Pinhal/SP,0,132,19,11317
1109903,2022-07-18,Espírito Santo do Pinhal/SP,0,132,0,11317
1115500,2022-07-19,Espírito Santo do Pinhal/SP,0,132,161,11478
1121097,2022-07-20,Espírito Santo do Pinhal/SP,2,134,179,11657
1126694,2022-07-21,Espírito Santo do Pinhal/SP,0,134,62,11719
1132291,2022-07-22,Espírito Santo do Pinhal/SP,0,134,30,11749
1137888,2022-07-23,Espírito Santo do Pinhal/SP,1,135,134,11883
1143485,2022-07-24,Espírito Santo do Pinhal/SP,0,135,188,12071
1149082,2022-07-25,Espírito Santo do Pinhal/SP,0,135,0,12071
1154679,2022-07-26,Espírito Santo do Pinhal/SP,0,135,31,12102
1160276,2022-07-27,Espírito Santo do Pinhal/SP,-1,134,79,12181
1165873,2022-07-28,Espírito Santo do Pinhal/SP,0,134,130,12311
1171470,2022-07-29,Espírito Santo do Pinhal/SP,0,134,87,12398
1177067,2022-07-30,Espírito Santo do Pinhal/SP,0,134,57,12455
1182664,2022-07-31,Espírito Santo do Pinhal/SP,0,134,113,12568
1188261,2022-08-01,Espírito Santo do Pinhal/SP,0,134,0,12568
1193858,2022-08-02,Espírito Santo do Pinhal/SP,1,135,40,12608
1199455,2022-08-03,Espírito Santo do Pinhal/SP,0,135,20,12628
1205052,2022-08-04,Espírito Santo do Pinhal/SP,0,135,20,12648
1210649,2022-08-05,Espírito Santo do Pinhal/SP,0,135,23,12671
1216246,2022-08-06,Espírito Santo do Pinhal/SP,0,135,28,12699
1221843,2022-08-07,Espírito Santo do Pinhal/SP,0,135,2,12701
1227440,2022-08-08,Espírito Santo do Pinhal/SP,0,135,0,12701
1233037,2022-08-09,Espírito Santo do Pinhal/SP,0,135,17,12718
1238634,2022-08-10,Espírito Santo do Pinhal/SP,0,135,15,12733
1244231,2022-08-11,Espírito Santo do Pinhal/SP,1,136,26,12759
1249828,2022-08-12,Espírito Santo do Pinhal/SP,0,136,13,12772
1255425,2022-08-13,Espírito Santo do Pinhal/SP,0,136,20,12792
1261022,2022-08-14,Espírito Santo do Pinhal/SP,0,136,0,12792
1266619,2022-08-15,Espírito Santo do Pinhal/SP,0,136,0,12792
1272216,2022-08-16,Espírito Santo do Pinhal/SP,0,136,8,12800
1277813,2022-08-17,Espírito Santo do Pinhal/SP,0,136,6,12806
1283410,2022-08-18,Espírito Santo do Pinhal/SP,0,136,12,12818
1289007,2022-08-19,Espírito Santo do Pinhal/SP,0,136,6,12824
1294604,2022-08-20,Espírito Santo do Pinhal/SP,0,136,9,12833
1300201,2022-08-21,Espírito Santo do Pinhal/SP,0,136,1,12834
1305798,2022-08-22,Espírito Santo do Pinhal/SP,0,136,0,12834
1311395,2022-08-23,Espírito Santo do Pinhal/SP,0,136,49,12883
1316992,2022-08-24,Espírito Santo do Pinhal/SP,0,136,47,12930
1322589,2022-08-25,Espírito Santo do Pinhal/SP,0,136,8,12938
2180,2022-01-01,Indaiatuba/SP,0,746,0,27632
7777,2022-01-02,Indaiatuba/SP,0,746,0,27632
13374,2022-01-03,Indaiatuba/SP,0,746,0,27632
18971,2022-01-04,Indaiatuba/SP,1,747,2,27634
24568,2022-01-05,Indaiatuba/SP,0,747,0,27634
30165,2022-01-06,Indaiatuba/SP,1,748,-5,27629
35762,2022-01-07,Indaiatuba/SP,0,748,2,27631
41359,2022-01-08,Indaiatuba/SP,3,751,4,27635
46956,2022-01-09,Indaiatuba/SP,0,751,0,27635
52553,2022-01-10,Indaiatuba/SP,0,751,0,27635
58150,2022-01-11,Indaiatuba/SP,4,755,5,27640
63747,2022-01-12,Indaiatuba/SP,0,755,3,27643
69344,2022-01-13,Indaiatuba/SP,0,755,5,27648
74941,2022-01-14,Indaiatuba/SP,3,758,3,27651
80538,2022-01-15,Indaiatuba/SP,0,758,0,27651
86135,2022-01-16,Indaiatuba/SP,0,758,0,27651
91732,2022-01-17,Indaiatuba/SP,0,758,0,27651
97329,2022-01-18,Indaiatuba/SP,0,758,2,27653
102926,2022-01-19,Indaiatuba/SP,0,758,1,27654
108523,2022-01-20,Indaiatuba/SP,0,758,-6,27648
114120,2022-01-21,Indaiatuba/SP,0,758,-1,27647
119717,2022-01-22,Indaiatuba/SP,0,758,0,27647
125314,2022-01-23,Indaiatuba/SP,0,758,4,27651
130911,2022-01-24,Indaiatuba/SP,0,758,0,27651
136508,2022-01-25,Indaiatuba/SP,0,758,-1,27650
142105,2022-01-26,Indaiatuba/SP,0,758,-13,27637
147702,2022-01-27,Indaiatuba/SP,1,759,-10,27627
153299,2022-01-28,Indaiatuba/SP,0,759,-18,27609
158896,2022-01-29,Indaiatuba/SP,4,763,-14,27595
164493,2022-01-30,Indaiatuba/SP,0,763,0,27595
170090,2022-01-31,Indaiatuba/SP,0,763,0,27595
175687,2022-02-01,Indaiatuba/SP,0,763,-9,27586
181284,2022-02-02,Indaiatuba/SP,1,764,4,27590
186881,2022-02-03,Indaiatuba/SP,0,764,-6,27584
192478,2022-02-04,Indaiatuba/SP,0,764,0,27584
198075,2022-02-05,Indaiatuba/SP,3,767,-4,27580
203672,2022-02-06,Indaiatuba/SP,0,767,3,27583
209269,2022-02-07,Indaiatuba/SP,0,767,0,27583
214866,2022-02-08,Indaiatuba/SP,0,767,-11,27572
220463,2022-02-09,Indaiatuba/SP,0,767,-6,27566
226060,2022-02-10,Indaiatuba/SP,0,767,0,27566
231657,2022-02-11,Indaiatuba/SP,0,767,9,27575
237254,2022-02-12,Indaiatuba/SP,1,768,8,27583
242851,2022-02-13,Indaiatuba/SP,0,768,1,27584
248448,2022-02-14,Indaiatuba/SP,0,768,0,27584
254045,2022-02-15,Indaiatuba/SP,0,768,11,27595
259642,2022-02-16,Indaiatuba/SP,0,768,-5,27590
265239,2022-02-17,Indaiatuba/SP,1,769,17,27607
270836,2022-02-18,Indaiatuba/SP,1,770,23,27630
276433,2022-02-19,Indaiatuba/SP,2,772,38,27668
282030,2022-02-20,Indaiatuba/SP,1,773,0,27668
287627,2022-02-21,Indaiatuba/SP,0,773,-1,27667
293224,2022-02-22,Indaiatuba/SP,0,773,43,27710
298821,2022-02-23,Indaiatuba/SP,1,774,49,27759
304418,2022-02-24,Indaiatuba/SP,0,774,42,27801
310015,2022-02-25,Indaiatuba/SP,0,774,24,27825
315612,2022-02-26,Indaiatuba/SP,0,774,19,27844
321209,2022-02-27,Indaiatuba/SP,0,774,0,27844
326806,2022-02-28,Indaiatuba/SP,0,774,0,27844
332403,2022-03-01,Indaiatuba/SP,0,774,0,27844
338000,2022-03-02,Indaiatuba/SP,0,774,0,27844
343597,2022-03-03,Indaiatuba/SP,1,775,4,27848
349194,2022-03-04,Indaiatuba/SP,0,775,1,27849
354791,2022-03-05,Indaiatuba/SP,7,782,8,27857
360388,2022-03-06,Indaiatuba/SP,0,782,0,27857
365985,2022-03-07,Indaiatuba/SP,0,782,0,27857
371582,2022-03-08,Indaiatuba/SP,13,795,10,27867
377179,2022-03-09,Indaiatuba/SP,5,800,18,27885
382776,2022-03-10,Indaiatuba/SP,3,803,4,27889
388373,2022-03-11,Indaiatuba/SP,0,803,10,27899
393970,2022-03-12,Indaiatuba/SP,0,803,2,27901
399567,2022-03-13,Indaiatuba/SP,0,803,0,27901
405164,2022-03-14,Indaiatuba/SP,0,803,0,27901
410761,2022-03-15,Indaiatuba/SP,1,804,2,27903
416358,2022-03-16,Indaiatuba/SP,1,805,1,27904
421955,2022-03-17,Indaiatuba/SP,0,805,3,27907
427552,2022-03-18,Indaiatuba/SP,0,805,0,27907
433149,2022-03-19,Indaiatuba/SP,0,805,5,27912
438746,2022-03-20,Indaiatuba/SP,0,805,0,27912
444343,2022-03-21,Indaiatuba/SP,0,805,0,27912
449940,2022-03-22,Indaiatuba/SP,0,805,-2,27910
455537,2022-03-23,Indaiatuba/SP,0,805,5,27915
461134,2022-03-24,Indaiatuba/SP,1,806,27,27942
466731,2022-03-25,Indaiatuba/SP,3,809,25,27967
472328,2022-03-26,Indaiatuba/SP,1,810,4,27971
477925,2022-03-27,Indaiatuba/SP,0,810,0,27971
483522,2022-03-28,Indaiatuba/SP,0,810,0,27971
489119,2022-03-29,Indaiatuba/SP,0,810,17,27988
494716,2022-03-30,Indaiatuba/SP,0,810,36,28024
500313,2022-03-31,Indaiatuba/SP,2,812,16,28040
505910,2022-04-01,Indaiatuba/SP,0,812,15,28055
511507,2022-04-02,Indaiatuba/SP,0,812,19,28074
517104,2022-04-03,Indaiatuba/SP,0,812,0,28074
522701,2022-04-04,Indaiatuba/SP,0,812,0,28074
528298,2022-04-05,Indaiatuba/SP,2,814,25,28099
533895,2022-04-06,Indaiatuba/SP,-1,813,20,28119
539492,2022-04-07,Indaiatuba/SP,0,813,16,28135
545089,2022-04-08,Indaiatuba/SP,1,814,18,28153
550686,2022-04-09,Indaiatuba/SP,0,814,8,28161
556283,2022-04-10,Indaiatuba/SP,-1,813,1,28162
561880,2022-04-11,Indaiatuba/SP,0,813,0,28162
567477,2022-04-12,Indaiatuba/SP,0,813,14,28176
573074,2022-04-13,Indaiatuba/SP,1,814,20,28196
578671,2022-04-14,Indaiatuba/SP,0,814,19,28215
584268,2022-04-15,Indaiatuba/SP,0,814,32,28247
589865,2022-04-16,Indaiatuba/SP,0,814,0,28247
595462,2022-04-17,Indaiatuba/SP,0,814,0,28247
601059,2022-04-18,Indaiatuba/SP,0,814,0,28247
606656,2022-04-19,Indaiatuba/SP,0,814,0,28247
612253,2022-04-20,Indaiatuba/SP,0,814,19,28266
617850,2022-04-21,Indaiatuba/SP,0,814,-2,28264
623447,2022-04-22,Indaiatuba/SP,0,814,0,28264
629044,2022-04-23,Indaiatuba/SP,0,814,0,28264
634641,2022-04-24,Indaiatuba/SP,0,814,0,28264
640238,2022-04-25,Indaiatuba/SP,0,814,0,28264
645835,2022-04-26,Indaiatuba/SP,0,814,-1,28263
651432,2022-04-27,Indaiatuba/SP,0,814,-10,28253
657029,2022-04-28,Indaiatuba/SP,0,814,2,28255
662626,2022-04-29,Indaiatuba/SP,0,814,-3,28252
668223,2022-04-30,Indaiatuba/SP,0,814,3,28255
673820,2022-05-01,Indaiatuba/SP,0,814,1,28256
679417,2022-05-02,Indaiatuba/SP,0,814,0,28256
685014,2022-05-03,Indaiatuba/SP,0,814,-7,28249
690611,2022-05-04,Indaiatuba/SP,0,814,-7,28242
696208,2022-05-05,Indaiatuba/SP,0,814,-5,28237
701805,2022-05-06,Indaiatuba/SP,0,814,-3,28234
707402,2022-05-07,Indaiatuba/SP,0,814,-4,28230
712999,2022-05-08,Indaiatuba/SP,0,814,0,28230
718596,2022-05-09,Indaiatuba/SP,0,814,0,28230
724193,2022-05-10,Indaiatuba/SP,0,814,22,28252
729790,2022-05-11,Indaiatuba/SP,0,814,6,28258
735387,2022-05-12,Indaiatuba/SP,0,814,18,28276
740984,2022-05-13,Indaiatuba/SP,1,815,0,28276
746581,2022-05-14,Indaiatuba/SP,1,816,12,28288
752178,2022-05-15,Indaiatuba/SP,0,816,0,28288
757775,2022-05-16,Indaiatuba/SP,0,816,0,28288
763372,2022-05-17,Indaiatuba/SP,0,816,-7,28281
768969,2022-05-18,Indaiatuba/SP,1,817,23,28304
774566,2022-05-19,Indaiatuba/SP,0,817,6,28310
780163,2022-05-20,Indaiatuba/SP,0,817,0,28310
785760,2022-05-21,Indaiatuba/SP,0,817,0,28310
791357,2022-05-22,Indaiatuba/SP,0,817,-4,28306
796954,2022-05-23,Indaiatuba/SP,0,817,0,28306
802551,2022-05-24,Indaiatuba/SP,1,818,7,28313
808148,2022-05-25,Indaiatuba/SP,1,819,0,28313
813745,2022-05-26,Indaiatuba/SP,1,820,7,28320
819342,2022-05-27,Indaiatuba/SP,0,820,-2,28318
824939,2022-05-28,Indaiatuba/SP,0,820,6,28324
830536,2022-05-29,Indaiatuba/SP,0,820,0,28324
836133,2022-05-30,Indaiatuba/SP,0,820,0,28324
841730,2022-05-31,Indaiatuba/SP,0,820,5,28329
847327,2022-06-01,Indaiatuba/SP,0,820,6,28335
852924,2022-06-02,Indaiatuba/SP,-1,819,-4,28331
858521,2022-06-03,Indaiatuba/SP,0,819,0,28331
864118,2022-06-04,Indaiatuba/SP,0,819,0,28331
869715,2022-06-05,Indaiatuba/SP,0,819,0,28331
875312,2022-06-06,Indaiatuba/SP,0,819,0,28331
880909,2022-06-07,Indaiatuba/SP,4,823,85,28416
886506,2022-06-08,Indaiatuba/SP,1,824,20,28436
892103,2022-06-09,Indaiatuba/SP,0,824,24,28460
897700,2022-06-10,Indaiatuba/SP,0,824,27,28487
903297,2022-06-11,Indaiatuba/SP,2,826,44,28531
908894,2022-06-12,Indaiatuba/SP,0,826,0,28531
914491,2022-06-13,Indaiatuba/SP,0,826,0,28531
920088,2022-06-14,Indaiatuba/SP,0,826,0,28531
925685,2022-06-15,Indaiatuba/SP,3,829,51,28582
931282,2022-06-16,Indaiatuba/SP,1,830,8,28590
936879,2022-06-17,Indaiatuba/SP,0,830,0,28590
942476,2022-06-18,Indaiatuba/SP,0,830,0,28590
948073,2022-06-19,Indaiatuba/SP,0,830,0,28590
953670,2022-06-20,Indaiatuba/SP,0,830,0,28590
959267,2022-06-21,Indaiatuba/SP,0,830,12,28602
964864,2022-06-22,Indaiatuba/SP,0,830,-2,28600
970461,2022-06-23,Indaiatuba/SP,2,832,19,28619
976058,2022-06-24,Indaiatuba/SP,2,834,6,28625
981655,2022-06-25,Indaiatuba/SP,0,834,2,28627
987252,2022-06-26,Indaiatuba/SP,0,834,1,28628
992849,2022-06-27,Indaiatuba/SP,0,834,0,28628
998446,2022-06-28,Indaiatuba/SP,0,834,9,28637
1004043,2022-06-29,Indaiatuba/SP,0,834,7,28644
1009640,2022-06-30,Indaiatuba/SP,-1,833,0,28644
1015237,2022-07-01,Indaiatuba/SP,1,834,20,28664
1020834,2022-07-02,Indaiatuba/SP,0,834,-1,28663
1026431,2022-07-03,Indaiatuba/SP,0,834,0,28663
1032028,2022-07-04,Indaiatuba/SP,0,834,0,28663
1037625,2022-07-05,Indaiatuba/SP,0,834,32,28695
1043222,2022-07-06,Indaiatuba/SP,1,835,32,28727
1048819,2022-07-07,Indaiatuba/SP,1,836,16,28743
1054416,2022-07-08,Indaiatuba/SP,2,838,5,28748
1060013,2022-07-09,Indaiatuba/SP,0,838,1,28749
1065610,2022-07-10,Indaiatuba/SP,0,838,0,28749
1071207,2022-07-11,Indaiatuba/SP,0,838,0,28749
1076804,2022-07-12,Indaiatuba/SP,1,839,-1,28748
1082401,2022-07-13,Indaiatuba/SP,0,839,2,28750
1087998,2022-07-14,Indaiatuba/SP,-3,836,-5,28745
1093595,2022-07-15,Indaiatuba/SP,0,836,-6,28739
1099192,2022-07-16,Indaiatuba/SP,1,837,1,28740
1104789,2022-07-17,Indaiatuba/SP,0,837,0,28740
1110386,2022-07-18,Indaiatuba/SP,0,837,0,28740
1115983,2022-07-19,Indaiatuba/SP,0,837,-1,28739
1121580,2022-07-20,Indaiatuba/SP,1,838,1,28740
1127177,2022-07-21,Indaiatuba/SP,0,838,-13,28727
1132774,2022-07-22,Indaiatuba/SP,1,839,1,28728
1138371,2022-07-23,Indaiatuba/SP,2,841,0,28728
1143968,2022-07-24,Indaiatuba/SP,0,841,0,28728
1149565,2022-07-25,Indaiatuba/SP,0,841,0,28728
1155162,2022-07-26,Indaiatuba/SP,0,841,1,28729
1160759,2022-07-27,Indaiatuba/SP,1,842,38,28767
1166356,2022-07-28,Indaiatuba/SP,0,842,37,28804
1171953,2022-07-29,Indaiatuba/SP,0,842,13,28817
1177550,2022-07-30,Indaiatuba/SP,1,843,19,28836
1183147,2022-07-31,Indaiatuba/SP,0,843,0,28836
1188744,2022-08-01,Indaiatuba/SP,0,843,0,28836
1194341,2022-08-02,Indaiatuba/SP,1,844,22,28858
1199938,2022-08-03,Indaiatuba/SP,0,844,16,28874
1205535,2022-08-04,Indaiatuba/SP,0,844,34,28908
1211132,2022-08-05,Indaiatuba/SP,1,845,29,28937
1216729,2022-08-06,Indaiatuba/SP,0,845,28,28965
1222326,2022-08-07,Indaiatuba/SP,0,845,0,28965
1227923,2022-08-08,Indaiatuba/SP,0,845,0,28965
1233520,2022-08-09,Indaiatuba/SP,0,845,19,28984
1239117,2022-08-10,Indaiatuba/SP,0,845,31,29015
1244714,2022-08-11,Indaiatuba/SP,1,846,21,29036
1250311,2022-08-12,Indaiatuba/SP,0,846,25,29061
1255908,2022-08-13,Indaiatuba/SP,0,846,0,29061
1261505,2022-08-14,Indaiatuba/SP,0,846,0,29061
1267102,2022-08-15,Indaiatuba/SP,0,846,0,29061
1272699,2022-08-16,Indaiatuba/SP,0,846,32,29093
1278296,2022-08-17,Indaiatuba/SP,0,846,21,29114
1283893,2022-08-18,Indaiatuba/SP,0,846,35,29149
1289490,2022-08-19,Indaiatuba/SP,0,846,9,29158
1295087,2022-08-20,Indaiatuba/SP,-1,845,2,29160
1300684,2022-08-21,Indaiatuba/SP,0,845,0,29160
1306281,2022-08-22,Indaiatuba/SP,0,845,0,29160
1311878,2022-08-23,Indaiatuba/SP,0,845,2,29162
1317475,2022-08-24,Indaiatuba/SP,0,845,2,29164
1323072,2022-08-25,Indaiatuba/SP,0,845,0,29164
2363,2022-01-01,Itapira/SP,0,322,0,9904
7960,2022-01-02,Itapira/SP,0,322,0,9904
13557,2022-01-03,Itapira/SP,0,322,0,9904
19154,2022-01-04,Itapira/SP,0,322,20,9924
24751,2022-01-05,Itapira/SP,0,322,0,9924
30348,2022-01-06,Itapira/SP,-1,321,4,9928
35945,2022-01-07,Itapira/SP,0,321,5,9933
41542,2022-01-08,Itapira/SP,0,321,20,9953
47139,2022-01-09,Itapira/SP,0,321,0,9953
52736,2022-01-10,Itapira/SP,0,321,0,9953
58333,2022-01-11,Itapira/SP,0,321,-1,9952
63930,2022-01-12,Itapira/SP,0,321,2,9954
69527,2022-01-13,Itapira/SP,0,321,19,9973
75124,2022-01-14,Itapira/SP,0,321,12,9985
80721,2022-01-15,Itapira/SP,0,321,0,9985
86318,2022-01-16,Itapira/SP,0,321,0,9985
91915,2022-01-17,Itapira/SP,0,321,0,9985
97512,2022-01-18,Itapira/SP,0,321,5,9990
103109,2022-01-19,Itapira/SP,1,322,8,9998
108706,2022-01-20,Itapira/SP,0,322,5,10003
114303,2022-01-21,Itapira/SP,0,322,0,10003
119900,2022-01-22,Itapira/SP,0,322,0,10003
125497,2022-01-23,Itapira/SP,0,322,4,10007
131094,2022-01-24,Itapira/SP,0,322,0,10007
136691,2022-01-25,Itapira/SP,0,322,2,10009
142288,2022-01-26,Itapira/SP,0,322,3,10012
147885,2022-01-27,Itapira/SP,0,322,1,10013
153482,2022-01-28,Itapira/SP,0,322,39,10052
159079,2022-01-29,Itapira/SP,0,322,0,10052
164676,2022-01-30,Itapira/SP,0,322,0,10052
170273,2022-01-31,Itapira/SP,0,322,0,10052
175870,2022-02-01,Itapira/SP,0,322,0,10052
181467,2022-02-02,Itapira/SP,0,322,0,10052
187064,2022-02-03,Itapira/SP,1,323,2,10054
192661,2022-02-04,Itapira/SP,0,323,0,10054
198258,2022-02-05,Itapira/SP,1,324,6,10060
203855,2022-02-06,Itapira/SP,0,324,0,10060
209452,2022-02-07,Itapira/SP,0,324,0,10060
215049,2022-02-08,Itapira/SP,0,324,33,10093
220646,2022-02-09,Itapira/SP,0,324,31,10124
226243,2022-02-10,Itapira/SP,1,325,35,10159
231840,2022-02-11,Itapira/SP,0,325,52,10211
237437,2022-02-12,Itapira/SP,2,327,22,10233
243034,2022-02-13,Itapira/SP,0,327,0,10233
248631,2022-02-14,Itapira/SP,0,327,0,10233
254228,2022-02-15,Itapira/SP,0,327,38,10271
259825,2022-02-16,Itapira/SP,0,327,34,10305
265422,2022-02-17,Itapira/SP,3,330,10,10315
271019,2022-02-18,Itapira/SP,0,330,21,10336
276616,2022-02-19,Itapira/SP,0,330,23,10359
282213,2022-02-20,Itapira/SP,0,330,3,10362
287810,2022-02-21,Itapira/SP,0,330,0,10362
293407,2022-02-22,Itapira/SP,3,333,7,10369
299004,2022-02-23,Itapira/SP,0,333,120,10489
304601,2022-02-24,Itapira/SP,0,333,125,10614
310198,2022-02-25,Itapira/SP,0,333,167,10781
315795,2022-02-26,Itapira/SP,1,334,198,10979
321392,2022-02-27,Itapira/SP,0,334,0,10979
326989,2022-02-28,Itapira/SP,0,334,0,10979
332586,2022-03-01,Itapira/SP,0,334,1,10980
338183,2022-03-02,Itapira/SP,0,334,0,10980
343780,2022-03-03,Itapira/SP,1,335,206,11186
349377,2022-03-04,Itapira/SP,0,335,195,11381
354974,2022-03-05,Itapira/SP,0,335,100,11481
360571,2022-03-06,Itapira/SP,0,335,0,11481
366168,2022-03-07,Itapira/SP,0,335,0,11481
371765,2022-03-08,Itapira/SP,0,335,169,11650
377362,2022-03-09,Itapira/SP,0,335,37,11687
382959,2022-03-10,Itapira/SP,1,336,155,11842
388556,2022-03-11,Itapira/SP,0,336,173,12015
394153,2022-03-12,Itapira/SP,2,338,127,12142
399750,2022-03-13,Itapira/SP,0,338,2,12144
405347,2022-03-14,Itapira/SP,0,338,2,12146
410944,2022-03-15,Itapira/SP,2,340,143,12289
416541,2022-03-16,Itapira/SP,0,340,144,12433
422138,2022-03-17,Itapira/SP,6,346,87,12520
427735,2022-03-18,Itapira/SP,2,348,42,12562
433332,2022-03-19,Itapira/SP,0,348,52,12614
438929,2022-03-20,Itapira/SP,0,348,0,12614
444526,2022-03-21,Itapira/SP,0,348,0,12614
450123,2022-03-22,Itapira/SP,0,348,80,12694
455720,2022-03-23,Itapira/SP,0,348,71,12765
461317,2022-03-24,Itapira/SP,0,348,46,12811
466914,2022-03-25,Itapira/SP,6,354,72,12883
472511,2022-03-26,Itapira/SP,0,354,78,12961
478108,2022-03-27,Itapira/SP,0,354,0,12961
483705,2022-03-28,Itapira/SP,0,354,0,12961
489302,2022-03-29,Itapira/SP,0,354,33,12994
494899,2022-03-30,Itapira/SP,1,355,64,13058
500496,2022-03-31,Itapira/SP,0,355,60,13118
506093,2022-04-01,Itapira/SP,0,355,66,13184
511690,2022-04-02,Itapira/SP,1,356,58,13242
517287,2022-04-03,Itapira/SP,0,356,92,13334
522884,2022-04-04,Itapira/SP,0,356,0,13334
528481,2022-04-05,Itapira/SP,0,356,66,13400
534078,2022-04-06,Itapira/SP,0,356,43,13443
539675,2022-04-07,Itapira/SP,0,356,65,13508
545272,2022-04-08,Itapira/SP,0,356,1,13509
550869,2022-04-09,Itapira/SP,1,357,30,13539
556466,2022-04-10,Itapira/SP,0,357,0,13539
562063,2022-04-11,Itapira/SP,0,357,0,13539
567660,2022-04-12,Itapira/SP,1,358,4,13543
573257,2022-04-13,Itapira/SP,0,358,2,13545
578854,2022-04-14,Itapira/SP,0,358,1,13546
584451,2022-04-15,Itapira/SP,1,359,3,13549
590048,2022-04-16,Itapira/SP,0,359,0,13549
595645,2022-04-17,Itapira/SP,0,359,0,13549
601242,2022-04-18,Itapira/SP,0,359,0,13549
606839,2022-04-19,Itapira/SP,0,359,0,13549
612436,2022-04-20,Itapira/SP,0,359,1,13550
618033,2022-04-21,Itapira/SP,0,359,0,13550
623630,2022-04-22,Itapira/SP,0,359,0,13550
629227,2022-04-23,Itapira/SP,0,359,0,13550
634824,2022-04-24,Itapira/SP,0,359,0,13550
640421,2022-04-25,Itapira/SP,0,359,0,13550
646018,2022-04-26,Itapira/SP,0,359,0,13550
651615,2022-04-27,Itapira/SP,0,359,1,13551
657212,2022-04-28,Itapira/SP,0,359,0,13551
662809,2022-04-29,Itapira/SP,0,359,1,13552
668406,2022-04-30,Itapira/SP,0,359,0,13552
674003,2022-05-01,Itapira/SP,0,359,11,13563
679600,2022-05-02,Itapira/SP,0,359,0,13563
685197,2022-05-03,Itapira/SP,0,359,30,13593
690794,2022-05-04,Itapira/SP,0,359,7,13600
696391,2022-05-05,Itapira/SP,0,359,23,13623
701988,2022-05-06,Itapira/SP,1,360,11,13634
707585,2022-05-07,Itapira/SP,0,360,21,13655
713182,2022-05-08,Itapira/SP,0,360,0,13655
718779,2022-05-09,Itapira/SP,0,360,0,13655
724376,2022-05-10,Itapira/SP,0,360,5,13660
729973,2022-05-11,Itapira/SP,0,360,16,13676
735570,2022-05-12,Itapira/SP,0,360,0,13676
741167,2022-05-13,Itapira/SP,0,360,46,13722
746764,2022-05-14,Itapira/SP,0,360,2,13724
752361,2022-05-15,Itapira/SP,0,360,0,13724
757958,2022-05-16,Itapira/SP,0,360,0,13724
763555,2022-05-17,Itapira/SP,0,360,16,13740
769152,2022-05-18,Itapira/SP,0,360,1,13741
774749,2022-05-19,Itapira/SP,0,360,0,13741
780346,2022-05-20,Itapira/SP,0,360,0,13741
785943,2022-05-21,Itapira/SP,0,360,0,13741
791540,2022-05-22,Itapira/SP,0,360,109,13850
797137,2022-05-23,Itapira/SP,0,360,0,13850
802734,2022-05-24,Itapira/SP,0,360,43,13893
808331,2022-05-25,Itapira/SP,0,360,60,13953
813928,2022-05-26,Itapira/SP,0,360,0,13953
819525,2022-05-27,Itapira/SP,0,360,26,13979
825122,2022-05-28,Itapira/SP,0,360,36,14015
830719,2022-05-29,Itapira/SP,0,360,0,14015
836316,2022-05-30,Itapira/SP,1,361,1,14016
841913,2022-05-31,Itapira/SP,0,361,32,14048
847510,2022-06-01,Itapira/SP,0,361,0,14048
853107,2022-06-02,Itapira/SP,0,361,1,14049
858704,2022-06-03,Itapira/SP,0,361,0,14049
864301,2022-06-04,Itapira/SP,0,361,0,14049
869898,2022-06-05,Itapira/SP,0,361,0,14049
875495,2022-06-06,Itapira/SP,0,361,0,14049
881092,2022-06-07,Itapira/SP,0,361,129,14178
886689,2022-06-08,Itapira/SP,0,361,101,14279
892286,2022-06-09,Itapira/SP,0,361,12,14291
897883,2022-06-10,Itapira/SP,0,361,27,14318
903480,2022-06-11,Itapira/SP,0,361,15,14333
909077,2022-06-12,Itapira/SP,0,361,0,14333
914674,2022-06-13,Itapira/SP,0,361,0,14333
920271,2022-06-14,Itapira/SP,0,361,0,14333
925868,2022-06-15,Itapira/SP,0,361,18,14351
931465,2022-06-16,Itapira/SP,0,361,0,14351
937062,2022-06-17,Itapira/SP,0,361,0,14351
942659,2022-06-18,Itapira/SP,0,361,0,14351
948256,2022-06-19,Itapira/SP,0,361,0,14351
953853,2022-06-20,Itapira/SP,0,361,0,14351
959450,2022-06-21,Itapira/SP,0,361,68,14419
965047,2022-06-22,Itapira/SP,0,361,49,14468
970644,2022-06-23,Itapira/SP,0,361,38,14506
976241,2022-06-24,Itapira/SP,0,361,0,14506
981838,2022-06-25,Itapira/SP,0,361,34,14540
987435,2022-06-26,Itapira/SP,0,361,0,14540
993032,2022-06-27,Itapira/SP,0,361,0,14540
998629,2022-06-28,Itapira/SP,0,361,41,14581
1004226,2022-06-29,Itapira/SP,0,361,102,14683
1009823,2022-06-30,Itapira/SP,0,361,48,14731
1015420,2022-07-01,Itapira/SP,0,361,35,14766
1021017,2022-07-02,Itapira/SP,0,361,102,14868
1026614,2022-07-03,Itapira/SP,0,361,0,14868
1032211,2022-07-04,Itapira/SP,0,361,0,14868
1037808,2022-07-05,Itapira/SP,1,362,150,15018
1043405,2022-07-06,Itapira/SP,0,362,232,15250
1049002,2022-07-07,Itapira/SP,0,362,17,15267
1054599,2022-07-08,Itapira/SP,0,362,158,15425
1060196,2022-07-09,Itapira/SP,0,362,67,15492
1065793,2022-07-10,Itapira/SP,0,362,2,15494
1071390,2022-07-11,Itapira/SP,0,362,0,15494
1076987,2022-07-12,Itapira/SP,0,362,11,15505
1082584,2022-07-13,Itapira/SP,0,362,12,15517
1088181,2022-07-14,Itapira/SP,0,362,1,15518
1093778,2022-07-15,Itapira/SP,0,362,18,15536
1099375,2022-07-16,Itapira/SP,0,362,102,15638
1104972,2022-07-17,Itapira/SP,0,362,0,15638
1110569,2022-07-18,Itapira/SP,0,362,0,15638
1116166,2022-07-19,Itapira/SP,0,362,145,15783
1121763,2022-07-20,Itapira/SP,0,362,15,15798
1127360,2022-07-21,Itapira/SP,0,362,8,15806
1132957,2022-07-22,Itapira/SP,0,362,106,15912
1138554,2022-07-23,Itapira/SP,1,363,62,15974
1144151,2022-07-24,Itapira/SP,0,363,0,15974
1149748,2022-07-25,Itapira/SP,0,363,0,15974
1155345,2022-07-26,Itapira/SP,0,363,56,16030
1160942,2022-07-27,Itapira/SP,0,363,13,16043
1166539,2022-07-28,Itapira/SP,0,363,0,16043
1172136,2022-07-29,Itapira/SP,0,363,0,16043
1177733,2022-07-30,Itapira/SP,0,363,6,16049
1183330,2022-07-31,Itapira/SP,0,363,0,16049
1188927,2022-08-01,Itapira/SP,0,363,0,16049
1194524,2022-08-02,Itapira/SP,0,363,28,16077
1200121,2022-08-03,Itapira/SP,0,363,74,16151
1205718,2022-08-04,Itapira/SP,0,363,9,16160
1211315,2022-08-05,Itapira/SP,0,363,46,16206
1216912,2022-08-06,Itapira/SP,0,363,53,16259
1222509,2022-08-07,Itapira/SP,0,363,0,16259
1228106,2022-08-08,Itapira/SP,0,363,0,16259
1233703,2022-08-09,Itapira/SP,0,363,12,16271
1239300,2022-08-10,Itapira/SP,0,363,23,16294
1244897,2022-08-11,Itapira/SP,3,366,3,16297
1250494,2022-08-12,Itapira/SP,0,366,4,16301
1256091,2022-08-13,Itapira/SP,0,366,-3,16298
1261688,2022-08-14,Itapira/SP,0,366,0,16298
1267285,2022-08-15,Itapira/SP,0,366,0,16298
1272882,2022-08-16,Itapira/SP,0,366,2,16300
1278479,2022-08-17,Itapira/SP,1,367,7,16307
1284076,2022-08-18,Itapira/SP,0,367,1,16308
1289673,2022-08-19,Itapira/SP,0,367,-6,16302
1295270,2022-08-20,Itapira/SP,0,367,4,16306
1300867,2022-08-21,Itapira/SP,0,367,0,16306
1306464,2022-08-22,Itapira/SP,0,367,0,16306
1312061,2022-08-23,Itapira/SP,0,367,1,16307
1317658,2022-08-24,Itapira/SP,0,367,10,16317
1323255,2022-08-25,Itapira/SP,0,367,2,16319
3090,2022-01-01,Mococa/SP,0,247,0,6141
8687,2022-01-02,Mococa/SP,0,247,0,6141
14284,2022-01-03,Mococa/SP,0,247,0,6141
19881,2022-01-04,Mococa/SP,0,247,34,6175
25478,2022-01-05,Mococa/SP,0,247,9,6184
31075,2022-01-06,Mococa/SP,0,247,30,6214
36672,2022-01-07,Mococa/SP,0,247,0,6214
42269,2022-01-08,Mococa/SP,0,247,0,6214
47866,2022-01-09,Mococa/SP,0,247,0,6214
53463,2022-01-10,Mococa/SP,0,247,0,6214
59060,2022-01-11,Mococa/SP,0,247,26,6240
64657,2022-01-12,Mococa/SP,0,247,7,6247
70254,2022-01-13,Mococa/SP,0,247,3,6250
75851,2022-01-14,Mococa/SP,0,247,49,6299
81448,2022-01-15,Mococa/SP,0,247,0,6299
87045,2022-01-16,Mococa/SP,0,247,0,6299
92642,2022-01-17,Mococa/SP,0,247,0,6299
98239,2022-01-18,Mococa/SP,0,247,45,6344
103836,2022-01-19,Mococa/SP,1,248,84,6428
109433,2022-01-20,Mococa/SP,0,248,45,6473
115030,2022-01-21,Mococa/SP,0,248,0,6473
120627,2022-01-22,Mococa/SP,0,248,0,6473
126224,2022-01-23,Mococa/SP,0,248,18,6491
131821,2022-01-24,Mococa/SP,0,248,0,6491
137418,2022-01-25,Mococa/SP,0,248,83,6574
143015,2022-01-26,Mococa/SP,0,248,31,6605
148612,2022-01-27,Mococa/SP,0,248,38,6643
154209,2022-01-28,Mococa/SP,0,248,60,6703
159806,2022-01-29,Mococa/SP,5,253,48,6751
165403,2022-01-30,Mococa/SP,0,253,0,6751
171000,2022-01-31,Mococa/SP,0,253,0,6751
176597,2022-02-01,Mococa/SP,0,253,83,6834
182194,2022-02-02,Mococa/SP,0,253,0,6834
187791,2022-02-03,Mococa/SP,0,253,139,6973
193388,2022-02-04,Mococa/SP,0,253,0,6973
198985,2022-02-05,Mococa/SP,0,253,125,7098
204582,2022-02-06,Mococa/SP,0,253,2,7100
210179,2022-02-07,Mococa/SP,0,253,0,7100
215776,2022-02-08,Mococa/SP,0,253,54,7154
221373,2022-02-09,Mococa/SP,0,253,58,7212
226970,2022-02-10,Mococa/SP,0,253,76,7288
232567,2022-02-11,Mococa/SP,0,253,65,7353
238164,2022-02-12,Mococa/SP,13,266,46,7399
243761,2022-02-13,Mococa/SP,0,266,0,7399
249358,2022-02-14,Mococa/SP,0,266,0,7399
254955,2022-02-15,Mococa/SP,0,266,79,7478
260552,2022-02-16,Mococa/SP,0,266,73,7551
266149,2022-02-17,Mococa/SP,4,270,87,7638
271746,2022-02-18,Mococa/SP,0,270,71,7709
277343,2022-02-19,Mococa/SP,0,270,43,7752
282940,2022-02-20,Mococa/SP,0,270,0,7752
288537,2022-02-21,Mococa/SP,0,270,0,7752
294134,2022-02-22,Mococa/SP,1,271,66,7818
299731,2022-02-23,Mococa/SP,0,271,93,7911
305328,2022-02-24,Mococa/SP,0,271,80,7991
310925,2022-02-25,Mococa/SP,0,271,64,8055
316522,2022-02-26,Mococa/SP,1,272,39,8094
322119,2022-02-27,Mococa/SP,0,272,0,8094
327716,2022-02-28,Mococa/SP,0,272,0,8094
333313,2022-03-01,Mococa/SP,0,272,0,8094
338910,2022-03-02,Mococa/SP,0,272,0,8094
344507,2022-03-03,Mococa/SP,0,272,28,8122
350104,2022-03-04,Mococa/SP,0,272,48,8170
355701,2022-03-05,Mococa/SP,0,272,44,8214
361298,2022-03-06,Mococa/SP,0,272,0,8214
366895,2022-03-07,Mococa/SP,0,272,0,8214
372492,2022-03-08,Mococa/SP,0,272,49,8263
378089,2022-03-09,Mococa/SP,2,274,89,8352
383686,2022-03-10,Mococa/SP,0,274,73,8425
389283,2022-03-11,Mococa/SP,0,274,37,8462
394880,2022-03-12,Mococa/SP,1,275,46,8508
400477,2022-03-13,Mococa/SP,0,275,0,8508
406074,2022-03-14,Mococa/SP,0,275,0,8508
411671,2022-03-15,Mococa/SP,0,275,34,8542
417268,2022-03-16,Mococa/SP,0,275,1,8543
422865,2022-03-17,Mococa/SP,2,277,36,8579
428462,2022-03-18,Mococa/SP,1,278,69,8648
434059,2022-03-19,Mococa/SP,0,278,50,8698
439656,2022-03-20,Mococa/SP,0,278,0,8698
445253,2022-03-21,Mococa/SP,0,278,0,8698
450850,2022-03-22,Mococa/SP,0,278,68,8766
456447,2022-03-23,Mococa/SP,0,278,88,8854
462044,2022-03-24,Mococa/SP,0,278,92,8946
467641,2022-03-25,Mococa/SP,0,278,47,8993
473238,2022-03-26,Mococa/SP,0,278,74,9067
478835,2022-03-27,Mococa/SP,0,278,0,9067
484432,2022-03-28,Mococa/SP,0,278,0,9067
490029,2022-03-29,Mococa/SP,0,278,30,9097
495626,2022-03-30,Mococa/SP,0,278,48,9145
501223,2022-03-31,Mococa/SP,0,278,63,9208
506820,2022-04-01,Mococa/SP,0,278,98,9306
512417,2022-04-02,Mococa/SP,0,278,39,9345
518014,2022-04-03,Mococa/SP,0,278,0,9345
523611,2022-04-04,Mococa/SP,0,278,0,9345
529208,2022-04-05,Mococa/SP,0,278,60,9405
534805,2022-04-06,Mococa/SP,0,278,0,9405
540402,2022-04-07,Mococa/SP,0,278,43,9448
545999,2022-04-08,Mococa/SP,0,278,62,9510
551596,2022-04-09,Mococa/SP,0,278,48,9558
557193,2022-04-10,Mococa/SP,0,278,0,9558
562790,2022-04-11,Mococa/SP,0,278,0,9558
568387,2022-04-12,Mococa/SP,0,278,45,9603
573984,2022-04-13,Mococa/SP,0,278,24,9627
579581,2022-04-14,Mococa/SP,0,278,44,9671
585178,2022-04-15,Mococa/SP,0,278,43,9714
590775,2022-04-16,Mococa/SP,0,278,0,9714
596372,2022-04-17,Mococa/SP,0,278,0,9714
601969,2022-04-18,Mococa/SP,0,278,0,9714
607566,2022-04-19,Mococa/SP,0,278,0,9714
613163,2022-04-20,Mococa/SP,0,278,35,9749
618760,2022-04-21,Mococa/SP,0,278,0,9749
624357,2022-04-22,Mococa/SP,0,278,0,9749
629954,2022-04-23,Mococa/SP,0,278,0,9749
635551,2022-04-24,Mococa/SP,0,278,0,9749
641148,2022-04-25,Mococa/SP,0,278,0,9749
646745,2022-04-26,Mococa/SP,0,278,16,9765
652342,2022-04-27,Mococa/SP,0,278,0,9765
657939,2022-04-28,Mococa/SP,0,278,0,9765
663536,2022-04-29,Mococa/SP,0,278,0,9765
669133,2022-04-30,Mococa/SP,0,278,7,9772
674730,2022-05-01,Mococa/SP,0,278,0,9772
680327,2022-05-02,Mococa/SP,0,278,0,9772
685924,2022-05-03,Mococa/SP,0,278,18,9790
691521,2022-05-04,Mococa/SP,0,278,32,9822
697118,2022-05-05,Mococa/SP,0,278,29,9851
702715,2022-05-06,Mococa/SP,0,278,63,9914
708312,2022-05-07,Mococa/SP,0,278,12,9926
713909,2022-05-08,Mococa/SP,0,278,0,9926
719506,2022-05-09,Mococa/SP,0,278,0,9926
725103,2022-05-10,Mococa/SP,0,278,11,9937
730700,2022-05-11,Mococa/SP,0,278,0,9937
736297,2022-05-12,Mococa/SP,0,278,26,9963
741894,2022-05-13,Mococa/SP,0,278,0,9963
747491,2022-05-14,Mococa/SP,0,278,21,9984
753088,2022-05-15,Mococa/SP,0,278,0,9984
758685,2022-05-16,Mococa/SP,0,278,0,9984
764282,2022-05-17,Mococa/SP,0,278,9,9993
769879,2022-05-18,Mococa/SP,0,278,0,9993
775476,2022-05-19,Mococa/SP,0,278,0,9993
781073,2022-05-20,Mococa/SP,0,278,0,9993
786670,2022-05-21,Mococa/SP,0,278,0,9993
792267,2022-05-22,Mococa/SP,0,278,29,10022
797864,2022-05-23,Mococa/SP,0,278,0,10022
803461,2022-05-24,Mococa/SP,0,278,45,10067
809058,2022-05-25,Mococa/SP,0,278,47,10114
814655,2022-05-26,Mococa/SP,0,278,62,10176
820252,2022-05-27,Mococa/SP,0,278,26,10202
825849,2022-05-28,Mococa/SP,0,278,24,10226
831446,2022-05-29,Mococa/SP,0,278,0,10226
837043,2022-05-30,Mococa/SP,0,278,0,10226
842640,2022-05-31,Mococa/SP,0,278,40,10266
848237,2022-06-01,Mococa/SP,0,278,53,10319
853834,2022-06-02,Mococa/SP,0,278,38,10357
859431,2022-06-03,Mococa/SP,0,278,0,10357
865028,2022-06-04,Mococa/SP,0,278,0,10357
870625,2022-06-05,Mococa/SP,0,278,0,10357
876222,2022-06-06,Mococa/SP,0,278,0,10357
881819,2022-06-07,Mococa/SP,0,278,114,10471
887416,2022-06-08,Mococa/SP,0,278,1,10472
893013,2022-06-09,Mococa/SP,0,278,4,10476
898610,2022-06-10,Mococa/SP,0,278,14,10490
904207,2022-06-11,Mococa/SP,1,279,20,10510
909804,2022-06-12,Mococa/SP,0,279,0,10510
915401,2022-06-13,Mococa/SP,0,279,0,10510
920998,2022-06-14,Mococa/SP,0,279,0,10510
926595,2022-06-15,Mococa/SP,0,279,85,10595
932192,2022-06-16,Mococa/SP,1,280,32,10627
937789,2022-06-17,Mococa/SP,0,280,0,10627
943386,2022-06-18,Mococa/SP,0,280,0,10627
948983,2022-06-19,Mococa/SP,0,280,0,10627
954580,2022-06-20,Mococa/SP,0,280,0,10627
960177,2022-06-21,Mococa/SP,0,280,36,10663
965774,2022-06-22,Mococa/SP,0,280,20,10683
971371,2022-06-23,Mococa/SP,0,280,18,10701
976968,2022-06-24,Mococa/SP,0,280,0,10701
982565,2022-06-25,Mococa/SP,0,280,21,10722
988162,2022-06-26,Mococa/SP,0,280,0,10722
993759,2022-06-27,Mococa/SP,0,280,0,10722
999356,2022-06-28,Mococa/SP,0,280,12,10734
1004953,2022-06-29,Mococa/SP,0,280,10,10744
1010550,2022-06-30,Mococa/SP,1,281,38,10782
1016147,2022-07-01,Mococa/SP,0,281,59,10841
1021744,2022-07-02,Mococa/SP,0,281,44,10885
1027341,2022-07-03,Mococa/SP,0,281,0,10885
1032938,2022-07-04,Mococa/SP,0,281,0,10885
1038535,2022-07-05,Mococa/SP,0,281,23,10908
1044132,2022-07-06,Mococa/SP,0,281,23,10931
1049729,2022-07-07,Mococa/SP,0,281,2,10933
1055326,2022-07-08,Mococa/SP,0,281,26,10959
1060923,2022-07-09,Mococa/SP,0,281,20,10979
1066520,2022-07-10,Mococa/SP,0,281,0,10979
1072117,2022-07-11,Mococa/SP,0,281,0,10979
1077714,2022-07-12,Mococa/SP,0,281,21,11000
1083311,2022-07-13,Mococa/SP,0,281,30,11030
1088908,2022-07-14,Mococa/SP,0,281,27,11057
1094505,2022-07-15,Mococa/SP,0,281,21,11078
1100102,2022-07-16,Mococa/SP,1,282,35,11113
1105699,2022-07-17,Mococa/SP,0,282,0,11113
1111296,2022-07-18,Mococa/SP,0,282,0,11113
1116893,2022-07-19,Mococa/SP,0,282,27,11140
1122490,2022-07-20,Mococa/SP,1,283,29,11169
1128087,2022-07-21,Mococa/SP,0,283,24,11193
1133684,2022-07-22,Mococa/SP,0,283,40,11233
1139281,2022-07-23,Mococa/SP,0,283,0,11233
1144878,2022-07-24,Mococa/SP,0,283,0,11233
1150475,2022-07-25,Mococa/SP,0,283,0,11233
1156072,2022-07-26,Mococa/SP,2,285,17,11250
1161669,2022-07-27,Mococa/SP,0,285,33,11283
1167266,2022-07-28,Mococa/SP,0,285,24,11307
1172863,2022-07-29,Mococa/SP,0,285,40,11347
1178460,2022-07-30,Mococa/SP,0,285,46,11393
1184057,2022-07-31,Mococa/SP,0,285,0,11393
1189654,2022-08-01,Mococa/SP,0,285,0,11393
1195251,2022-08-02,Mococa/SP,0,285,49,11442
1200848,2022-08-03,Mococa/SP,0,285,33,11475
1206445,2022-08-04,Mococa/SP,0,285,45,11520
1212042,2022-08-05,Mococa/SP,0,285,44,11564
1217639,2022-08-06,Mococa/SP,0,285,30,11594
1223236,2022-08-07,Mococa/SP,0,285,0,11594
1228833,2022-08-08,Mococa/SP,0,285,0,11594
1234430,2022-08-09,Mococa/SP,0,285,32,11626
1240027,2022-08-10,Mococa/SP,0,285,40,11666
1245624,2022-08-11,Mococa/SP,0,285,40,11706
1251221,2022-08-12,Mococa/SP,2,287,39,11745
1256818,2022-08-13,Mococa/SP,0,287,44,11789
1262415,2022-08-14,Mococa/SP,0,287,0,11789
1268012,2022-08-15,Mococa/SP,0,287,0,11789
1273609,2022-08-16,Mococa/SP,0,287,49,11838
1279206,2022-08-17,Mococa/SP,0,287,48,11886
1284803,2022-08-18,Mococa/SP,0,287,62,11948
1290400,2022-08-19,Mococa/SP,0,287,49,11997
1295997,2022-08-20,Mococa/SP,0,287,37,12034
1301594,2022-08-21,Mococa/SP,0,287,0,12034
1307191,2022-08-22,Mococa/SP,0,287,0,12034
1312788,2022-08-23,Mococa/SP,0,287,45,12079
1318385,2022-08-24,Mococa/SP,0,287,36,12115
1323982,2022-08-25,Mococa/SP,0,287,44,12159
3095,2022-01-01,Mogi Guaçu/SP,0,608,0,20375
8692,2022-01-02,Mogi Guaçu/SP,0,608,0,20375
14289,2022-01-03,Mogi Guaçu/SP,0,608,0,20375
19886,2022-01-04,Mogi Guaçu/SP,0,608,8,20383
25483,2022-01-05,Mogi Guaçu/SP,0,608,100,20483
31080,2022-01-06,Mogi Guaçu/SP,0,608,51,20534
36677,2022-01-07,Mogi Guaçu/SP,0,608,62,20596
42274,2022-01-08,Mogi Guaçu/SP,0,608,107,20703
47871,2022-01-09,Mogi Guaçu/SP,0,608,26,20729
53468,2022-01-10,Mogi Guaçu/SP,0,608,0,20729
59065,2022-01-11,Mogi Guaçu/SP,0,608,178,20907
64662,2022-01-12,Mogi Guaçu/SP,1,609,151,21058
70259,2022-01-13,Mogi Guaçu/SP,0,609,33,21091
75856,2022-01-14,Mogi Guaçu/SP,0,609,208,21299
81453,2022-01-15,Mogi Guaçu/SP,0,609,10,21309
87050,2022-01-16,Mogi Guaçu/SP,0,609,150,21459
92647,2022-01-17,Mogi Guaçu/SP,0,609,0,21459
98244,2022-01-18,Mogi Guaçu/SP,0,609,289,21748
103841,2022-01-19,Mogi Guaçu/SP,0,609,210,21958
109438,2022-01-20,Mogi Guaçu/SP,1,610,245,22203
115035,2022-01-21,Mogi Guaçu/SP,1,611,121,22324
120632,2022-01-22,Mogi Guaçu/SP,0,611,0,22324
126229,2022-01-23,Mogi Guaçu/SP,1,612,407,22731
131826,2022-01-24,Mogi Guaçu/SP,0,612,0,22731
137423,2022-01-25,Mogi Guaçu/SP,0,612,132,22863
143020,2022-01-26,Mogi Guaçu/SP,4,616,256,23119
148617,2022-01-27,Mogi Guaçu/SP,2,618,208,23327
154214,2022-01-28,Mogi Guaçu/SP,0,618,180,23507
159811,2022-01-29,Mogi Guaçu/SP,1,619,174,23681
165408,2022-01-30,Mogi Guaçu/SP,0,619,225,23906
171005,2022-01-31,Mogi Guaçu/SP,0,619,0,23906
176602,2022-02-01,Mogi Guaçu/SP,0,619,251,24157
182199,2022-02-02,Mogi Guaçu/SP,2,621,2,24159
187796,2022-02-03,Mogi Guaçu/SP,2,623,501,24660
193393,2022-02-04,Mogi Guaçu/SP,0,623,0,24660
198990,2022-02-05,Mogi Guaçu/SP,3,626,676,25336
204587,2022-02-06,Mogi Guaçu/SP,0,626,157,25493
210184,2022-02-07,Mogi Guaçu/SP,0,626,0,25493
215781,2022-02-08,Mogi Guaçu/SP,1,627,207,25700
221378,2022-02-09,Mogi Guaçu/SP,0,627,366,26066
226975,2022-02-10,Mogi Guaçu/SP,1,628,207,26273
232572,2022-02-11,Mogi Guaçu/SP,1,629,313,26586
238169,2022-02-12,Mogi Guaçu/SP,1,630,255,26841
243766,2022-02-13,Mogi Guaçu/SP,0,630,195,27036
249363,2022-02-14,Mogi Guaçu/SP,0,630,0,27036
254960,2022-02-15,Mogi Guaçu/SP,0,630,248,27284
260557,2022-02-16,Mogi Guaçu/SP,3,633,246,27530
266154,2022-02-17,Mogi Guaçu/SP,3,636,396,27926
271751,2022-02-18,Mogi Guaçu/SP,0,636,329,28255
277348,2022-02-19,Mogi Guaçu/SP,0,636,333,28588
282945,2022-02-20,Mogi Guaçu/SP,0,636,75,28663
288542,2022-02-21,Mogi Guaçu/SP,0,636,0,28663
294139,2022-02-22,Mogi Guaçu/SP,0,636,189,28852
299736,2022-02-23,Mogi Guaçu/SP,1,637,171,29023
305333,2022-02-24,Mogi Guaçu/SP,0,637,264,29287
310930,2022-02-25,Mogi Guaçu/SP,0,637,177,29464
316527,2022-02-26,Mogi Guaçu/SP,2,639,153,29617
322124,2022-02-27,Mogi Guaçu/SP,0,639,25,29642
327721,2022-02-28,Mogi Guaçu/SP,0,639,-1,29641
333318,2022-03-01,Mogi Guaçu/SP,0,639,9,29650
338915,2022-03-02,Mogi Guaçu/SP,0,639,0,29650
344512,2022-03-03,Mogi Guaçu/SP,2,641,16,29666
350109,2022-03-04,Mogi Guaçu/SP,0,641,117,29783
355706,2022-03-05,Mogi Guaçu/SP,4,645,90,29873
361303,2022-03-06,Mogi Guaçu/SP,0,645,-1,29872
366900,2022-03-07,Mogi Guaçu/SP,0,645,0,29872
372497,2022-03-08,Mogi Guaçu/SP,0,645,203,30075
378094,2022-03-09,Mogi Guaçu/SP,1,646,147,30222
383691,2022-03-10,Mogi Guaçu/SP,1,647,116,30338
389288,2022-03-11,Mogi Guaçu/SP,0,647,193,30531
394885,2022-03-12,Mogi Guaçu/SP,0,647,91,30622
400482,2022-03-13,Mogi Guaçu/SP,0,647,16,30638
406079,2022-03-14,Mogi Guaçu/SP,0,647,1,30639
411676,2022-03-15,Mogi Guaçu/SP,0,647,166,30805
417273,2022-03-16,Mogi Guaçu/SP,0,647,118,30923
422870,2022-03-17,Mogi Guaçu/SP,0,647,114,31037
428467,2022-03-18,Mogi Guaçu/SP,0,647,110,31147
434064,2022-03-19,Mogi Guaçu/SP,1,648,56,31203
439661,2022-03-20,Mogi Guaçu/SP,0,648,4,31207
445258,2022-03-21,Mogi Guaçu/SP,0,648,0,31207
450855,2022-03-22,Mogi Guaçu/SP,1,649,41,31248
456452,2022-03-23,Mogi Guaçu/SP,0,649,40,31288
462049,2022-03-24,Mogi Guaçu/SP,0,649,58,31346
467646,2022-03-25,Mogi Guaçu/SP,0,649,129,31475
473243,2022-03-26,Mogi Guaçu/SP,1,650,89,31564
478840,2022-03-27,Mogi Guaçu/SP,0,650,28,31592
484437,2022-03-28,Mogi Guaçu/SP,0,650,0,31592
490034,2022-03-29,Mogi Guaçu/SP,0,650,14,31606
495631,2022-03-30,Mogi Guaçu/SP,2,652,15,31621
501228,2022-03-31,Mogi Guaçu/SP,0,652,4,31625
506825,2022-04-01,Mogi Guaçu/SP,0,652,8,31633
512422,2022-04-02,Mogi Guaçu/SP,0,652,8,31641
518019,2022-04-03,Mogi Guaçu/SP,0,652,1,31642
523616,2022-04-04,Mogi Guaçu/SP,0,652,0,31642
529213,2022-04-05,Mogi Guaçu/SP,0,652,89,31731
534810,2022-04-06,Mogi Guaçu/SP,0,652,19,31750
540407,2022-04-07,Mogi Guaçu/SP,0,652,67,31817
546004,2022-04-08,Mogi Guaçu/SP,0,652,73,31890
551601,2022-04-09,Mogi Guaçu/SP,0,652,4,31894
557198,2022-04-10,Mogi Guaçu/SP,0,652,1,31895
562795,2022-04-11,Mogi Guaçu/SP,0,652,0,31895
568392,2022-04-12,Mogi Guaçu/SP,0,652,163,32058
573989,2022-04-13,Mogi Guaçu/SP,0,652,256,32314
579586,2022-04-14,Mogi Guaçu/SP,0,652,108,32422
585183,2022-04-15,Mogi Guaçu/SP,0,652,13,32435
590780,2022-04-16,Mogi Guaçu/SP,0,652,0,32435
596377,2022-04-17,Mogi Guaçu/SP,0,652,0,32435
601974,2022-04-18,Mogi Guaçu/SP,0,652,0,32435
607571,2022-04-19,Mogi Guaçu/SP,0,652,0,32435
613168,2022-04-20,Mogi Guaçu/SP,0,652,134,32569
618765,2022-04-21,Mogi Guaçu/SP,0,652,3,32572
624362,2022-04-22,Mogi Guaçu/SP,0,652,0,32572
629959,2022-04-23,Mogi Guaçu/SP,0,652,0,32572
635556,2022-04-24,Mogi Guaçu/SP,0,652,0,32572
641153,2022-04-25,Mogi Guaçu/SP,0,652,0,32572
646750,2022-04-26,Mogi Guaçu/SP,0,652,6,32578
652347,2022-04-27,Mogi Guaçu/SP,0,652,8,32586
657944,2022-04-28,Mogi Guaçu/SP,0,652,7,32593
663541,2022-04-29,Mogi Guaçu/SP,0,652,2,32595
669138,2022-04-30,Mogi Guaçu/SP,0,652,1,32596
674735,2022-05-01,Mogi Guaçu/SP,0,652,-1,32595
680332,2022-05-02,Mogi Guaçu/SP,0,652,0,32595
685929,2022-05-03,Mogi Guaçu/SP,0,652,4,32599
691526,2022-05-04,Mogi Guaçu/SP,0,652,6,32605
697123,2022-05-05,Mogi Guaçu/SP,0,652,14,32619
702720,2022-05-06,Mogi Guaçu/SP,2,654,29,32648
708317,2022-05-07,Mogi Guaçu/SP,0,654,16,32664
713914,2022-05-08,Mogi Guaçu/SP,0,654,0,32664
719511,2022-05-09,Mogi Guaçu/SP,0,654,0,32664
725108,2022-05-10,Mogi Guaçu/SP,1,655,35,32699
730705,2022-05-11,Mogi Guaçu/SP,1,656,34,32733
736302,2022-05-12,Mogi Guaçu/SP,0,656,33,32766
741899,2022-05-13,Mogi Guaçu/SP,0,656,55,32821
747496,2022-05-14,Mogi Guaçu/SP,0,656,50,32871
753093,2022-05-15,Mogi Guaçu/SP,0,656,1,32872
758690,2022-05-16,Mogi Guaçu/SP,0,656,0,32872
764287,2022-05-17,Mogi Guaçu/SP,0,656,36,32908
769884,2022-05-18,Mogi Guaçu/SP,0,656,1,32909
775481,2022-05-19,Mogi Guaçu/SP,0,656,3,32912
781078,2022-05-20,Mogi Guaçu/SP,0,656,0,32912
786675,2022-05-21,Mogi Guaçu/SP,0,656,0,32912
792272,2022-05-22,Mogi Guaçu/SP,0,656,83,32995
797869,2022-05-23,Mogi Guaçu/SP,0,656,0,32995
803466,2022-05-24,Mogi Guaçu/SP,0,656,107,33102
809063,2022-05-25,Mogi Guaçu/SP,0,656,42,33144
814660,2022-05-26,Mogi Guaçu/SP,0,656,26,33170
820257,2022-05-27,Mogi Guaçu/SP,1,657,46,33216
825854,2022-05-28,Mogi Guaçu/SP,0,657,95,33311
831451,2022-05-29,Mogi Guaçu/SP,0,657,1,33312
837048,2022-05-30,Mogi Guaçu/SP,0,657,0,33312
842645,2022-05-31,Mogi Guaçu/SP,0,657,103,33415
848242,2022-06-01,Mogi Guaçu/SP,0,657,44,33459
853839,2022-06-02,Mogi Guaçu/SP,0,657,76,33535
859436,2022-06-03,Mogi Guaçu/SP,0,657,0,33535
865033,2022-06-04,Mogi Guaçu/SP,0,657,0,33535
870630,2022-06-05,Mogi Guaçu/SP,0,657,0,33535
876227,2022-06-06,Mogi Guaçu/SP,0,657,0,33535
881824,2022-06-07,Mogi Guaçu/SP,0,657,214,33749
887421,2022-06-08,Mogi Guaçu/SP,1,658,96,33845
893018,2022-06-09,Mogi Guaçu/SP,0,658,43,33888
898615,2022-06-10,Mogi Guaçu/SP,1,659,149,34037
904212,2022-06-11,Mogi Guaçu/SP,0,659,46,34083
909809,2022-06-12,Mogi Guaçu/SP,0,659,2,34085
915406,2022-06-13,Mogi Guaçu/SP,0,659,0,34085
921003,2022-06-14,Mogi Guaçu/SP,0,659,0,34085
926600,2022-06-15,Mogi Guaçu/SP,0,659,98,34183
932197,2022-06-16,Mogi Guaçu/SP,0,659,32,34215
937794,2022-06-17,Mogi Guaçu/SP,0,659,1,34216
943391,2022-06-18,Mogi Guaçu/SP,0,659,0,34216
948988,2022-06-19,Mogi Guaçu/SP,0,659,0,34216
954585,2022-06-20,Mogi Guaçu/SP,0,659,0,34216
960182,2022-06-21,Mogi Guaçu/SP,0,659,69,34285
965779,2022-06-22,Mogi Guaçu/SP,0,659,84,34369
971376,2022-06-23,Mogi Guaçu/SP,2,661,32,34401
976973,2022-06-24,Mogi Guaçu/SP,0,661,2,34403
982570,2022-06-25,Mogi Guaçu/SP,0,661,82,34485
988167,2022-06-26,Mogi Guaçu/SP,0,661,1,34486
993764,2022-06-27,Mogi Guaçu/SP,0,661,0,34486
999361,2022-06-28,Mogi Guaçu/SP,2,663,52,34538
1004958,2022-06-29,Mogi Guaçu/SP,0,663,117,34655
1010555,2022-06-30,Mogi Guaçu/SP,1,664,35,34690
1016152,2022-07-01,Mogi Guaçu/SP,0,664,114,34804
1021749,2022-07-02,Mogi Guaçu/SP,0,664,33,34837
1027346,2022-07-03,Mogi Guaçu/SP,0,664,0,34837
1032943,2022-07-04,Mogi Guaçu/SP,0,664,0,34837
1038540,2022-07-05,Mogi Guaçu/SP,0,664,43,34880
1044137,2022-07-06,Mogi Guaçu/SP,0,664,139,35019
1049734,2022-07-07,Mogi Guaçu/SP,1,665,84,35103
1055331,2022-07-08,Mogi Guaçu/SP,0,665,48,35151
1060928,2022-07-09,Mogi Guaçu/SP,1,666,61,35212
1066525,2022-07-10,Mogi Guaçu/SP,0,666,0,35212
1072122,2022-07-11,Mogi Guaçu/SP,0,666,0,35212
1077719,2022-07-12,Mogi Guaçu/SP,1,667,46,35258
1083316,2022-07-13,Mogi Guaçu/SP,1,668,66,35324
1088913,2022-07-14,Mogi Guaçu/SP,0,668,37,35361
1094510,2022-07-15,Mogi Guaçu/SP,0,668,73,35434
1100107,2022-07-16,Mogi Guaçu/SP,1,669,43,35477
1105704,2022-07-17,Mogi Guaçu/SP,0,669,1,35478
1111301,2022-07-18,Mogi Guaçu/SP,0,669,0,35478
1116898,2022-07-19,Mogi Guaçu/SP,2,671,57,35535
1122495,2022-07-20,Mogi Guaçu/SP,0,671,20,35555
1128092,2022-07-21,Mogi Guaçu/SP,0,671,59,35614
1133689,2022-07-22,Mogi Guaçu/SP,1,672,113,35727
1139286,2022-07-23,Mogi Guaçu/SP,2,674,69,35796
1144883,2022-07-24,Mogi Guaçu/SP,0,674,0,35796
1150480,2022-07-25,Mogi Guaçu/SP,0,674,0,35796
1156077,2022-07-26,Mogi Guaçu/SP,3,677,47,35843
1161674,2022-07-27,Mogi Guaçu/SP,1,678,34,35877
1167271,2022-07-28,Mogi Guaçu/SP,0,678,24,35901
1172868,2022-07-29,Mogi Guaçu/SP,1,679,33,35934
1178465,2022-07-30,Mogi Guaçu/SP,0,679,44,35978
1184062,2022-07-31,Mogi Guaçu/SP,0,679,2,35980
1189659,2022-08-01,Mogi Guaçu/SP,0,679,0,35980
1195256,2022-08-02,Mogi Guaçu/SP,0,679,36,36016
1200853,2022-08-03,Mogi Guaçu/SP,0,679,52,36068
1206450,2022-08-04,Mogi Guaçu/SP,0,679,16,36084
1212047,2022-08-05,Mogi Guaçu/SP,2,681,19,36103
1217644,2022-08-06,Mogi Guaçu/SP,0,681,12,36115
1223241,2022-08-07,Mogi Guaçu/SP,0,681,0,36115
1228838,2022-08-08,Mogi Guaçu/SP,0,681,0,36115
1234435,2022-08-09,Mogi Guaçu/SP,0,681,20,36135
1240032,2022-08-10,Mogi Guaçu/SP,1,682,24,36159
1245629,2022-08-11,Mogi Guaçu/SP,0,682,11,36170
1251226,2022-08-12,Mogi Guaçu/SP,0,682,12,36182
1256823,2022-08-13,Mogi Guaçu/SP,2,684,10,36192
1262420,2022-08-14,Mogi Guaçu/SP,0,684,0,36192
1268017,2022-08-15,Mogi Guaçu/SP,0,684,0,36192
1273614,2022-08-16,Mogi Guaçu/SP,0,684,7,36199
1279211,2022-08-17,Mogi Guaçu/SP,0,684,39,36238
1284808,2022-08-18,Mogi Guaçu/SP,0,684,8,36246
1290405,2022-08-19,Mogi Guaçu/SP,0,684,11,36257
1296002,2022-08-20,Mogi Guaçu/SP,0,684,6,36263
1301599,2022-08-21,Mogi Guaçu/SP,0,684,0,36263
1307196,2022-08-22,Mogi Guaçu/SP,0,684,0,36263
1312793,2022-08-23,Mogi Guaçu/SP,2,686,25,36288
1318390,2022-08-24,Mogi Guaçu/SP,0,686,3,36291
1323987,2022-08-25,Mogi Guaçu/SP,0,686,15,36306
3096,2022-01-01,Mogi Mirim/SP,0,365,0,12327
8693,2022-01-02,Mogi Mirim/SP,0,365,0,12327
14290,2022-01-03,Mogi Mirim/SP,0,365,0,12327
19887,2022-01-04,Mogi Mirim/SP,1,366,51,12378
25484,2022-01-05,Mogi Mirim/SP,0,366,102,12480
31081,2022-01-06,Mogi Mirim/SP,0,366,2,12482
36678,2022-01-07,Mogi Mirim/SP,0,366,35,12517
42275,2022-01-08,Mogi Mirim/SP,0,366,22,12539
47872,2022-01-09,Mogi Mirim/SP,0,366,2,12541
53469,2022-01-10,Mogi Mirim/SP,0,366,0,12541
59066,2022-01-11,Mogi Mirim/SP,0,366,9,12550
64663,2022-01-12,Mogi Mirim/SP,0,366,15,12565
70260,2022-01-13,Mogi Mirim/SP,0,366,1,12566
75857,2022-01-14,Mogi Mirim/SP,0,366,13,12579
81454,2022-01-15,Mogi Mirim/SP,1,367,1,12580
87051,2022-01-16,Mogi Mirim/SP,0,367,4,12584
92648,2022-01-17,Mogi Mirim/SP,0,367,0,12584
98245,2022-01-18,Mogi Mirim/SP,2,369,22,12606
103842,2022-01-19,Mogi Mirim/SP,1,370,25,12631
109439,2022-01-20,Mogi Mirim/SP,0,370,44,12675
115036,2022-01-21,Mogi Mirim/SP,1,371,22,12697
120633,2022-01-22,Mogi Mirim/SP,0,371,0,12697
126230,2022-01-23,Mogi Mirim/SP,0,371,15,12712
131827,2022-01-24,Mogi Mirim/SP,0,371,0,12712
137424,2022-01-25,Mogi Mirim/SP,0,371,6,12718
143021,2022-01-26,Mogi Mirim/SP,2,373,15,12733
148618,2022-01-27,Mogi Mirim/SP,1,374,15,12748
154215,2022-01-28,Mogi Mirim/SP,3,377,7,12755
159812,2022-01-29,Mogi Mirim/SP,1,378,4,12759
165409,2022-01-30,Mogi Mirim/SP,0,378,5,12764
171006,2022-01-31,Mogi Mirim/SP,0,378,0,12764
176603,2022-02-01,Mogi Mirim/SP,0,378,24,12788
182200,2022-02-02,Mogi Mirim/SP,1,379,7,12795
187797,2022-02-03,Mogi Mirim/SP,1,380,122,12917
193394,2022-02-04,Mogi Mirim/SP,0,380,0,12917
198991,2022-02-05,Mogi Mirim/SP,4,384,108,13025
204588,2022-02-06,Mogi Mirim/SP,0,384,5,13030
210185,2022-02-07,Mogi Mirim/SP,0,384,0,13030
215782,2022-02-08,Mogi Mirim/SP,0,384,63,13093
221379,2022-02-09,Mogi Mirim/SP,0,384,70,13163
226976,2022-02-10,Mogi Mirim/SP,2,386,68,13231
232573,2022-02-11,Mogi Mirim/SP,0,386,63,13294
238170,2022-02-12,Mogi Mirim/SP,0,386,38,13332
243767,2022-02-13,Mogi Mirim/SP,0,386,16,13348
249364,2022-02-14,Mogi Mirim/SP,0,386,0,13348
254961,2022-02-15,Mogi Mirim/SP,0,386,56,13404
260558,2022-02-16,Mogi Mirim/SP,3,389,103,13507
266155,2022-02-17,Mogi Mirim/SP,1,390,74,13581
271752,2022-02-18,Mogi Mirim/SP,2,392,91,13672
277349,2022-02-19,Mogi Mirim/SP,3,395,103,13775
282946,2022-02-20,Mogi Mirim/SP,0,395,180,13955
288543,2022-02-21,Mogi Mirim/SP,0,395,0,13955
294140,2022-02-22,Mogi Mirim/SP,0,395,144,14099
299737,2022-02-23,Mogi Mirim/SP,3,398,163,14262
305334,2022-02-24,Mogi Mirim/SP,1,399,147,14409
310931,2022-02-25,Mogi Mirim/SP,0,399,140,14549
316528,2022-02-26,Mogi Mirim/SP,0,399,38,14587
322125,2022-02-27,Mogi Mirim/SP,0,399,499,15086
327722,2022-02-28,Mogi Mirim/SP,0,399,1,15087
333319,2022-03-01,Mogi Mirim/SP,0,399,194,15281
338916,2022-03-02,Mogi Mirim/SP,0,399,0,15281
344513,2022-03-03,Mogi Mirim/SP,1,400,4,15285
350110,2022-03-04,Mogi Mirim/SP,0,400,129,15414
355707,2022-03-05,Mogi Mirim/SP,0,400,98,15512
361304,2022-03-06,Mogi Mirim/SP,0,400,19,15531
366901,2022-03-07,Mogi Mirim/SP,0,400,0,15531
372498,2022-03-08,Mogi Mirim/SP,1,401,138,15669
378095,2022-03-09,Mogi Mirim/SP,0,401,144,15813
383692,2022-03-10,Mogi Mirim/SP,0,401,121,15934
389289,2022-03-11,Mogi Mirim/SP,0,401,145,16079
394886,2022-03-12,Mogi Mirim/SP,0,401,61,16140
400483,2022-03-13,Mogi Mirim/SP,0,401,199,16339
406080,2022-03-14,Mogi Mirim/SP,0,401,0,16339
411677,2022-03-15,Mogi Mirim/SP,0,401,176,16515
417274,2022-03-16,Mogi Mirim/SP,0,401,186,16701
422871,2022-03-17,Mogi Mirim/SP,0,401,141,16842
428468,2022-03-18,Mogi Mirim/SP,1,402,128,16970
434065,2022-03-19,Mogi Mirim/SP,0,402,178,17148
439662,2022-03-20,Mogi Mirim/SP,0,402,111,17259
445259,2022-03-21,Mogi Mirim/SP,0,402,0,17259
450856,2022-03-22,Mogi Mirim/SP,0,402,173,17432
456453,2022-03-23,Mogi Mirim/SP,0,402,163,17595
462050,2022-03-24,Mogi Mirim/SP,0,402,180,17775
467647,2022-03-25,Mogi Mirim/SP,0,402,183,17958
473244,2022-03-26,Mogi Mirim/SP,0,402,62,18020
478841,2022-03-27,Mogi Mirim/SP,0,402,264,18284
484438,2022-03-28,Mogi Mirim/SP,0,402,0,18284
490035,2022-03-29,Mogi Mirim/SP,0,402,234,18518
495632,2022-03-30,Mogi Mirim/SP,0,402,227,18745
501229,2022-03-31,Mogi Mirim/SP,0,402,272,19017
506826,2022-04-01,Mogi Mirim/SP,0,402,234,19251
512423,2022-04-02,Mogi Mirim/SP,0,402,111,19362
518020,2022-04-03,Mogi Mirim/SP,0,402,1,19363
523617,2022-04-04,Mogi Mirim/SP,0,402,0,19363
529214,2022-04-05,Mogi Mirim/SP,0,402,195,19558
534811,2022-04-06,Mogi Mirim/SP,0,402,189,19747
540408,2022-04-07,Mogi Mirim/SP,0,402,236,19983
546005,2022-04-08,Mogi Mirim/SP,0,402,209,20192
551602,2022-04-09,Mogi Mirim/SP,0,402,62,20254
557199,2022-04-10,Mogi Mirim/SP,0,402,202,20456
562796,2022-04-11,Mogi Mirim/SP,0,402,0,20456
568393,2022-04-12,Mogi Mirim/SP,0,402,172,20628
573990,2022-04-13,Mogi Mirim/SP,0,402,160,20788
579587,2022-04-14,Mogi Mirim/SP,0,402,174,20962
585184,2022-04-15,Mogi Mirim/SP,0,402,74,21036
590781,2022-04-16,Mogi Mirim/SP,0,402,0,21036
596378,2022-04-17,Mogi Mirim/SP,0,402,0,21036
601975,2022-04-18,Mogi Mirim/SP,0,402,0,21036
607572,2022-04-19,Mogi Mirim/SP,0,402,0,21036
613169,2022-04-20,Mogi Mirim/SP,0,402,117,21153
618766,2022-04-21,Mogi Mirim/SP,0,402,5,21158
624363,2022-04-22,Mogi Mirim/SP,0,402,0,21158
629960,2022-04-23,Mogi Mirim/SP,0,402,0,21158
635557,2022-04-24,Mogi Mirim/SP,0,402,0,21158
641154,2022-04-25,Mogi Mirim/SP,0,402,0,21158
646751,2022-04-26,Mogi Mirim/SP,0,402,24,21182
652348,2022-04-27,Mogi Mirim/SP,0,402,29,21211
657945,2022-04-28,Mogi Mirim/SP,0,402,7,21218
663542,2022-04-29,Mogi Mirim/SP,0,402,7,21225
669139,2022-04-30,Mogi Mirim/SP,0,402,37,21262
674736,2022-05-01,Mogi Mirim/SP,0,402,0,21262
680333,2022-05-02,Mogi Mirim/SP,0,402,0,21262
685930,2022-05-03,Mogi Mirim/SP,0,402,1,21263
691527,2022-05-04,Mogi Mirim/SP,0,402,0,21263
697124,2022-05-05,Mogi Mirim/SP,0,402,0,21263
702721,2022-05-06,Mogi Mirim/SP,0,402,55,21318
708318,2022-05-07,Mogi Mirim/SP,0,402,46,21364
713915,2022-05-08,Mogi Mirim/SP,0,402,0,21364
719512,2022-05-09,Mogi Mirim/SP,0,402,0,21364
725109,2022-05-10,Mogi Mirim/SP,1,403,36,21400
730706,2022-05-11,Mogi Mirim/SP,0,403,41,21441
736303,2022-05-12,Mogi Mirim/SP,0,403,38,21479
741900,2022-05-13,Mogi Mirim/SP,0,403,35,21514
747497,2022-05-14,Mogi Mirim/SP,0,403,40,21554
753094,2022-05-15,Mogi Mirim/SP,0,403,11,21565
758691,2022-05-16,Mogi Mirim/SP,0,403,0,21565
764288,2022-05-17,Mogi Mirim/SP,0,403,64,21629
769885,2022-05-18,Mogi Mirim/SP,0,403,1,21630
775482,2022-05-19,Mogi Mirim/SP,2,405,1,21631
781079,2022-05-20,Mogi Mirim/SP,0,405,0,21631
786676,2022-05-21,Mogi Mirim/SP,0,405,0,21631
792273,2022-05-22,Mogi Mirim/SP,0,405,77,21708
797870,2022-05-23,Mogi Mirim/SP,0,405,0,21708
803467,2022-05-24,Mogi Mirim/SP,0,405,84,21792
809064,2022-05-25,Mogi Mirim/SP,0,405,94,21886
814661,2022-05-26,Mogi Mirim/SP,0,405,73,21959
820258,2022-05-27,Mogi Mirim/SP,0,405,63,22022
825855,2022-05-28,Mogi Mirim/SP,0,405,12,22034
831452,2022-05-29,Mogi Mirim/SP,0,405,1,22035
837049,2022-05-30,Mogi Mirim/SP,0,405,1,22036
842646,2022-05-31,Mogi Mirim/SP,0,405,67,22103
848243,2022-06-01,Mogi Mirim/SP,0,405,48,22151
853840,2022-06-02,Mogi Mirim/SP,0,405,48,22199
859437,2022-06-03,Mogi Mirim/SP,0,405,0,22199
865034,2022-06-04,Mogi Mirim/SP,0,405,0,22199
870631,2022-06-05,Mogi Mirim/SP,0,405,0,22199
876228,2022-06-06,Mogi Mirim/SP,0,405,0,22199
881825,2022-06-07,Mogi Mirim/SP,0,405,259,22458
887422,2022-06-08,Mogi Mirim/SP,0,405,49,22507
893019,2022-06-09,Mogi Mirim/SP,0,405,19,22526
898616,2022-06-10,Mogi Mirim/SP,0,405,59,22585
904213,2022-06-11,Mogi Mirim/SP,0,405,44,22629
909810,2022-06-12,Mogi Mirim/SP,0,405,15,22644
915407,2022-06-13,Mogi Mirim/SP,0,405,0,22644
921004,2022-06-14,Mogi Mirim/SP,0,405,0,22644
926601,2022-06-15,Mogi Mirim/SP,0,405,65,22709
932198,2022-06-16,Mogi Mirim/SP,0,405,1,22710
937795,2022-06-17,Mogi Mirim/SP,0,405,0,22710
943392,2022-06-18,Mogi Mirim/SP,0,405,0,22710
948989,2022-06-19,Mogi Mirim/SP,0,405,0,22710
954586,2022-06-20,Mogi Mirim/SP,0,405,0,22710
960183,2022-06-21,Mogi Mirim/SP,0,405,53,22763
965780,2022-06-22,Mogi Mirim/SP,0,405,64,22827
971377,2022-06-23,Mogi Mirim/SP,0,405,22,22849
976974,2022-06-24,Mogi Mirim/SP,0,405,1,22850
982571,2022-06-25,Mogi Mirim/SP,0,405,97,22947
988168,2022-06-26,Mogi Mirim/SP,0,405,34,22981
993765,2022-06-27,Mogi Mirim/SP,0,405,-1,22980
999362,2022-06-28,Mogi Mirim/SP,1,406,58,23038
1004959,2022-06-29,Mogi Mirim/SP,0,406,28,23066
1010556,2022-06-30,Mogi Mirim/SP,0,406,0,23066
1016153,2022-07-01,Mogi Mirim/SP,0,406,89,23155
1021750,2022-07-02,Mogi Mirim/SP,1,407,121,23276
1027347,2022-07-03,Mogi Mirim/SP,0,407,17,23293
1032944,2022-07-04,Mogi Mirim/SP,0,407,0,23293
1038541,2022-07-05,Mogi Mirim/SP,0,407,52,23345
1044138,2022-07-06,Mogi Mirim/SP,0,407,38,23383
1049735,2022-07-07,Mogi Mirim/SP,1,408,94,23477
1055332,2022-07-08,Mogi Mirim/SP,0,408,48,23525
1060929,2022-07-09,Mogi Mirim/SP,0,408,22,23547
1066526,2022-07-10,Mogi Mirim/SP,0,408,0,23547
1072123,2022-07-11,Mogi Mirim/SP,0,408,0,23547
1077720,2022-07-12,Mogi Mirim/SP,0,408,50,23597
1083317,2022-07-13,Mogi Mirim/SP,2,410,52,23649
1088914,2022-07-14,Mogi Mirim/SP,0,410,28,23677
1094511,2022-07-15,Mogi Mirim/SP,1,411,66,23743
1100108,2022-07-16,Mogi Mirim/SP,0,411,45,23788
1105705,2022-07-17,Mogi Mirim/SP,0,411,60,23848
1111302,2022-07-18,Mogi Mirim/SP,0,411,0,23848
1116899,2022-07-19,Mogi Mirim/SP,0,411,9,23857
1122496,2022-07-20,Mogi Mirim/SP,1,412,6,23863
1128093,2022-07-21,Mogi Mirim/SP,0,412,15,23878
1133690,2022-07-22,Mogi Mirim/SP,1,413,45,23923
1139287,2022-07-23,Mogi Mirim/SP,0,413,9,23932
1144884,2022-07-24,Mogi Mirim/SP,0,413,0,23932
1150481,2022-07-25,Mogi Mirim/SP,0,413,0,23932
1156078,2022-07-26,Mogi Mirim/SP,0,413,79,24011
1161675,2022-07-27,Mogi Mirim/SP,1,414,43,24054
1167272,2022-07-28,Mogi Mirim/SP,0,414,80,24134
1172869,2022-07-29,Mogi Mirim/SP,1,415,7,24141
1178466,2022-07-30,Mogi Mirim/SP,0,415,7,24148
1184063,2022-07-31,Mogi Mirim/SP,0,415,50,24198
1189660,2022-08-01,Mogi Mirim/SP,0,415,0,24198
1195257,2022-08-02,Mogi Mirim/SP,0,415,9,24207
1200854,2022-08-03,Mogi Mirim/SP,0,415,26,24233
1206451,2022-08-04,Mogi Mirim/SP,0,415,38,24271
1212048,2022-08-05,Mogi Mirim/SP,0,415,17,24288
1217645,2022-08-06,Mogi Mirim/SP,0,415,26,24314
1223242,2022-08-07,Mogi Mirim/SP,0,415,0,24314
1228839,2022-08-08,Mogi Mirim/SP,0,415,0,24314
1234436,2022-08-09,Mogi Mirim/SP,0,415,2,24316
1240033,2022-08-10,Mogi Mirim/SP,0,415,3,24319
1245630,2022-08-11,Mogi Mirim/SP,1,416,29,24348
1251227,2022-08-12,Mogi Mirim/SP,0,416,8,24356
1256824,2022-08-13,Mogi Mirim/SP,0,416,14,24370
1262421,2022-08-14,Mogi Mirim/SP,0,416,0,24370
1268018,2022-08-15,Mogi Mirim/SP,0,416,0,24370
1273615,2022-08-16,Mogi Mirim/SP,1,417,7,24377
1279212,2022-08-17,Mogi Mirim/SP,0,417,13,24390
1284809,2022-08-18,Mogi Mirim/SP,0,417,27,24417
1290406,2022-08-19,Mogi Mirim/SP,0,417,33,24450
1296003,2022-08-20,Mogi Mirim/SP,0,417,8,24458
1301600,2022-08-21,Mogi Mirim/SP,0,417,0,24458
1307197,2022-08-22,Mogi Mirim/SP,0,417,0,24458
1312794,2022-08-23,Mogi Mirim/SP,1,418,11,24469
1318391,2022-08-24,Mogi Mirim/SP,0,418,1,24470
1323988,2022-08-25,Mogi Mirim/SP,1,419,0,24470
3831,2022-01-01,Pirassununga/SP,0,263,0,9140
9428,2022-01-02,Pirassununga/SP,0,263,0,9140
15025,2022-01-03,Pirassununga/SP,0,263,0,9140
20622,2022-01-04,Pirassununga/SP,0,263,38,9178
26219,2022-01-05,Pirassununga/SP,0,263,69,9247
31816,2022-01-06,Pirassununga/SP,0,263,10,9257
37413,2022-01-07,Pirassununga/SP,0,263,62,9319
43010,2022-01-08,Pirassununga/SP,0,263,37,9356
48607,2022-01-09,Pirassununga/SP,0,263,0,9356
54204,2022-01-10,Pirassununga/SP,0,263,0,9356
59801,2022-01-11,Pirassununga/SP,0,263,25,9381
65398,2022-01-12,Pirassununga/SP,0,263,23,9404
70995,2022-01-13,Pirassununga/SP,0,263,27,9431
76592,2022-01-14,Pirassununga/SP,0,263,51,9482
82189,2022-01-15,Pirassununga/SP,1,264,1,9483
87786,2022-01-16,Pirassununga/SP,0,264,0,9483
93383,2022-01-17,Pirassununga/SP,0,264,-1,9482
98980,2022-01-18,Pirassununga/SP,0,264,-2,9480
104577,2022-01-19,Pirassununga/SP,0,264,79,9559
110174,2022-01-20,Pirassununga/SP,1,265,41,9600
115771,2022-01-21,Pirassununga/SP,0,265,61,9661
121368,2022-01-22,Pirassununga/SP,0,265,0,9661
126965,2022-01-23,Pirassununga/SP,0,265,36,9697
132562,2022-01-24,Pirassununga/SP,0,265,0,9697
138159,2022-01-25,Pirassununga/SP,1,266,38,9735
143756,2022-01-26,Pirassununga/SP,0,266,67,9802
149353,2022-01-27,Pirassununga/SP,4,270,87,9889
154950,2022-01-28,Pirassununga/SP,0,270,34,9923
160547,2022-01-29,Pirassununga/SP,0,270,59,9982
166144,2022-01-30,Pirassununga/SP,0,270,3,9985
171741,2022-01-31,Pirassununga/SP,0,270,0,9985
177338,2022-02-01,Pirassununga/SP,0,270,49,10034
182935,2022-02-02,Pirassununga/SP,0,270,0,10034
188532,2022-02-03,Pirassununga/SP,1,271,190,10224
194129,2022-02-04,Pirassununga/SP,0,271,0,10224
199726,2022-02-05,Pirassununga/SP,1,272,158,10382
205323,2022-02-06,Pirassununga/SP,0,272,24,10406
210920,2022-02-07,Pirassununga/SP,0,272,0,10406
216517,2022-02-08,Pirassununga/SP,5,277,68,10474
222114,2022-02-09,Pirassununga/SP,0,277,56,10530
227711,2022-02-10,Pirassununga/SP,1,278,30,10560
233308,2022-02-11,Pirassununga/SP,0,278,85,10645
238905,2022-02-12,Pirassununga/SP,0,278,60,10705
244502,2022-02-13,Pirassununga/SP,0,278,0,10705
250099,2022-02-14,Pirassununga/SP,0,278,0,10705
255696,2022-02-15,Pirassununga/SP,0,278,29,10734
261293,2022-02-16,Pirassununga/SP,0,278,57,10791
266890,2022-02-17,Pirassununga/SP,0,278,73,10864
272487,2022-02-18,Pirassununga/SP,0,278,56,10920
278084,2022-02-19,Pirassununga/SP,0,278,102,11022
283681,2022-02-20,Pirassununga/SP,0,278,0,11022
289278,2022-02-21,Pirassununga/SP,0,278,0,11022
294875,2022-02-22,Pirassununga/SP,0,278,156,11178
300472,2022-02-23,Pirassununga/SP,0,278,105,11283
306069,2022-02-24,Pirassununga/SP,3,281,111,11394
311666,2022-02-25,Pirassununga/SP,0,281,195,11589
317263,2022-02-26,Pirassununga/SP,1,282,90,11679
322860,2022-02-27,Pirassununga/SP,0,282,1,11680
328457,2022-02-28,Pirassununga/SP,0,282,0,11680
334054,2022-03-01,Pirassununga/SP,0,282,1,11681
339651,2022-03-02,Pirassununga/SP,0,282,0,11681
345248,2022-03-03,Pirassununga/SP,0,282,27,11708
350845,2022-03-04,Pirassununga/SP,0,282,112,11820
356442,2022-03-05,Pirassununga/SP,1,283,139,11959
362039,2022-03-06,Pirassununga/SP,0,283,0,11959
367636,2022-03-07,Pirassununga/SP,0,283,0,11959
373233,2022-03-08,Pirassununga/SP,1,284,122,12081
378830,2022-03-09,Pirassununga/SP,1,285,119,12200
384427,2022-03-10,Pirassununga/SP,0,285,151,12351
390024,2022-03-11,Pirassununga/SP,1,286,151,12502
395621,2022-03-12,Pirassununga/SP,0,286,144,12646
401218,2022-03-13,Pirassununga/SP,0,286,0,12646
406815,2022-03-14,Pirassununga/SP,0,286,0,12646
412412,2022-03-15,Pirassununga/SP,0,286,80,12726
418009,2022-03-16,Pirassununga/SP,1,287,143,12869
423606,2022-03-17,Pirassununga/SP,0,287,66,12935
429203,2022-03-18,Pirassununga/SP,0,287,130,13065
434800,2022-03-19,Pirassununga/SP,0,287,98,13163
440397,2022-03-20,Pirassununga/SP,0,287,0,13163
445994,2022-03-21,Pirassununga/SP,0,287,3,13166
451591,2022-03-22,Pirassununga/SP,0,287,98,13264
457188,2022-03-23,Pirassununga/SP,0,287,130,13394
462785,2022-03-24,Pirassununga/SP,0,287,157,13551
468382,2022-03-25,Pirassununga/SP,0,287,88,13639
473979,2022-03-26,Pirassununga/SP,0,287,101,13740
479576,2022-03-27,Pirassununga/SP,0,287,-1,13739
485173,2022-03-28,Pirassununga/SP,0,287,0,13739
490770,2022-03-29,Pirassununga/SP,0,287,92,13831
496367,2022-03-30,Pirassununga/SP,0,287,134,13965
501964,2022-03-31,Pirassununga/SP,0,287,72,14037
507561,2022-04-01,Pirassununga/SP,0,287,96,14133
513158,2022-04-02,Pirassununga/SP,0,287,81,14214
518755,2022-04-03,Pirassununga/SP,0,287,0,14214
524352,2022-04-04,Pirassununga/SP,0,287,0,14214
529949,2022-04-05,Pirassununga/SP,0,287,91,14305
535546,2022-04-06,Pirassununga/SP,0,287,25,14330
541143,2022-04-07,Pirassununga/SP,0,287,109,14439
546740,2022-04-08,Pirassununga/SP,0,287,111,14550
552337,2022-04-09,Pirassununga/SP,0,287,113,14663
557934,2022-04-10,Pirassununga/SP,0,287,0,14663
563531,2022-04-11,Pirassununga/SP,0,287,0,14663
569128,2022-04-12,Pirassununga/SP,0,287,8,14671
574725,2022-04-13,Pirassununga/SP,1,288,16,14687
580322,2022-04-14,Pirassununga/SP,0,288,0,14687
585919,2022-04-15,Pirassununga/SP,0,288,0,14687
591516,2022-04-16,Pirassununga/SP,0,288,0,14687
597113,2022-04-17,Pirassununga/SP,0,288,0,14687
602710,2022-04-18,Pirassununga/SP,0,288,0,14687
608307,2022-04-19,Pirassununga/SP,0,288,0,14687
613904,2022-04-20,Pirassununga/SP,0,288,11,14698
619501,2022-04-21,Pirassununga/SP,0,288,-1,14697
625098,2022-04-22,Pirassununga/SP,0,288,0,14697
630695,2022-04-23,Pirassununga/SP,0,288,0,14697
636292,2022-04-24,Pirassununga/SP,0,288,0,14697
641889,2022-04-25,Pirassununga/SP,0,288,0,14697
647486,2022-04-26,Pirassununga/SP,0,288,-1,14696
653083,2022-04-27,Pirassununga/SP,0,288,10,14706
658680,2022-04-28,Pirassununga/SP,0,288,1,14707
664277,2022-04-29,Pirassununga/SP,1,289,0,14707
669874,2022-04-30,Pirassununga/SP,0,289,0,14707
675471,2022-05-01,Pirassununga/SP,0,289,0,14707
681068,2022-05-02,Pirassununga/SP,0,289,0,14707
686665,2022-05-03,Pirassununga/SP,0,289,0,14707
692262,2022-05-04,Pirassununga/SP,0,289,1,14708
697859,2022-05-05,Pirassununga/SP,0,289,20,14728
703456,2022-05-06,Pirassununga/SP,0,289,0,14728
709053,2022-05-07,Pirassununga/SP,0,289,0,14728
714650,2022-05-08,Pirassununga/SP,0,289,0,14728
720247,2022-05-09,Pirassununga/SP,0,289,0,14728
725844,2022-05-10,Pirassununga/SP,1,290,15,14743
731441,2022-05-11,Pirassununga/SP,0,290,10,14753
737038,2022-05-12,Pirassununga/SP,0,290,20,14773
742635,2022-05-13,Pirassununga/SP,0,290,7,14780
748232,2022-05-14,Pirassununga/SP,0,290,1,14781
753829,2022-05-15,Pirassununga/SP,0,290,0,14781
759426,2022-05-16,Pirassununga/SP,0,290,0,14781
765023,2022-05-17,Pirassununga/SP,0,290,14,14795
770620,2022-05-18,Pirassununga/SP,0,290,0,14795
776217,2022-05-19,Pirassununga/SP,1,291,0,14795
781814,2022-05-20,Pirassununga/SP,0,291,0,14795
787411,2022-05-21,Pirassununga/SP,0,291,0,14795
793008,2022-05-22,Pirassununga/SP,0,291,50,14845
798605,2022-05-23,Pirassununga/SP,0,291,0,14845
804202,2022-05-24,Pirassununga/SP,1,292,51,14896
809799,2022-05-25,Pirassununga/SP,0,292,49,14945
815396,2022-05-26,Pirassununga/SP,1,293,19,14964
820993,2022-05-27,Pirassununga/SP,0,293,105,15069
826590,2022-05-28,Pirassununga/SP,0,293,86,15155
832187,2022-05-29,Pirassununga/SP,0,293,0,15155
837784,2022-05-30,Pirassununga/SP,0,293,0,15155
843381,2022-05-31,Pirassununga/SP,0,293,103,15258
848978,2022-06-01,Pirassununga/SP,0,293,116,15374
854575,2022-06-02,Pirassununga/SP,0,293,72,15446
860172,2022-06-03,Pirassununga/SP,0,293,0,15446
865769,2022-06-04,Pirassununga/SP,0,293,0,15446
871366,2022-06-05,Pirassununga/SP,0,293,0,15446
876963,2022-06-06,Pirassununga/SP,0,293,0,15446
882560,2022-06-07,Pirassununga/SP,0,293,269,15715
888157,2022-06-08,Pirassununga/SP,0,293,81,15796
893754,2022-06-09,Pirassununga/SP,0,293,75,15871
899351,2022-06-10,Pirassununga/SP,0,293,72,15943
904948,2022-06-11,Pirassununga/SP,1,294,90,16033
910545,2022-06-12,Pirassununga/SP,0,294,0,16033
916142,2022-06-13,Pirassununga/SP,0,294,0,16033
921739,2022-06-14,Pirassununga/SP,0,294,0,16033
927336,2022-06-15,Pirassununga/SP,0,294,38,16071
932933,2022-06-16,Pirassununga/SP,0,294,18,16089
938530,2022-06-17,Pirassununga/SP,0,294,0,16089
944127,2022-06-18,Pirassununga/SP,0,294,0,16089
949724,2022-06-19,Pirassununga/SP,0,294,0,16089
955321,2022-06-20,Pirassununga/SP,0,294,0,16089
960918,2022-06-21,Pirassununga/SP,2,296,120,16209
966515,2022-06-22,Pirassununga/SP,0,296,80,16289
972112,2022-06-23,Pirassununga/SP,0,296,89,16378
977709,2022-06-24,Pirassununga/SP,0,296,0,16378
983306,2022-06-25,Pirassununga/SP,0,296,156,16534
988903,2022-06-26,Pirassununga/SP,0,296,0,16534
994500,2022-06-27,Pirassununga/SP,0,296,0,16534
1000097,2022-06-28,Pirassununga/SP,0,296,35,16569
1005694,2022-06-29,Pirassununga/SP,0,296,158,16727
1011291,2022-06-30,Pirassununga/SP,0,296,81,16808
1016888,2022-07-01,Pirassununga/SP,0,296,63,16871
1022485,2022-07-02,Pirassununga/SP,0,296,64,16935
1028082,2022-07-03,Pirassununga/SP,0,296,0,16935
1033679,2022-07-04,Pirassununga/SP,0,296,0,16935
1039276,2022-07-05,Pirassununga/SP,0,296,98,17033
1044873,2022-07-06,Pirassununga/SP,1,297,62,17095
1050470,2022-07-07,Pirassununga/SP,0,297,2,17097
1056067,2022-07-08,Pirassununga/SP,0,297,8,17105
1061664,2022-07-09,Pirassununga/SP,0,297,39,17144
1067261,2022-07-10,Pirassununga/SP,0,297,0,17144
1072858,2022-07-11,Pirassununga/SP,0,297,0,17144
1078455,2022-07-12,Pirassununga/SP,1,298,36,17180
1084052,2022-07-13,Pirassununga/SP,0,298,64,17244
1089649,2022-07-14,Pirassununga/SP,1,299,40,17284
1095246,2022-07-15,Pirassununga/SP,0,299,1,17285
1100843,2022-07-16,Pirassununga/SP,0,299,-1,17284
1106440,2022-07-17,Pirassununga/SP,0,299,0,17284
1112037,2022-07-18,Pirassununga/SP,0,299,0,17284
1117634,2022-07-19,Pirassununga/SP,0,299,0,17284
1123231,2022-07-20,Pirassununga/SP,3,302,1,17285
1128828,2022-07-21,Pirassununga/SP,0,302,1,17286
1134425,2022-07-22,Pirassununga/SP,0,302,1,17287
1140022,2022-07-23,Pirassununga/SP,0,302,2,17289
1145619,2022-07-24,Pirassununga/SP,0,302,0,17289
1151216,2022-07-25,Pirassununga/SP,0,302,0,17289
1156813,2022-07-26,Pirassununga/SP,2,304,0,17289
1162410,2022-07-27,Pirassununga/SP,0,304,0,17289
1168007,2022-07-28,Pirassununga/SP,0,304,0,17289
1173604,2022-07-29,Pirassununga/SP,0,304,1,17290
1179201,2022-07-30,Pirassununga/SP,0,304,0,17290
1184798,2022-07-31,Pirassununga/SP,0,304,0,17290
1190395,2022-08-01,Pirassununga/SP,0,304,0,17290
1195992,2022-08-02,Pirassununga/SP,0,304,0,17290
1201589,2022-08-03,Pirassununga/SP,0,304,0,17290
1207186,2022-08-04,Pirassununga/SP,0,304,0,17290
1212783,2022-08-05,Pirassununga/SP,0,304,2,17292
1218380,2022-08-06,Pirassununga/SP,0,304,-1,17291
1223977,2022-08-07,Pirassununga/SP,0,304,0,17291
1229574,2022-08-08,Pirassununga/SP,0,304,0,17291
1235171,2022-08-09,Pirassununga/SP,0,304,-1,17290
1240768,2022-08-10,Pirassununga/SP,0,304,0,17290
1246365,2022-08-11,Pirassununga/SP,0,304,1,17291
1251962,2022-08-12,Pirassununga/SP,0,304,0,17291
1257559,2022-08-13,Pirassununga/SP,0,304,0,17291
1263156,2022-08-14,Pirassununga/SP,0,304,0,17291
1268753,2022-08-15,Pirassununga/SP,0,304,0,17291
1274350,2022-08-16,Pirassununga/SP,0,304,0,17291
1279947,2022-08-17,Pirassununga/SP,0,304,-1,17290
1285544,2022-08-18,Pirassununga/SP,0,304,0,17290
1291141,2022-08-19,Pirassununga/SP,0,304,22,17312
1296738,2022-08-20,Pirassununga/SP,1,305,62,17374
1302335,2022-08-21,Pirassununga/SP,0,305,0,17374
1307932,2022-08-22,Pirassununga/SP,0,305,0,17374
1313529,2022-08-23,Pirassununga/SP,0,305,33,17407
1319126,2022-08-24,Pirassununga/SP,0,305,62,17469
1324723,2022-08-25,Pirassununga/SP,0,305,25,17494
4359,2022-01-01,Santa Cruz das Palmeiras/SP,0,122,0,3944
9956,2022-01-02,Santa Cruz das Palmeiras/SP,0,122,0,3944
15553,2022-01-03,Santa Cruz das Palmeiras/SP,0,122,0,3944
21150,2022-01-04,Santa Cruz das Palmeiras/SP,0,122,0,3944
26747,2022-01-05,Santa Cruz das Palmeiras/SP,0,122,1,3945
32344,2022-01-06,Santa Cruz das Palmeiras/SP,0,122,0,3945
37941,2022-01-07,Santa Cruz das Palmeiras/SP,0,122,13,3958
43538,2022-01-08,Santa Cruz das Palmeiras/SP,0,122,1,3959
49135,2022-01-09,Santa Cruz das Palmeiras/SP,0,122,0,3959
54732,2022-01-10,Santa Cruz das Palmeiras/SP,0,122,0,3959
60329,2022-01-11,Santa Cruz das Palmeiras/SP,0,122,17,3976
65926,2022-01-12,Santa Cruz das Palmeiras/SP,0,122,9,3985
71523,2022-01-13,Santa Cruz das Palmeiras/SP,0,122,23,4008
77120,2022-01-14,Santa Cruz das Palmeiras/SP,0,122,9,4017
82717,2022-01-15,Santa Cruz das Palmeiras/SP,0,122,0,4017
88314,2022-01-16,Santa Cruz das Palmeiras/SP,1,123,1,4018
93911,2022-01-17,Santa Cruz das Palmeiras/SP,0,123,0,4018
99508,2022-01-18,Santa Cruz das Palmeiras/SP,0,123,23,4041
105105,2022-01-19,Santa Cruz das Palmeiras/SP,0,123,36,4077
110702,2022-01-20,Santa Cruz das Palmeiras/SP,0,123,27,4104
116299,2022-01-21,Santa Cruz das Palmeiras/SP,0,123,0,4104
121896,2022-01-22,Santa Cruz das Palmeiras/SP,0,123,0,4104
127493,2022-01-23,Santa Cruz das Palmeiras/SP,0,123,14,4118
133090,2022-01-24,Santa Cruz das Palmeiras/SP,0,123,0,4118
138687,2022-01-25,Santa Cruz das Palmeiras/SP,0,123,19,4137
144284,2022-01-26,Santa Cruz das Palmeiras/SP,0,123,34,4171
149881,2022-01-27,Santa Cruz das Palmeiras/SP,0,123,30,4201
155478,2022-01-28,Santa Cruz das Palmeiras/SP,1,124,10,4211
161075,2022-01-29,Santa Cruz das Palmeiras/SP,0,124,2,4213
166672,2022-01-30,Santa Cruz das Palmeiras/SP,3,127,6,4219
172269,2022-01-31,Santa Cruz das Palmeiras/SP,0,127,0,4219
177866,2022-02-01,Santa Cruz das Palmeiras/SP,0,127,11,4230
183463,2022-02-02,Santa Cruz das Palmeiras/SP,0,127,0,4230
189060,2022-02-03,Santa Cruz das Palmeiras/SP,1,128,64,4294
194657,2022-02-04,Santa Cruz das Palmeiras/SP,0,128,0,4294
200254,2022-02-05,Santa Cruz das Palmeiras/SP,0,128,64,4358
205851,2022-02-06,Santa Cruz das Palmeiras/SP,0,128,2,4360
211448,2022-02-07,Santa Cruz das Palmeiras/SP,0,128,0,4360
217045,2022-02-08,Santa Cruz das Palmeiras/SP,0,128,75,4435
222642,2022-02-09,Santa Cruz das Palmeiras/SP,0,128,44,4479
228239,2022-02-10,Santa Cruz das Palmeiras/SP,0,128,23,4502
233836,2022-02-11,Santa Cruz das Palmeiras/SP,1,129,43,4545
239433,2022-02-12,Santa Cruz das Palmeiras/SP,0,129,1,4546
245030,2022-02-13,Santa Cruz das Palmeiras/SP,0,129,0,4546
250627,2022-02-14,Santa Cruz das Palmeiras/SP,0,129,0,4546
256224,2022-02-15,Santa Cruz das Palmeiras/SP,0,129,18,4564
261821,2022-02-16,Santa Cruz das Palmeiras/SP,0,129,101,4665
267418,2022-02-17,Santa Cruz das Palmeiras/SP,0,129,48,4713
273015,2022-02-18,Santa Cruz das Palmeiras/SP,0,129,50,4763
278612,2022-02-19,Santa Cruz das Palmeiras/SP,0,129,14,4777
284209,2022-02-20,Santa Cruz das Palmeiras/SP,0,129,0,4777
289806,2022-02-21,Santa Cruz das Palmeiras/SP,0,129,0,4777
295403,2022-02-22,Santa Cruz das Palmeiras/SP,0,129,14,4791
301000,2022-02-23,Santa Cruz das Palmeiras/SP,0,129,10,4801
306597,2022-02-24,Santa Cruz das Palmeiras/SP,0,129,32,4833
312194,2022-02-25,Santa Cruz das Palmeiras/SP,0,129,2,4835
317791,2022-02-26,Santa Cruz das Palmeiras/SP,0,129,15,4850
323388,2022-02-27,Santa Cruz das Palmeiras/SP,0,129,0,4850
328985,2022-02-28,Santa Cruz das Palmeiras/SP,0,129,0,4850
334582,2022-03-01,Santa Cruz das Palmeiras/SP,0,129,0,4850
340179,2022-03-02,Santa Cruz das Palmeiras/SP,0,129,0,4850
345776,2022-03-03,Santa Cruz das Palmeiras/SP,1,130,26,4876
351373,2022-03-04,Santa Cruz das Palmeiras/SP,0,130,30,4906
356970,2022-03-05,Santa Cruz das Palmeiras/SP,0,130,12,4918
362567,2022-03-06,Santa Cruz das Palmeiras/SP,0,130,0,4918
368164,2022-03-07,Santa Cruz das Palmeiras/SP,0,130,0,4918
373761,2022-03-08,Santa Cruz das Palmeiras/SP,0,130,1,4919
379358,2022-03-09,Santa Cruz das Palmeiras/SP,5,135,16,4935
384955,2022-03-10,Santa Cruz das Palmeiras/SP,0,135,10,4945
390552,2022-03-11,Santa Cruz das Palmeiras/SP,0,135,6,4951
396149,2022-03-12,Santa Cruz das Palmeiras/SP,0,135,0,4951
401746,2022-03-13,Santa Cruz das Palmeiras/SP,0,135,0,4951
407343,2022-03-14,Santa Cruz das Palmeiras/SP,0,135,0,4951
412940,2022-03-15,Santa Cruz das Palmeiras/SP,0,135,31,4982
418537,2022-03-16,Santa Cruz das Palmeiras/SP,0,135,4,4986
424134,2022-03-17,Santa Cruz das Palmeiras/SP,0,135,0,4986
429731,2022-03-18,Santa Cruz das Palmeiras/SP,0,135,2,4988
435328,2022-03-19,Santa Cruz das Palmeiras/SP,0,135,4,4992
440925,2022-03-20,Santa Cruz das Palmeiras/SP,0,135,0,4992
446522,2022-03-21,Santa Cruz das Palmeiras/SP,0,135,0,4992
452119,2022-03-22,Santa Cruz das Palmeiras/SP,0,135,5,4997
457716,2022-03-23,Santa Cruz das Palmeiras/SP,0,135,0,4997
463313,2022-03-24,Santa Cruz das Palmeiras/SP,0,135,0,4997
468910,2022-03-25,Santa Cruz das Palmeiras/SP,0,135,0,4997
474507,2022-03-26,Santa Cruz das Palmeiras/SP,0,135,0,4997
480104,2022-03-27,Santa Cruz das Palmeiras/SP,0,135,0,4997
485701,2022-03-28,Santa Cruz das Palmeiras/SP,0,135,0,4997
491298,2022-03-29,Santa Cruz das Palmeiras/SP,0,135,1,4998
496895,2022-03-30,Santa Cruz das Palmeiras/SP,0,135,0,4998
502492,2022-03-31,Santa Cruz das Palmeiras/SP,0,135,3,5001
508089,2022-04-01,Santa Cruz das Palmeiras/SP,0,135,3,5004
513686,2022-04-02,Santa Cruz das Palmeiras/SP,0,135,0,5004
519283,2022-04-03,Santa Cruz das Palmeiras/SP,0,135,0,5004
524880,2022-04-04,Santa Cruz das Palmeiras/SP,0,135,0,5004
530477,2022-04-05,Santa Cruz das Palmeiras/SP,0,135,0,5004
536074,2022-04-06,Santa Cruz das Palmeiras/SP,0,135,0,5004
541671,2022-04-07,Santa Cruz das Palmeiras/SP,0,135,0,5004
547268,2022-04-08,Santa Cruz das Palmeiras/SP,0,135,1,5005
552865,2022-04-09,Santa Cruz das Palmeiras/SP,0,135,0,5005
558462,2022-04-10,Santa Cruz das Palmeiras/SP,0,135,0,5005
564059,2022-04-11,Santa Cruz das Palmeiras/SP,0,135,0,5005
569656,2022-04-12,Santa Cruz das Palmeiras/SP,0,135,0,5005
575253,2022-04-13,Santa Cruz das Palmeiras/SP,0,135,2,5007
580850,2022-04-14,Santa Cruz das Palmeiras/SP,0,135,0,5007
586447,2022-04-15,Santa Cruz das Palmeiras/SP,0,135,0,5007
592044,2022-04-16,Santa Cruz das Palmeiras/SP,0,135,0,5007
597641,2022-04-17,Santa Cruz das Palmeiras/SP,0,135,0,5007
603238,2022-04-18,Santa Cruz das Palmeiras/SP,0,135,0,5007
608835,2022-04-19,Santa Cruz das Palmeiras/SP,0,135,0,5007
614432,2022-04-20,Santa Cruz das Palmeiras/SP,0,135,0,5007
620029,2022-04-21,Santa Cruz das Palmeiras/SP,0,135,2,5009
625626,2022-04-22,Santa Cruz das Palmeiras/SP,0,135,0,5009
631223,2022-04-23,Santa Cruz das Palmeiras/SP,0,135,0,5009
636820,2022-04-24,Santa Cruz das Palmeiras/SP,0,135,0,5009
642417,2022-04-25,Santa Cruz das Palmeiras/SP,0,135,0,5009
648014,2022-04-26,Santa Cruz das Palmeiras/SP,0,135,2,5011
653611,2022-04-27,Santa Cruz das Palmeiras/SP,0,135,0,5011
659208,2022-04-28,Santa Cruz das Palmeiras/SP,0,135,0,5011
664805,2022-04-29,Santa Cruz das Palmeiras/SP,0,135,0,5011
670402,2022-04-30,Santa Cruz das Palmeiras/SP,0,135,0,5011
675999,2022-05-01,Santa Cruz das Palmeiras/SP,0,135,0,5011
681596,2022-05-02,Santa Cruz das Palmeiras/SP,0,135,0,5011
687193,2022-05-03,Santa Cruz das Palmeiras/SP,0,135,0,5011
692790,2022-05-04,Santa Cruz das Palmeiras/SP,0,135,0,5011
698387,2022-05-05,Santa Cruz das Palmeiras/SP,0,135,0,5011
703984,2022-05-06,Santa Cruz das Palmeiras/SP,0,135,0,5011
709581,2022-05-07,Santa Cruz das Palmeiras/SP,0,135,0,5011
715178,2022-05-08,Santa Cruz das Palmeiras/SP,0,135,0,5011
720775,2022-05-09,Santa Cruz das Palmeiras/SP,0,135,0,5011
726372,2022-05-10,Santa Cruz das Palmeiras/SP,0,135,6,5017
731969,2022-05-11,Santa Cruz das Palmeiras/SP,0,135,0,5017
737566,2022-05-12,Santa Cruz das Palmeiras/SP,0,135,0,5017
743163,2022-05-13,Santa Cruz das Palmeiras/SP,0,135,0,5017
748760,2022-05-14,Santa Cruz das Palmeiras/SP,0,135,0,5017
754357,2022-05-15,Santa Cruz das Palmeiras/SP,0,135,0,5017
759954,2022-05-16,Santa Cruz das Palmeiras/SP,0,135,0,5017
765551,2022-05-17,Santa Cruz das Palmeiras/SP,0,135,0,5017
771148,2022-05-18,Santa Cruz das Palmeiras/SP,1,136,0,5017
776745,2022-05-19,Santa Cruz das Palmeiras/SP,0,136,0,5017
782342,2022-05-20,Santa Cruz das Palmeiras/SP,0,136,0,5017
787939,2022-05-21,Santa Cruz das Palmeiras/SP,0,136,0,5017
793536,2022-05-22,Santa Cruz das Palmeiras/SP,0,136,0,5017
799133,2022-05-23,Santa Cruz das Palmeiras/SP,0,136,0,5017
804730,2022-05-24,Santa Cruz das Palmeiras/SP,0,136,7,5024
810327,2022-05-25,Santa Cruz das Palmeiras/SP,0,136,7,5031
815924,2022-05-26,Santa Cruz das Palmeiras/SP,0,136,3,5034
821521,2022-05-27,Santa Cruz das Palmeiras/SP,0,136,0,5034
827118,2022-05-28,Santa Cruz das Palmeiras/SP,0,136,0,5034
832715,2022-05-29,Santa Cruz das Palmeiras/SP,0,136,0,5034
838312,2022-05-30,Santa Cruz das Palmeiras/SP,0,136,0,5034
843909,2022-05-31,Santa Cruz das Palmeiras/SP,0,136,1,5035
849506,2022-06-01,Santa Cruz das Palmeiras/SP,0,136,0,5035
855103,2022-06-02,Santa Cruz das Palmeiras/SP,0,136,2,5037
860700,2022-06-03,Santa Cruz das Palmeiras/SP,0,136,0,5037
866297,2022-06-04,Santa Cruz das Palmeiras/SP,0,136,0,5037
871894,2022-06-05,Santa Cruz das Palmeiras/SP,0,136,0,5037
877491,2022-06-06,Santa Cruz das Palmeiras/SP,0,136,0,5037
883088,2022-06-07,Santa Cruz das Palmeiras/SP,0,136,9,5046
888685,2022-06-08,Santa Cruz das Palmeiras/SP,0,136,0,5046
894282,2022-06-09,Santa Cruz das Palmeiras/SP,0,136,5,5051
899879,2022-06-10,Santa Cruz das Palmeiras/SP,0,136,3,5054
905476,2022-06-11,Santa Cruz das Palmeiras/SP,0,136,0,5054
911073,2022-06-12,Santa Cruz das Palmeiras/SP,0,136,0,5054
916670,2022-06-13,Santa Cruz das Palmeiras/SP,0,136,0,5054
922267,2022-06-14,Santa Cruz das Palmeiras/SP,0,136,0,5054
927864,2022-06-15,Santa Cruz das Palmeiras/SP,0,136,23,5077
933461,2022-06-16,Santa Cruz das Palmeiras/SP,0,136,10,5087
939058,2022-06-17,Santa Cruz das Palmeiras/SP,0,136,0,5087
944655,2022-06-18,Santa Cruz das Palmeiras/SP,0,136,0,5087
950252,2022-06-19,Santa Cruz das Palmeiras/SP,0,136,0,5087
955849,2022-06-20,Santa Cruz das Palmeiras/SP,0,136,0,5087
961446,2022-06-21,Santa Cruz das Palmeiras/SP,0,136,13,5100
967043,2022-06-22,Santa Cruz das Palmeiras/SP,0,136,35,5135
972640,2022-06-23,Santa Cruz das Palmeiras/SP,0,136,0,5135
978237,2022-06-24,Santa Cruz das Palmeiras/SP,0,136,0,5135
983834,2022-06-25,Santa Cruz das Palmeiras/SP,0,136,3,5138
989431,2022-06-26,Santa Cruz das Palmeiras/SP,0,136,0,5138
995028,2022-06-27,Santa Cruz das Palmeiras/SP,0,136,0,5138
1000625,2022-06-28,Santa Cruz das Palmeiras/SP,0,136,12,5150
1006222,2022-06-29,Santa Cruz das Palmeiras/SP,0,136,0,5150
1011819,2022-06-30,Santa Cruz das Palmeiras/SP,0,136,-1,5149
1017416,2022-07-01,Santa Cruz das Palmeiras/SP,0,136,2,5151
1023013,2022-07-02,Santa Cruz das Palmeiras/SP,0,136,4,5155
1028610,2022-07-03,Santa Cruz das Palmeiras/SP,0,136,0,5155
1034207,2022-07-04,Santa Cruz das Palmeiras/SP,0,136,0,5155
1039804,2022-07-05,Santa Cruz das Palmeiras/SP,0,136,16,5171
1045401,2022-07-06,Santa Cruz das Palmeiras/SP,0,136,8,5179
1050998,2022-07-07,Santa Cruz das Palmeiras/SP,0,136,7,5186
1056595,2022-07-08,Santa Cruz das Palmeiras/SP,0,136,2,5188
1062192,2022-07-09,Santa Cruz das Palmeiras/SP,0,136,18,5206
1067789,2022-07-10,Santa Cruz das Palmeiras/SP,0,136,0,5206
1073386,2022-07-11,Santa Cruz das Palmeiras/SP,0,136,0,5206
1078983,2022-07-12,Santa Cruz das Palmeiras/SP,0,136,7,5213
1084580,2022-07-13,Santa Cruz das Palmeiras/SP,0,136,16,5229
1090177,2022-07-14,Santa Cruz das Palmeiras/SP,0,136,10,5239
1095774,2022-07-15,Santa Cruz das Palmeiras/SP,0,136,19,5258
1101371,2022-07-16,Santa Cruz das Palmeiras/SP,0,136,0,5258
1106968,2022-07-17,Santa Cruz das Palmeiras/SP,0,136,0,5258
1112565,2022-07-18,Santa Cruz das Palmeiras/SP,0,136,0,5258
1118162,2022-07-19,Santa Cruz das Palmeiras/SP,0,136,15,5273
1123759,2022-07-20,Santa Cruz das Palmeiras/SP,0,136,21,5294
1129356,2022-07-21,Santa Cruz das Palmeiras/SP,0,136,0,5294
1134953,2022-07-22,Santa Cruz das Palmeiras/SP,0,136,6,5300
1140550,2022-07-23,Santa Cruz das Palmeiras/SP,0,136,0,5300
1146147,2022-07-24,Santa Cruz das Palmeiras/SP,0,136,0,5300
1151744,2022-07-25,Santa Cruz das Palmeiras/SP,0,136,6,5306
1157341,2022-07-26,Santa Cruz das Palmeiras/SP,0,136,15,5321
1162938,2022-07-27,Santa Cruz das Palmeiras/SP,0,136,21,5342
1168535,2022-07-28,Santa Cruz das Palmeiras/SP,0,136,36,5378
1174132,2022-07-29,Santa Cruz das Palmeiras/SP,0,136,2,5380
1179729,2022-07-30,Santa Cruz das Palmeiras/SP,0,136,0,5380
1185326,2022-07-31,Santa Cruz das Palmeiras/SP,0,136,0,5380
1190923,2022-08-01,Santa Cruz das Palmeiras/SP,0,136,0,5380
1196520,2022-08-02,Santa Cruz das Palmeiras/SP,0,136,17,5397
1202117,2022-08-03,Santa Cruz das Palmeiras/SP,0,136,39,5436
1207714,2022-08-04,Santa Cruz das Palmeiras/SP,0,136,3,5439
1213311,2022-08-05,Santa Cruz das Palmeiras/SP,0,136,1,5440
1218908,2022-08-06,Santa Cruz das Palmeiras/SP,0,136,0,5440
1224505,2022-08-07,Santa Cruz das Palmeiras/SP,0,136,0,5440
1230102,2022-08-08,Santa Cruz das Palmeiras/SP,0,136,0,5440
1235699,2022-08-09,Santa Cruz das Palmeiras/SP,0,136,0,5440
1241296,2022-08-10,Santa Cruz das Palmeiras/SP,0,136,0,5440
1246893,2022-08-11,Santa Cruz das Palmeiras/SP,0,136,0,5440
1252490,2022-08-12,Santa Cruz das Palmeiras/SP,0,136,0,5440
1258087,2022-08-13,Santa Cruz das Palmeiras/SP,0,136,0,5440
1263684,2022-08-14,Santa Cruz das Palmeiras/SP,0,136,0,5440
1269281,2022-08-15,Santa Cruz das Palmeiras/SP,0,136,0,5440
1274878,2022-08-16,Santa Cruz das Palmeiras/SP,0,136,1,5441
1280475,2022-08-17,Santa Cruz das Palmeiras/SP,0,136,12,5453
1286072,2022-08-18,Santa Cruz das Palmeiras/SP,0,136,4,5457
1291669,2022-08-19,Santa Cruz das Palmeiras/SP,0,136,6,5463
1297266,2022-08-20,Santa Cruz das Palmeiras/SP,0,136,19,5482
1302863,2022-08-21,Santa Cruz das Palmeiras/SP,0,136,0,5482
1308460,2022-08-22,Santa Cruz das Palmeiras/SP,0,136,0,5482
1314057,2022-08-23,Santa Cruz das Palmeiras/SP,0,136,0,5482
1319654,2022-08-24,Santa Cruz das Palmeiras/SP,0,136,0,5482
1325251,2022-08-25,Santa Cruz das Palmeiras/SP,0,136,45,5527
4919,2022-01-01,São João da Boa Vista/SP,0,314,0,9657
10516,2022-01-02,São João da Boa Vista/SP,0,314,1,9658
16113,2022-01-03,São João da Boa Vista/SP,0,314,0,9658
21710,2022-01-04,São João da Boa Vista/SP,0,314,48,9706
27307,2022-01-05,São João da Boa Vista/SP,0,314,28,9734
32904,2022-01-06,São João da Boa Vista/SP,0,314,12,9746
38501,2022-01-07,São João da Boa Vista/SP,0,314,10,9756
44098,2022-01-08,São João da Boa Vista/SP,0,314,20,9776
49695,2022-01-09,São João da Boa Vista/SP,0,314,0,9776
55292,2022-01-10,São João da Boa Vista/SP,0,314,0,9776
60889,2022-01-11,São João da Boa Vista/SP,0,314,142,9918
66486,2022-01-12,São João da Boa Vista/SP,0,314,178,10096
72083,2022-01-13,São João da Boa Vista/SP,0,314,172,10268
77680,2022-01-14,São João da Boa Vista/SP,0,314,209,10477
83277,2022-01-15,São João da Boa Vista/SP,0,314,3,10480
88874,2022-01-16,São João da Boa Vista/SP,0,314,0,10480
94471,2022-01-17,São João da Boa Vista/SP,0,314,0,10480
100068,2022-01-18,São João da Boa Vista/SP,0,314,17,10497
105665,2022-01-19,São João da Boa Vista/SP,2,316,41,10538
111262,2022-01-20,São João da Boa Vista/SP,0,316,8,10546
116859,2022-01-21,São João da Boa Vista/SP,2,318,45,10591
122456,2022-01-22,São João da Boa Vista/SP,0,318,0,10591
128053,2022-01-23,São João da Boa Vista/SP,1,319,38,10629
133650,2022-01-24,São João da Boa Vista/SP,0,319,1,10630
139247,2022-01-25,São João da Boa Vista/SP,3,322,7,10637
144844,2022-01-26,São João da Boa Vista/SP,0,322,5,10642
150441,2022-01-27,São João da Boa Vista/SP,2,324,23,10665
156038,2022-01-28,São João da Boa Vista/SP,7,331,6,10671
161635,2022-01-29,São João da Boa Vista/SP,3,334,13,10684
167232,2022-01-30,São João da Boa Vista/SP,0,334,73,10757
172829,2022-01-31,São João da Boa Vista/SP,0,334,0,10757
178426,2022-02-01,São João da Boa Vista/SP,6,340,19,10776
184023,2022-02-02,São João da Boa Vista/SP,1,341,3,10779
189620,2022-02-03,São João da Boa Vista/SP,0,341,742,11521
195217,2022-02-04,São João da Boa Vista/SP,0,341,0,11521
200814,2022-02-05,São João da Boa Vista/SP,6,347,794,12315
206411,2022-02-06,São João da Boa Vista/SP,0,347,38,12353
212008,2022-02-07,São João da Boa Vista/SP,0,347,0,12353
217605,2022-02-08,São João da Boa Vista/SP,0,347,90,12443
223202,2022-02-09,São João da Boa Vista/SP,2,349,29,12472
228799,2022-02-10,São João da Boa Vista/SP,0,349,160,12632
234396,2022-02-11,São João da Boa Vista/SP,0,349,123,12755
239993,2022-02-12,São João da Boa Vista/SP,0,349,71,12826
245590,2022-02-13,São João da Boa Vista/SP,0,349,0,12826
251187,2022-02-14,São João da Boa Vista/SP,0,349,0,12826
256784,2022-02-15,São João da Boa Vista/SP,2,351,118,12944
262381,2022-02-16,São João da Boa Vista/SP,0,351,126,13070
267978,2022-02-17,São João da Boa Vista/SP,1,352,68,13138
273575,2022-02-18,São João da Boa Vista/SP,0,352,78,13216
279172,2022-02-19,São João da Boa Vista/SP,1,353,41,13257
284769,2022-02-20,São João da Boa Vista/SP,0,353,0,13257
290366,2022-02-21,São João da Boa Vista/SP,0,353,0,13257
295963,2022-02-22,São João da Boa Vista/SP,1,354,148,13405
301560,2022-02-23,São João da Boa Vista/SP,0,354,1,13406
307157,2022-02-24,São João da Boa Vista/SP,0,354,0,13406
312754,2022-02-25,São João da Boa Vista/SP,0,354,0,13406
318351,2022-02-26,São João da Boa Vista/SP,0,354,1,13407
323948,2022-02-27,São João da Boa Vista/SP,0,354,0,13407
329545,2022-02-28,São João da Boa Vista/SP,0,354,0,13407
335142,2022-03-01,São João da Boa Vista/SP,0,354,0,13407
340739,2022-03-02,São João da Boa Vista/SP,0,354,0,13407
346336,2022-03-03,São João da Boa Vista/SP,0,354,0,13407
351933,2022-03-04,São João da Boa Vista/SP,0,354,0,13407
357530,2022-03-05,São João da Boa Vista/SP,3,357,17,13424
363127,2022-03-06,São João da Boa Vista/SP,0,357,0,13424
368724,2022-03-07,São João da Boa Vista/SP,0,357,2,13426
374321,2022-03-08,São João da Boa Vista/SP,1,358,26,13452
379918,2022-03-09,São João da Boa Vista/SP,0,358,72,13524
385515,2022-03-10,São João da Boa Vista/SP,0,358,27,13551
391112,2022-03-11,São João da Boa Vista/SP,0,358,29,13580
396709,2022-03-12,São João da Boa Vista/SP,0,358,88,13668
402306,2022-03-13,São João da Boa Vista/SP,0,358,44,13712
407903,2022-03-14,São João da Boa Vista/SP,0,358,0,13712
413500,2022-03-15,São João da Boa Vista/SP,0,358,69,13781
419097,2022-03-16,São João da Boa Vista/SP,0,358,142,13923
424694,2022-03-17,São João da Boa Vista/SP,0,358,17,13940
430291,2022-03-18,São João da Boa Vista/SP,0,358,52,13992
435888,2022-03-19,São João da Boa Vista/SP,0,358,39,14031
441485,2022-03-20,São João da Boa Vista/SP,0,358,40,14071
447082,2022-03-21,São João da Boa Vista/SP,0,358,0,14071
452679,2022-03-22,São João da Boa Vista/SP,0,358,48,14119
458276,2022-03-23,São João da Boa Vista/SP,0,358,39,14158
463873,2022-03-24,São João da Boa Vista/SP,0,358,38,14196
469470,2022-03-25,São João da Boa Vista/SP,0,358,47,14243
475067,2022-03-26,São João da Boa Vista/SP,0,358,15,14258
480664,2022-03-27,São João da Boa Vista/SP,0,358,1,14259
486261,2022-03-28,São João da Boa Vista/SP,0,358,0,14259
491858,2022-03-29,São João da Boa Vista/SP,0,358,11,14270
497455,2022-03-30,São João da Boa Vista/SP,0,358,13,14283
503052,2022-03-31,São João da Boa Vista/SP,0,358,28,14311
508649,2022-04-01,São João da Boa Vista/SP,0,358,44,14355
514246,2022-04-02,São João da Boa Vista/SP,0,358,19,14374
519843,2022-04-03,São João da Boa Vista/SP,0,358,0,14374
525440,2022-04-04,São João da Boa Vista/SP,0,358,0,14374
531037,2022-04-05,São João da Boa Vista/SP,0,358,28,14402
536634,2022-04-06,São João da Boa Vista/SP,1,359,19,14421
542231,2022-04-07,São João da Boa Vista/SP,0,359,0,14421
547828,2022-04-08,São João da Boa Vista/SP,0,359,8,14429
553425,2022-04-09,São João da Boa Vista/SP,0,359,13,14442
559022,2022-04-10,São João da Boa Vista/SP,0,359,0,14442
564619,2022-04-11,São João da Boa Vista/SP,0,359,0,14442
570216,2022-04-12,São João da Boa Vista/SP,0,359,0,14442
575813,2022-04-13,São João da Boa Vista/SP,0,359,0,14442
581410,2022-04-14,São João da Boa Vista/SP,0,359,16,14458
587007,2022-04-15,São João da Boa Vista/SP,0,359,53,14511
592604,2022-04-16,São João da Boa Vista/SP,0,359,0,14511
598201,2022-04-17,São João da Boa Vista/SP,0,359,0,14511
603798,2022-04-18,São João da Boa Vista/SP,0,359,252,14763
609395,2022-04-19,São João da Boa Vista/SP,0,359,0,14763
614992,2022-04-20,São João da Boa Vista/SP,1,360,44,14807
620589,2022-04-21,São João da Boa Vista/SP,0,360,58,14865
626186,2022-04-22,São João da Boa Vista/SP,0,360,0,14865
631783,2022-04-23,São João da Boa Vista/SP,0,360,0,14865
637380,2022-04-24,São João da Boa Vista/SP,0,360,0,14865
642977,2022-04-25,São João da Boa Vista/SP,0,360,0,14865
648574,2022-04-26,São João da Boa Vista/SP,0,360,32,14897
654171,2022-04-27,São João da Boa Vista/SP,0,360,179,15076
659768,2022-04-28,São João da Boa Vista/SP,0,360,189,15265
665365,2022-04-29,São João da Boa Vista/SP,0,360,2,15267
670962,2022-04-30,São João da Boa Vista/SP,0,360,96,15363
676559,2022-05-01,São João da Boa Vista/SP,0,360,0,15363
682156,2022-05-02,São João da Boa Vista/SP,0,360,0,15363
687753,2022-05-03,São João da Boa Vista/SP,0,360,8,15371
693350,2022-05-04,São João da Boa Vista/SP,0,360,21,15392
698947,2022-05-05,São João da Boa Vista/SP,0,360,27,15419
704544,2022-05-06,São João da Boa Vista/SP,0,360,36,15455
710141,2022-05-07,São João da Boa Vista/SP,0,360,13,15468
715738,2022-05-08,São João da Boa Vista/SP,0,360,0,15468
721335,2022-05-09,São João da Boa Vista/SP,0,360,0,15468
726932,2022-05-10,São João da Boa Vista/SP,1,361,64,15532
732529,2022-05-11,São João da Boa Vista/SP,0,361,41,15573
738126,2022-05-12,São João da Boa Vista/SP,0,361,17,15590
743723,2022-05-13,São João da Boa Vista/SP,0,361,16,15606
749320,2022-05-14,São João da Boa Vista/SP,0,361,26,15632
754917,2022-05-15,São João da Boa Vista/SP,0,361,137,15769
760514,2022-05-16,São João da Boa Vista/SP,0,361,0,15769
766111,2022-05-17,São João da Boa Vista/SP,0,361,56,15825
771708,2022-05-18,São João da Boa Vista/SP,0,361,9,15834
777305,2022-05-19,São João da Boa Vista/SP,0,361,0,15834
782902,2022-05-20,São João da Boa Vista/SP,0,361,0,15834
788499,2022-05-21,São João da Boa Vista/SP,0,361,0,15834
794096,2022-05-22,São João da Boa Vista/SP,1,362,-1,15833
799693,2022-05-23,São João da Boa Vista/SP,0,362,0,15833
805290,2022-05-24,São João da Boa Vista/SP,2,364,37,15870
810887,2022-05-25,São João da Boa Vista/SP,-1,363,93,15963
816484,2022-05-26,São João da Boa Vista/SP,1,364,304,16267
822081,2022-05-27,São João da Boa Vista/SP,1,365,143,16410
827678,2022-05-28,São João da Boa Vista/SP,0,365,99,16509
833275,2022-05-29,São João da Boa Vista/SP,0,365,70,16579
838872,2022-05-30,São João da Boa Vista/SP,0,365,0,16579
844469,2022-05-31,São João da Boa Vista/SP,0,365,118,16697
850066,2022-06-01,São João da Boa Vista/SP,1,366,82,16779
855663,2022-06-02,São João da Boa Vista/SP,0,366,112,16891
861260,2022-06-03,São João da Boa Vista/SP,0,366,0,16891
866857,2022-06-04,São João da Boa Vista/SP,0,366,0,16891
872454,2022-06-05,São João da Boa Vista/SP,0,366,0,16891
878051,2022-06-06,São João da Boa Vista/SP,0,366,0,16891
883648,2022-06-07,São João da Boa Vista/SP,1,367,582,17473
889245,2022-06-08,São João da Boa Vista/SP,1,368,148,17621
894842,2022-06-09,São João da Boa Vista/SP,0,368,54,17675
900439,2022-06-10,São João da Boa Vista/SP,0,368,93,17768
906036,2022-06-11,São João da Boa Vista/SP,1,369,56,17824
911633,2022-06-12,São João da Boa Vista/SP,0,369,265,18089
917230,2022-06-13,São João da Boa Vista/SP,0,369,0,18089
922827,2022-06-14,São João da Boa Vista/SP,0,369,0,18089
928424,2022-06-15,São João da Boa Vista/SP,0,369,154,18243
934021,2022-06-16,São João da Boa Vista/SP,0,369,96,18339
939618,2022-06-17,São João da Boa Vista/SP,0,369,0,18339
945215,2022-06-18,São João da Boa Vista/SP,0,369,0,18339
950812,2022-06-19,São João da Boa Vista/SP,0,369,0,18339
956409,2022-06-20,São João da Boa Vista/SP,0,369,0,18339
962006,2022-06-21,São João da Boa Vista/SP,0,369,76,18415
967603,2022-06-22,São João da Boa Vista/SP,0,369,53,18468
973200,2022-06-23,São João da Boa Vista/SP,0,369,76,18544
978797,2022-06-24,São João da Boa Vista/SP,0,369,0,18544
984394,2022-06-25,São João da Boa Vista/SP,0,369,107,18651
989991,2022-06-26,São João da Boa Vista/SP,0,369,0,18651
995588,2022-06-27,São João da Boa Vista/SP,0,369,0,18651
1001185,2022-06-28,São João da Boa Vista/SP,0,369,79,18730
1006782,2022-06-29,São João da Boa Vista/SP,0,369,43,18773
1012379,2022-06-30,São João da Boa Vista/SP,1,370,106,18879
1017976,2022-07-01,São João da Boa Vista/SP,0,370,73,18952
1023573,2022-07-02,São João da Boa Vista/SP,0,370,101,19053
1029170,2022-07-03,São João da Boa Vista/SP,0,370,0,19053
1034767,2022-07-04,São João da Boa Vista/SP,0,370,0,19053
1040364,2022-07-05,São João da Boa Vista/SP,3,373,76,19129
1045961,2022-07-06,São João da Boa Vista/SP,0,373,57,19186
1051558,2022-07-07,São João da Boa Vista/SP,0,373,36,19222
1057155,2022-07-08,São João da Boa Vista/SP,0,373,46,19268
1062752,2022-07-09,São João da Boa Vista/SP,0,373,75,19343
1068349,2022-07-10,São João da Boa Vista/SP,0,373,0,19343
1073946,2022-07-11,São João da Boa Vista/SP,0,373,0,19343
1079543,2022-07-12,São João da Boa Vista/SP,0,373,2,19345
1085140,2022-07-13,São João da Boa Vista/SP,1,374,32,19377
1090737,2022-07-14,São João da Boa Vista/SP,0,374,50,19427
1096334,2022-07-15,São João da Boa Vista/SP,3,377,37,19464
1101931,2022-07-16,São João da Boa Vista/SP,1,378,49,19513
1107528,2022-07-17,São João da Boa Vista/SP,0,378,22,19535
1113125,2022-07-18,São João da Boa Vista/SP,0,378,0,19535
1118722,2022-07-19,São João da Boa Vista/SP,0,378,30,19565
1124319,2022-07-20,São João da Boa Vista/SP,0,378,23,19588
1129916,2022-07-21,São João da Boa Vista/SP,0,378,54,19642
1135513,2022-07-22,São João da Boa Vista/SP,0,378,93,19735
1141110,2022-07-23,São João da Boa Vista/SP,0,378,56,19791
1146707,2022-07-24,São João da Boa Vista/SP,0,378,1,19792
1152304,2022-07-25,São João da Boa Vista/SP,0,378,0,19792
1157901,2022-07-26,São João da Boa Vista/SP,0,378,85,19877
1163498,2022-07-27,São João da Boa Vista/SP,1,379,140,20017
1169095,2022-07-28,São João da Boa Vista/SP,0,379,127,20144
1174692,2022-07-29,São João da Boa Vista/SP,0,379,83,20227
1180289,2022-07-30,São João da Boa Vista/SP,0,379,108,20335
1185886,2022-07-31,São João da Boa Vista/SP,0,379,0,20335
1191483,2022-08-01,São João da Boa Vista/SP,0,379,0,20335
1197080,2022-08-02,São João da Boa Vista/SP,0,379,129,20464
1202677,2022-08-03,São João da Boa Vista/SP,0,379,113,20577
1208274,2022-08-04,São João da Boa Vista/SP,0,379,116,20693
1213871,2022-08-05,São João da Boa Vista/SP,1,380,148,20841
1219468,2022-08-06,São João da Boa Vista/SP,0,380,102,20943
1225065,2022-08-07,São João da Boa Vista/SP,0,380,42,20985
1230662,2022-08-08,São João da Boa Vista/SP,0,380,0,20985
1236259,2022-08-09,São João da Boa Vista/SP,0,380,120,21105
1241856,2022-08-10,São João da Boa Vista/SP,0,380,161,21266
1247453,2022-08-11,São João da Boa Vista/SP,0,380,147,21413
1253050,2022-08-12,São João da Boa Vista/SP,0,380,135,21548
1258647,2022-08-13,São João da Boa Vista/SP,0,380,201,21749
1264244,2022-08-14,São João da Boa Vista/SP,0,380,36,21785
1269841,2022-08-15,São João da Boa Vista/SP,0,380,0,21785
1275438,2022-08-16,São João da Boa Vista/SP,1,381,185,21970
1281035,2022-08-17,São João da Boa Vista/SP,0,381,39,22009
1286632,2022-08-18,São João da Boa Vista/SP,0,381,29,22038
1292229,2022-08-19,São João da Boa Vista/SP,0,381,25,22063
1297826,2022-08-20,São João da Boa Vista/SP,0,381,5,22068
1303423,2022-08-21,São João da Boa Vista/SP,0,381,36,22104
1309020,2022-08-22,São João da Boa Vista/SP,0,381,0,22104
1314617,2022-08-23,São João da Boa Vista/SP,0,381,11,22115
1320214,2022-08-24,São João da Boa Vista/SP,0,381,8,22123
1325811,2022-08-25,São João da Boa Vista/SP,0,381,7,22130
4896,2022-01-01,São José do Rio Pardo/SP,0,155,0,4202
10493,2022-01-02,São José do Rio Pardo/SP,0,155,0,4202
16090,2022-01-03,São José do Rio Pardo/SP,0,155,0,4202
21687,2022-01-04,São José do Rio Pardo/SP,0,155,0,4202
27284,2022-01-05,São José do Rio Pardo/SP,0,155,8,4210
32881,2022-01-06,São José do Rio Pardo/SP,0,155,17,4227
38478,2022-01-07,São José do Rio Pardo/SP,0,155,15,4242
44075,2022-01-08,São José do Rio Pardo/SP,0,155,12,4254
49672,2022-01-09,São José do Rio Pardo/SP,0,155,0,4254
55269,2022-01-10,São José do Rio Pardo/SP,0,155,0,4254
60866,2022-01-11,São José do Rio Pardo/SP,0,155,12,4266
66463,2022-01-12,São José do Rio Pardo/SP,0,155,13,4279
72060,2022-01-13,São José do Rio Pardo/SP,0,155,0,4279
77657,2022-01-14,São José do Rio Pardo/SP,0,155,34,4313
83254,2022-01-15,São José do Rio Pardo/SP,0,155,0,4313
88851,2022-01-16,São José do Rio Pardo/SP,0,155,0,4313
94448,2022-01-17,São José do Rio Pardo/SP,0,155,0,4313
100045,2022-01-18,São José do Rio Pardo/SP,0,155,0,4313
105642,2022-01-19,São José do Rio Pardo/SP,0,155,0,4313
111239,2022-01-20,São José do Rio Pardo/SP,1,156,4,4317
116836,2022-01-21,São José do Rio Pardo/SP,0,156,6,4323
122433,2022-01-22,São José do Rio Pardo/SP,0,156,0,4323
128030,2022-01-23,São José do Rio Pardo/SP,0,156,5,4328
133627,2022-01-24,São José do Rio Pardo/SP,0,156,0,4328
139224,2022-01-25,São José do Rio Pardo/SP,1,157,23,4351
144821,2022-01-26,São José do Rio Pardo/SP,0,157,0,4351
150418,2022-01-27,São José do Rio Pardo/SP,1,158,24,4375
156015,2022-01-28,São José do Rio Pardo/SP,0,158,59,4434
161612,2022-01-29,São José do Rio Pardo/SP,0,158,77,4511
167209,2022-01-30,São José do Rio Pardo/SP,0,158,1,4512
172806,2022-01-31,São José do Rio Pardo/SP,0,158,0,4512
178403,2022-02-01,São José do Rio Pardo/SP,0,158,34,4546
184000,2022-02-02,São José do Rio Pardo/SP,0,158,0,4546
189597,2022-02-03,São José do Rio Pardo/SP,0,158,72,4618
195194,2022-02-04,São José do Rio Pardo/SP,0,158,0,4618
200791,2022-02-05,São José do Rio Pardo/SP,0,158,79,4697
206388,2022-02-06,São José do Rio Pardo/SP,0,158,1,4698
211985,2022-02-07,São José do Rio Pardo/SP,0,158,0,4698
217582,2022-02-08,São José do Rio Pardo/SP,1,159,46,4744
223179,2022-02-09,São José do Rio Pardo/SP,1,160,7,4751
228776,2022-02-10,São José do Rio Pardo/SP,3,163,73,4824
234373,2022-02-11,São José do Rio Pardo/SP,1,164,44,4868
239970,2022-02-12,São José do Rio Pardo/SP,0,164,25,4893
245567,2022-02-13,São José do Rio Pardo/SP,0,164,0,4893
251164,2022-02-14,São José do Rio Pardo/SP,0,164,0,4893
256761,2022-02-15,São José do Rio Pardo/SP,0,164,47,4940
262358,2022-02-16,São José do Rio Pardo/SP,0,164,36,4976
267955,2022-02-17,São José do Rio Pardo/SP,0,164,50,5026
273552,2022-02-18,São José do Rio Pardo/SP,0,164,40,5066
279149,2022-02-19,São José do Rio Pardo/SP,0,164,33,5099
284746,2022-02-20,São José do Rio Pardo/SP,0,164,0,5099
290343,2022-02-21,São José do Rio Pardo/SP,0,164,0,5099
295940,2022-02-22,São José do Rio Pardo/SP,1,165,50,5149
301537,2022-02-23,São José do Rio Pardo/SP,1,166,40,5189
307134,2022-02-24,São José do Rio Pardo/SP,0,166,9,5198
312731,2022-02-25,São José do Rio Pardo/SP,0,166,50,5248
318328,2022-02-26,São José do Rio Pardo/SP,1,167,42,5290
323925,2022-02-27,São José do Rio Pardo/SP,0,167,0,5290
329522,2022-02-28,São José do Rio Pardo/SP,0,167,0,5290
335119,2022-03-01,São José do Rio Pardo/SP,0,167,0,5290
340716,2022-03-02,São José do Rio Pardo/SP,0,167,0,5290
346313,2022-03-03,São José do Rio Pardo/SP,0,167,50,5340
351910,2022-03-04,São José do Rio Pardo/SP,0,167,30,5370
357507,2022-03-05,São José do Rio Pardo/SP,0,167,25,5395
363104,2022-03-06,São José do Rio Pardo/SP,0,167,0,5395
368701,2022-03-07,São José do Rio Pardo/SP,0,167,0,5395
374298,2022-03-08,São José do Rio Pardo/SP,0,167,67,5462
379895,2022-03-09,São José do Rio Pardo/SP,0,167,43,5505
385492,2022-03-10,São José do Rio Pardo/SP,0,167,135,5640
391089,2022-03-11,São José do Rio Pardo/SP,0,167,7,5647
396686,2022-03-12,São José do Rio Pardo/SP,0,167,37,5684
402283,2022-03-13,São José do Rio Pardo/SP,0,167,0,5684
407880,2022-03-14,São José do Rio Pardo/SP,0,167,0,5684
413477,2022-03-15,São José do Rio Pardo/SP,0,167,76,5760
419074,2022-03-16,São José do Rio Pardo/SP,0,167,9,5769
424671,2022-03-17,São José do Rio Pardo/SP,0,167,89,5858
430268,2022-03-18,São José do Rio Pardo/SP,0,167,8,5866
435865,2022-03-19,São José do Rio Pardo/SP,0,167,0,5866
441462,2022-03-20,São José do Rio Pardo/SP,0,167,0,5866
447059,2022-03-21,São José do Rio Pardo/SP,0,167,0,5866
452656,2022-03-22,São José do Rio Pardo/SP,0,167,14,5880
458253,2022-03-23,São José do Rio Pardo/SP,0,167,10,5890
463850,2022-03-24,São José do Rio Pardo/SP,0,167,19,5909
469447,2022-03-25,São José do Rio Pardo/SP,0,167,17,5926
475044,2022-03-26,São José do Rio Pardo/SP,0,167,0,5926
480641,2022-03-27,São José do Rio Pardo/SP,0,167,0,5926
486238,2022-03-28,São José do Rio Pardo/SP,0,167,0,5926
491835,2022-03-29,São José do Rio Pardo/SP,0,167,0,5926
497432,2022-03-30,São José do Rio Pardo/SP,0,167,1,5927
503029,2022-03-31,São José do Rio Pardo/SP,0,167,2,5929
508626,2022-04-01,São José do Rio Pardo/SP,0,167,0,5929
514223,2022-04-02,São José do Rio Pardo/SP,0,167,7,5936
519820,2022-04-03,São José do Rio Pardo/SP,0,167,0,5936
525417,2022-04-04,São José do Rio Pardo/SP,0,167,0,5936
531014,2022-04-05,São José do Rio Pardo/SP,0,167,3,5939
536611,2022-04-06,São José do Rio Pardo/SP,0,167,0,5939
542208,2022-04-07,São José do Rio Pardo/SP,0,167,5,5944
547805,2022-04-08,São José do Rio Pardo/SP,0,167,0,5944
553402,2022-04-09,São José do Rio Pardo/SP,0,167,0,5944
558999,2022-04-10,São José do Rio Pardo/SP,0,167,0,5944
564596,2022-04-11,São José do Rio Pardo/SP,0,167,0,5944
570193,2022-04-12,São José do Rio Pardo/SP,0,167,3,5947
575790,2022-04-13,São José do Rio Pardo/SP,1,168,1,5948
581387,2022-04-14,São José do Rio Pardo/SP,0,168,9,5957
586984,2022-04-15,São José do Rio Pardo/SP,0,168,0,5957
592581,2022-04-16,São José do Rio Pardo/SP,0,168,0,5957
598178,2022-04-17,São José do Rio Pardo/SP,0,168,0,5957
603775,2022-04-18,São José do Rio Pardo/SP,0,168,0,5957
609372,2022-04-19,São José do Rio Pardo/SP,0,168,0,5957
614969,2022-04-20,São José do Rio Pardo/SP,0,168,8,5965
620566,2022-04-21,São José do Rio Pardo/SP,0,168,0,5965
626163,2022-04-22,São José do Rio Pardo/SP,0,168,0,5965
631760,2022-04-23,São José do Rio Pardo/SP,0,168,0,5965
637357,2022-04-24,São José do Rio Pardo/SP,0,168,0,5965
642954,2022-04-25,São José do Rio Pardo/SP,0,168,0,5965
648551,2022-04-26,São José do Rio Pardo/SP,0,168,2,5967
654148,2022-04-27,São José do Rio Pardo/SP,0,168,2,5969
659745,2022-04-28,São José do Rio Pardo/SP,0,168,3,5972
665342,2022-04-29,São José do Rio Pardo/SP,0,168,0,5972
670939,2022-04-30,São José do Rio Pardo/SP,0,168,29,6001
676536,2022-05-01,São José do Rio Pardo/SP,0,168,0,6001
682133,2022-05-02,São José do Rio Pardo/SP,0,168,0,6001
687730,2022-05-03,São José do Rio Pardo/SP,0,168,20,6021
693327,2022-05-04,São José do Rio Pardo/SP,0,168,1,6022
698924,2022-05-05,São José do Rio Pardo/SP,0,168,10,6032
704521,2022-05-06,São José do Rio Pardo/SP,0,168,0,6032
710118,2022-05-07,São José do Rio Pardo/SP,0,168,6,6038
715715,2022-05-08,São José do Rio Pardo/SP,0,168,0,6038
721312,2022-05-09,São José do Rio Pardo/SP,0,168,0,6038
726909,2022-05-10,São José do Rio Pardo/SP,0,168,8,6046
732506,2022-05-11,São José do Rio Pardo/SP,0,168,17,6063
738103,2022-05-12,São José do Rio Pardo/SP,0,168,45,6108
743700,2022-05-13,São José do Rio Pardo/SP,0,168,7,6115
749297,2022-05-14,São José do Rio Pardo/SP,0,168,0,6115
754894,2022-05-15,São José do Rio Pardo/SP,0,168,0,6115
760491,2022-05-16,São José do Rio Pardo/SP,0,168,0,6115
766088,2022-05-17,São José do Rio Pardo/SP,0,168,60,6175
771685,2022-05-18,São José do Rio Pardo/SP,0,168,0,6175
777282,2022-05-19,São José do Rio Pardo/SP,0,168,0,6175
782879,2022-05-20,São José do Rio Pardo/SP,0,168,0,6175
788476,2022-05-21,São José do Rio Pardo/SP,0,168,0,6175
794073,2022-05-22,São José do Rio Pardo/SP,0,168,22,6197
799670,2022-05-23,São José do Rio Pardo/SP,0,168,0,6197
805267,2022-05-24,São José do Rio Pardo/SP,0,168,47,6244
810864,2022-05-25,São José do Rio Pardo/SP,0,168,0,6244
816461,2022-05-26,São José do Rio Pardo/SP,0,168,18,6262
822058,2022-05-27,São José do Rio Pardo/SP,0,168,35,6297
827655,2022-05-28,São José do Rio Pardo/SP,0,168,25,6322
833252,2022-05-29,São José do Rio Pardo/SP,0,168,0,6322
838849,2022-05-30,São José do Rio Pardo/SP,0,168,0,6322
844446,2022-05-31,São José do Rio Pardo/SP,0,168,1,6323
850043,2022-06-01,São José do Rio Pardo/SP,0,168,21,6344
855640,2022-06-02,São José do Rio Pardo/SP,0,168,4,6348
861237,2022-06-03,São José do Rio Pardo/SP,0,168,0,6348
866834,2022-06-04,São José do Rio Pardo/SP,0,168,0,6348
872431,2022-06-05,São José do Rio Pardo/SP,0,168,0,6348
878028,2022-06-06,São José do Rio Pardo/SP,0,168,0,6348
883625,2022-06-07,São José do Rio Pardo/SP,1,169,70,6418
889222,2022-06-08,São José do Rio Pardo/SP,0,169,13,6431
894819,2022-06-09,São José do Rio Pardo/SP,0,169,5,6436
900416,2022-06-10,São José do Rio Pardo/SP,0,169,1,6437
906013,2022-06-11,São José do Rio Pardo/SP,0,169,5,6442
911610,2022-06-12,São José do Rio Pardo/SP,0,169,0,6442
917207,2022-06-13,São José do Rio Pardo/SP,0,169,0,6442
922804,2022-06-14,São José do Rio Pardo/SP,0,169,0,6442
928401,2022-06-15,São José do Rio Pardo/SP,0,169,5,6447
933998,2022-06-16,São José do Rio Pardo/SP,0,169,58,6505
939595,2022-06-17,São José do Rio Pardo/SP,0,169,0,6505
945192,2022-06-18,São José do Rio Pardo/SP,0,169,0,6505
950789,2022-06-19,São José do Rio Pardo/SP,0,169,0,6505
956386,2022-06-20,São José do Rio Pardo/SP,0,169,0,6505
961983,2022-06-21,São José do Rio Pardo/SP,1,170,20,6525
967580,2022-06-22,São José do Rio Pardo/SP,0,170,2,6527
973177,2022-06-23,São José do Rio Pardo/SP,0,170,2,6529
978774,2022-06-24,São José do Rio Pardo/SP,0,170,0,6529
984371,2022-06-25,São José do Rio Pardo/SP,1,171,39,6568
989968,2022-06-26,São José do Rio Pardo/SP,0,171,0,6568
995565,2022-06-27,São José do Rio Pardo/SP,0,171,0,6568
1001162,2022-06-28,São José do Rio Pardo/SP,0,171,54,6622
1006759,2022-06-29,São José do Rio Pardo/SP,1,172,40,6662
1012356,2022-06-30,São José do Rio Pardo/SP,0,172,0,6662
1017953,2022-07-01,São José do Rio Pardo/SP,0,172,2,6664
1023550,2022-07-02,São José do Rio Pardo/SP,0,172,13,6677
1029147,2022-07-03,São José do Rio Pardo/SP,0,172,0,6677
1034744,2022-07-04,São José do Rio Pardo/SP,0,172,0,6677
1040341,2022-07-05,São José do Rio Pardo/SP,1,173,41,6718
1045938,2022-07-06,São José do Rio Pardo/SP,1,174,11,6729
1051535,2022-07-07,São José do Rio Pardo/SP,0,174,16,6745
1057132,2022-07-08,São José do Rio Pardo/SP,0,174,19,6764
1062729,2022-07-09,São José do Rio Pardo/SP,0,174,10,6774
1068326,2022-07-10,São José do Rio Pardo/SP,0,174,0,6774
1073923,2022-07-11,São José do Rio Pardo/SP,0,174,0,6774
1079520,2022-07-12,São José do Rio Pardo/SP,0,174,0,6774
1085117,2022-07-13,São José do Rio Pardo/SP,0,174,25,6799
1090714,2022-07-14,São José do Rio Pardo/SP,0,174,5,6804
1096311,2022-07-15,São José do Rio Pardo/SP,1,175,19,6823
1101908,2022-07-16,São José do Rio Pardo/SP,0,175,19,6842
1107505,2022-07-17,São José do Rio Pardo/SP,0,175,0,6842
1113102,2022-07-18,São José do Rio Pardo/SP,0,175,0,6842
1118699,2022-07-19,São José do Rio Pardo/SP,1,176,8,6850
1124296,2022-07-20,São José do Rio Pardo/SP,0,176,12,6862
1129893,2022-07-21,São José do Rio Pardo/SP,0,176,6,6868
1135490,2022-07-22,São José do Rio Pardo/SP,0,176,4,6872
1141087,2022-07-23,São José do Rio Pardo/SP,0,176,0,6872
1146684,2022-07-24,São José do Rio Pardo/SP,0,176,0,6872
1152281,2022-07-25,São José do Rio Pardo/SP,0,176,0,6872
1157878,2022-07-26,São José do Rio Pardo/SP,0,176,35,6907
1163475,2022-07-27,São José do Rio Pardo/SP,0,176,0,6907
1169072,2022-07-28,São José do Rio Pardo/SP,0,176,1,6908
1174669,2022-07-29,São José do Rio Pardo/SP,0,176,0,6908
1180266,2022-07-30,São José do Rio Pardo/SP,0,176,0,6908
1185863,2022-07-31,São José do Rio Pardo/SP,0,176,0,6908
1191460,2022-08-01,São José do Rio Pardo/SP,0,176,0,6908
1197057,2022-08-02,São José do Rio Pardo/SP,0,176,38,6946
1202654,2022-08-03,São José do Rio Pardo/SP,1,177,31,6977
1208251,2022-08-04,São José do Rio Pardo/SP,0,177,28,7005
1213848,2022-08-05,São José do Rio Pardo/SP,0,177,0,7005
1219445,2022-08-06,São José do Rio Pardo/SP,0,177,5,7010
1225042,2022-08-07,São José do Rio Pardo/SP,0,177,0,7010
1230639,2022-08-08,São José do Rio Pardo/SP,0,177,0,7010
1236236,2022-08-09,São José do Rio Pardo/SP,0,177,5,7015
1241833,2022-08-10,São José do Rio Pardo/SP,1,178,5,7020
1247430,2022-08-11,São José do Rio Pardo/SP,0,178,1,7021
1253027,2022-08-12,São José do Rio Pardo/SP,0,178,0,7021
1258624,2022-08-13,São José do Rio Pardo/SP,0,178,0,7021
1264221,2022-08-14,São José do Rio Pardo/SP,0,178,0,7021
1269818,2022-08-15,São José do Rio Pardo/SP,0,178,0,7021
1275415,2022-08-16,São José do Rio Pardo/SP,0,178,0,7021
1281012,2022-08-17,São José do Rio Pardo/SP,0,178,5,7026
1286609,2022-08-18,São José do Rio Pardo/SP,0,178,0,7026
1292206,2022-08-19,São José do Rio Pardo/SP,0,178,22,7048
1297803,2022-08-20,São José do Rio Pardo/SP,0,178,6,7054
1303400,2022-08-21,São José do Rio Pardo/SP,0,178,0,7054
1308997,2022-08-22,São José do Rio Pardo/SP,0,178,0,7054
1314594,2022-08-23,São José do Rio Pardo/SP,0,178,9,7063
1320191,2022-08-24,São José do Rio Pardo/SP,0,178,0,7063
1325788,2022-08-25,São José do Rio Pardo/SP,0,178,1,7064
5124,2022-01-01,Tambaú/SP,0,50,0,2525
10721,2022-01-02,Tambaú/SP,0,50,0,2525
16318,2022-01-03,Tambaú/SP,0,50,0,2525
21915,2022-01-04,Tambaú/SP,0,50,3,2528
27512,2022-01-05,Tambaú/SP,0,50,37,2565
33109,2022-01-06,Tambaú/SP,0,50,17,2582
38706,2022-01-07,Tambaú/SP,0,50,14,2596
44303,2022-01-08,Tambaú/SP,0,50,31,2627
49900,2022-01-09,Tambaú/SP,0,50,0,2627
55497,2022-01-10,Tambaú/SP,0,50,0,2627
61094,2022-01-11,Tambaú/SP,0,50,31,2658
66691,2022-01-12,Tambaú/SP,0,50,6,2664
72288,2022-01-13,Tambaú/SP,0,50,27,2691
77885,2022-01-14,Tambaú/SP,0,50,46,2737
83482,2022-01-15,Tambaú/SP,0,50,0,2737
89079,2022-01-16,Tambaú/SP,0,50,27,2764
94676,2022-01-17,Tambaú/SP,0,50,103,2867
100273,2022-01-18,Tambaú/SP,0,50,40,2907
105870,2022-01-19,Tambaú/SP,0,50,48,2955
111467,2022-01-20,Tambaú/SP,0,50,57,3012
117064,2022-01-21,Tambaú/SP,0,50,28,3040
122661,2022-01-22,Tambaú/SP,0,50,0,3040
128258,2022-01-23,Tambaú/SP,0,50,28,3068
133855,2022-01-24,Tambaú/SP,0,50,0,3068
139452,2022-01-25,Tambaú/SP,0,50,17,3085
145049,2022-01-26,Tambaú/SP,0,50,26,3111
150646,2022-01-27,Tambaú/SP,0,50,31,3142
156243,2022-01-28,Tambaú/SP,0,50,27,3169
161840,2022-01-29,Tambaú/SP,0,50,33,3202
167437,2022-01-30,Tambaú/SP,0,50,0,3202
173034,2022-01-31,Tambaú/SP,0,50,0,3202
178631,2022-02-01,Tambaú/SP,0,50,12,3214
184228,2022-02-02,Tambaú/SP,0,50,0,3214
189825,2022-02-03,Tambaú/SP,0,50,107,3321
195422,2022-02-04,Tambaú/SP,0,50,0,3321
201019,2022-02-05,Tambaú/SP,1,51,105,3426
206616,2022-02-06,Tambaú/SP,0,51,15,3441
212213,2022-02-07,Tambaú/SP,0,51,20,3461
217810,2022-02-08,Tambaú/SP,0,51,38,3499
223407,2022-02-09,Tambaú/SP,4,55,114,3613
229004,2022-02-10,Tambaú/SP,0,55,43,3656
234601,2022-02-11,Tambaú/SP,0,55,57,3713
240198,2022-02-12,Tambaú/SP,0,55,58,3771
245795,2022-02-13,Tambaú/SP,0,55,0,3771
251392,2022-02-14,Tambaú/SP,0,55,0,3771
256989,2022-02-15,Tambaú/SP,1,56,53,3824
262586,2022-02-16,Tambaú/SP,0,56,65,3889
268183,2022-02-17,Tambaú/SP,0,56,67,3956
273780,2022-02-18,Tambaú/SP,0,56,61,4017
279377,2022-02-19,Tambaú/SP,0,56,27,4044
284974,2022-02-20,Tambaú/SP,0,56,57,4101
290571,2022-02-21,Tambaú/SP,0,56,0,4101
296168,2022-02-22,Tambaú/SP,0,56,20,4121
301765,2022-02-23,Tambaú/SP,0,56,10,4131
307362,2022-02-24,Tambaú/SP,0,56,31,4162
312959,2022-02-25,Tambaú/SP,0,56,20,4182
318556,2022-02-26,Tambaú/SP,0,56,36,4218
324153,2022-02-27,Tambaú/SP,0,56,0,4218
329750,2022-02-28,Tambaú/SP,0,56,0,4218
335347,2022-03-01,Tambaú/SP,0,56,3,4221
340944,2022-03-02,Tambaú/SP,0,56,0,4221
346541,2022-03-03,Tambaú/SP,1,57,11,4232
352138,2022-03-04,Tambaú/SP,0,57,9,4241
357735,2022-03-05,Tambaú/SP,0,57,3,4244
363332,2022-03-06,Tambaú/SP,0,57,0,4244
368929,2022-03-07,Tambaú/SP,0,57,0,4244
374526,2022-03-08,Tambaú/SP,0,57,2,4246
380123,2022-03-09,Tambaú/SP,0,57,8,4254
385720,2022-03-10,Tambaú/SP,0,57,1,4255
391317,2022-03-11,Tambaú/SP,0,57,6,4261
396914,2022-03-12,Tambaú/SP,0,57,4,4265
402511,2022-03-13,Tambaú/SP,0,57,0,4265
408108,2022-03-14,Tambaú/SP,0,57,0,4265
413705,2022-03-15,Tambaú/SP,0,57,1,4266
419302,2022-03-16,Tambaú/SP,0,57,1,4267
424899,2022-03-17,Tambaú/SP,0,57,2,4269
430496,2022-03-18,Tambaú/SP,0,57,0,4269
436093,2022-03-19,Tambaú/SP,0,57,1,4270
441690,2022-03-20,Tambaú/SP,0,57,0,4270
447287,2022-03-21,Tambaú/SP,0,57,0,4270
452884,2022-03-22,Tambaú/SP,0,57,0,4270
458481,2022-03-23,Tambaú/SP,0,57,1,4271
464078,2022-03-24,Tambaú/SP,0,57,-1,4270
469675,2022-03-25,Tambaú/SP,0,57,0,4270
475272,2022-03-26,Tambaú/SP,0,57,-2,4268
480869,2022-03-27,Tambaú/SP,0,57,0,4268
486466,2022-03-28,Tambaú/SP,0,57,0,4268
492063,2022-03-29,Tambaú/SP,0,57,0,4268
497660,2022-03-30,Tambaú/SP,0,57,-2,4266
503257,2022-03-31,Tambaú/SP,0,57,-2,4264
508854,2022-04-01,Tambaú/SP,0,57,1,4265
514451,2022-04-02,Tambaú/SP,0,57,0,4265
520048,2022-04-03,Tambaú/SP,0,57,0,4265
525645,2022-04-04,Tambaú/SP,0,57,0,4265
531242,2022-04-05,Tambaú/SP,0,57,2,4267
536839,2022-04-06,Tambaú/SP,0,57,0,4267
542436,2022-04-07,Tambaú/SP,0,57,2,4269
548033,2022-04-08,Tambaú/SP,0,57,-3,4266
553630,2022-04-09,Tambaú/SP,0,57,2,4268
559227,2022-04-10,Tambaú/SP,0,57,0,4268
564824,2022-04-11,Tambaú/SP,0,57,0,4268
570421,2022-04-12,Tambaú/SP,0,57,2,4270
576018,2022-04-13,Tambaú/SP,0,57,1,4271
581615,2022-04-14,Tambaú/SP,0,57,0,4271
587212,2022-04-15,Tambaú/SP,0,57,0,4271
592809,2022-04-16,Tambaú/SP,0,57,0,4271
598406,2022-04-17,Tambaú/SP,0,57,0,4271
604003,2022-04-18,Tambaú/SP,0,57,0,4271
609600,2022-04-19,Tambaú/SP,0,57,0,4271
615197,2022-04-20,Tambaú/SP,0,57,6,4277
620794,2022-04-21,Tambaú/SP,0,57,2,4279
626391,2022-04-22,Tambaú/SP,0,57,0,4279
631988,2022-04-23,Tambaú/SP,0,57,0,4279
637585,2022-04-24,Tambaú/SP,0,57,0,4279
643182,2022-04-25,Tambaú/SP,0,57,0,4279
648779,2022-04-26,Tambaú/SP,0,57,1,4280
654376,2022-04-27,Tambaú/SP,0,57,8,4288
659973,2022-04-28,Tambaú/SP,0,57,6,4294
665570,2022-04-29,Tambaú/SP,0,57,0,4294
671167,2022-04-30,Tambaú/SP,0,57,11,4305
676764,2022-05-01,Tambaú/SP,0,57,0,4305
682361,2022-05-02,Tambaú/SP,0,57,0,4305
687958,2022-05-03,Tambaú/SP,0,57,3,4308
693555,2022-05-04,Tambaú/SP,0,57,4,4312
699152,2022-05-05,Tambaú/SP,0,57,3,4315
704749,2022-05-06,Tambaú/SP,0,57,7,4322
710346,2022-05-07,Tambaú/SP,0,57,4,4326
715943,2022-05-08,Tambaú/SP,0,57,0,4326
721540,2022-05-09,Tambaú/SP,0,57,0,4326
727137,2022-05-10,Tambaú/SP,0,57,5,4331
732734,2022-05-11,Tambaú/SP,0,57,2,4333
738331,2022-05-12,Tambaú/SP,1,58,10,4343
743928,2022-05-13,Tambaú/SP,0,58,5,4348
749525,2022-05-14,Tambaú/SP,0,58,7,4355
755122,2022-05-15,Tambaú/SP,0,58,0,4355
760719,2022-05-16,Tambaú/SP,0,58,0,4355
766316,2022-05-17,Tambaú/SP,0,58,9,4364
771913,2022-05-18,Tambaú/SP,0,58,0,4364
777510,2022-05-19,Tambaú/SP,0,58,0,4364
783107,2022-05-20,Tambaú/SP,0,58,0,4364
788704,2022-05-21,Tambaú/SP,0,58,0,4364
794301,2022-05-22,Tambaú/SP,0,58,6,4370
799898,2022-05-23,Tambaú/SP,0,58,0,4370
805495,2022-05-24,Tambaú/SP,0,58,23,4393
811092,2022-05-25,Tambaú/SP,0,58,3,4396
816689,2022-05-26,Tambaú/SP,0,58,6,4402
822286,2022-05-27,Tambaú/SP,0,58,21,4423
827883,2022-05-28,Tambaú/SP,0,58,6,4429
833480,2022-05-29,Tambaú/SP,0,58,0,4429
839077,2022-05-30,Tambaú/SP,0,58,0,4429
844674,2022-05-31,Tambaú/SP,0,58,13,4442
850271,2022-06-01,Tambaú/SP,0,58,13,4455
855868,2022-06-02,Tambaú/SP,0,58,13,4468
861465,2022-06-03,Tambaú/SP,0,58,0,4468
867062,2022-06-04,Tambaú/SP,0,58,0,4468
872659,2022-06-05,Tambaú/SP,0,58,0,4468
878256,2022-06-06,Tambaú/SP,0,58,0,4468
883853,2022-06-07,Tambaú/SP,1,59,44,4512
889450,2022-06-08,Tambaú/SP,0,59,11,4523
895047,2022-06-09,Tambaú/SP,0,59,4,4527
900644,2022-06-10,Tambaú/SP,0,59,9,4536
906241,2022-06-11,Tambaú/SP,0,59,11,4547
911838,2022-06-12,Tambaú/SP,0,59,0,4547
917435,2022-06-13,Tambaú/SP,0,59,0,4547
923032,2022-06-14,Tambaú/SP,0,59,0,4547
928629,2022-06-15,Tambaú/SP,0,59,25,4572
934226,2022-06-16,Tambaú/SP,0,59,10,4582
939823,2022-06-17,Tambaú/SP,0,59,0,4582
945420,2022-06-18,Tambaú/SP,0,59,0,4582
951017,2022-06-19,Tambaú/SP,0,59,0,4582
956614,2022-06-20,Tambaú/SP,0,59,0,4582
962211,2022-06-21,Tambaú/SP,0,59,7,4589
967808,2022-06-22,Tambaú/SP,0,59,29,4618
973405,2022-06-23,Tambaú/SP,0,59,11,4629
979002,2022-06-24,Tambaú/SP,0,59,0,4629
984599,2022-06-25,Tambaú/SP,0,59,12,4641
990196,2022-06-26,Tambaú/SP,0,59,0,4641
995793,2022-06-27,Tambaú/SP,0,59,0,4641
1001390,2022-06-28,Tambaú/SP,0,59,5,4646
1006987,2022-06-29,Tambaú/SP,0,59,2,4648
1012584,2022-06-30,Tambaú/SP,0,59,1,4649
1018181,2022-07-01,Tambaú/SP,1,60,10,4659
1023778,2022-07-02,Tambaú/SP,0,60,65,4724
1029375,2022-07-03,Tambaú/SP,0,60,0,4724
1034972,2022-07-04,Tambaú/SP,0,60,0,4724
1040569,2022-07-05,Tambaú/SP,0,60,21,4745
1046166,2022-07-06,Tambaú/SP,0,60,6,4751
1051763,2022-07-07,Tambaú/SP,0,60,7,4758
1057360,2022-07-08,Tambaú/SP,0,60,7,4765
1062957,2022-07-09,Tambaú/SP,0,60,6,4771
1068554,2022-07-10,Tambaú/SP,0,60,0,4771
1074151,2022-07-11,Tambaú/SP,0,60,0,4771
1079748,2022-07-12,Tambaú/SP,0,60,21,4792
1085345,2022-07-13,Tambaú/SP,0,60,8,4800
1090942,2022-07-14,Tambaú/SP,0,60,9,4809
1096539,2022-07-15,Tambaú/SP,0,60,6,4815
1102136,2022-07-16,Tambaú/SP,1,61,7,4822
1107733,2022-07-17,Tambaú/SP,0,61,0,4822
1113330,2022-07-18,Tambaú/SP,0,61,0,4822
1118927,2022-07-19,Tambaú/SP,0,61,16,4838
1124524,2022-07-20,Tambaú/SP,0,61,17,4855
1130121,2022-07-21,Tambaú/SP,0,61,10,4865
1135718,2022-07-22,Tambaú/SP,0,61,12,4877
1141315,2022-07-23,Tambaú/SP,0,61,8,4885
1146912,2022-07-24,Tambaú/SP,0,61,0,4885
1152509,2022-07-25,Tambaú/SP,0,61,0,4885
1158106,2022-07-26,Tambaú/SP,0,61,20,4905
1163703,2022-07-27,Tambaú/SP,0,61,9,4914
1169300,2022-07-28,Tambaú/SP,0,61,6,4920
1174897,2022-07-29,Tambaú/SP,0,61,3,4923
1180494,2022-07-30,Tambaú/SP,0,61,12,4935
1186091,2022-07-31,Tambaú/SP,0,61,0,4935
1191688,2022-08-01,Tambaú/SP,0,61,0,4935
1197285,2022-08-02,Tambaú/SP,0,61,17,4952
1202882,2022-08-03,Tambaú/SP,0,61,8,4960
1208479,2022-08-04,Tambaú/SP,0,61,9,4969
1214076,2022-08-05,Tambaú/SP,0,61,5,4974
1219673,2022-08-06,Tambaú/SP,0,61,4,4978
1225270,2022-08-07,Tambaú/SP,0,61,0,4978
1230867,2022-08-08,Tambaú/SP,0,61,0,4978
1236464,2022-08-09,Tambaú/SP,0,61,14,4992
1242061,2022-08-10,Tambaú/SP,0,61,7,4999
1247658,2022-08-11,Tambaú/SP,0,61,4,5003
1253255,2022-08-12,Tambaú/SP,0,61,2,5005
1258852,2022-08-13,Tambaú/SP,0,61,3,5008
1264449,2022-08-14,Tambaú/SP,0,61,0,5008
1270046,2022-08-15,Tambaú/SP,0,61,0,5008
1275643,2022-08-16,Tambaú/SP,0,61,2,5010
1281240,2022-08-17,Tambaú/SP,0,61,5,5015
1286837,2022-08-18,Tambaú/SP,0,61,4,5019
1292434,2022-08-19,Tambaú/SP,0,61,3,5022
1298031,2022-08-20,Tambaú/SP,0,61,4,5026
1303628,2022-08-21,Tambaú/SP,0,61,0,5026
1309225,2022-08-22,Tambaú/SP,0,61,0,5026
1314822,2022-08-23,Tambaú/SP,0,61,0,5026
1320419,2022-08-24,Tambaú/SP,0,61,3,5029
1326016,2022-08-25,Tambaú/SP,0,61,1,5030
5414,2022-01-01,Valinhos/SP,0,433,4,15433
11011,2022-01-02,Valinhos/SP,0,433,5,15438
16608,2022-01-03,Valinhos/SP,0,433,2,15440
22205,2022-01-04,Valinhos/SP,0,433,12,15452
27802,2022-01-05,Valinhos/SP,0,433,15,15467
33399,2022-01-06,Valinhos/SP,1,434,2,15469
38996,2022-01-07,Valinhos/SP,0,434,10,15479
44593,2022-01-08,Valinhos/SP,1,435,15,15494
50190,2022-01-09,Valinhos/SP,0,435,6,15500
55787,2022-01-10,Valinhos/SP,0,435,2,15502
61384,2022-01-11,Valinhos/SP,0,435,12,15514
66981,2022-01-12,Valinhos/SP,0,435,18,15532
72578,2022-01-13,Valinhos/SP,0,435,3,15535
78175,2022-01-14,Valinhos/SP,0,435,125,15660
83772,2022-01-15,Valinhos/SP,0,435,2,15662
89369,2022-01-16,Valinhos/SP,0,435,6,15668
94966,2022-01-17,Valinhos/SP,0,435,1,15669
100563,2022-01-18,Valinhos/SP,0,435,63,15732
106160,2022-01-19,Valinhos/SP,2,437,67,15799
111757,2022-01-20,Valinhos/SP,1,438,35,15834
117354,2022-01-21,Valinhos/SP,0,438,87,15921
122951,2022-01-22,Valinhos/SP,0,438,0,15921
128548,2022-01-23,Valinhos/SP,0,438,140,16061
134145,2022-01-24,Valinhos/SP,0,438,2,16063
139742,2022-01-25,Valinhos/SP,3,441,34,16097
145339,2022-01-26,Valinhos/SP,1,442,73,16170
150936,2022-01-27,Valinhos/SP,2,444,93,16263
156533,2022-01-28,Valinhos/SP,0,444,54,16317
162130,2022-01-29,Valinhos/SP,2,446,59,16376
167727,2022-01-30,Valinhos/SP,0,446,63,16439
173324,2022-01-31,Valinhos/SP,0,446,0,16439
178921,2022-02-01,Valinhos/SP,1,447,80,16519
184518,2022-02-02,Valinhos/SP,1,448,4,16523
190115,2022-02-03,Valinhos/SP,1,449,130,16653
195712,2022-02-04,Valinhos/SP,0,449,0,16653
201309,2022-02-05,Valinhos/SP,0,449,116,16769
206906,2022-02-06,Valinhos/SP,0,449,1,16770
212503,2022-02-07,Valinhos/SP,0,449,35,16805
218100,2022-02-08,Valinhos/SP,1,450,83,16888
223697,2022-02-09,Valinhos/SP,1,451,82,16970
229294,2022-02-10,Valinhos/SP,2,453,50,17020
234891,2022-02-11,Valinhos/SP,0,453,31,17051
240488,2022-02-12,Valinhos/SP,3,456,38,17089
246085,2022-02-13,Valinhos/SP,0,456,3,17092
251682,2022-02-14,Valinhos/SP,0,456,26,17118
257279,2022-02-15,Valinhos/SP,2,458,31,17149
262876,2022-02-16,Valinhos/SP,3,461,31,17180
268473,2022-02-17,Valinhos/SP,0,461,63,17243
274070,2022-02-18,Valinhos/SP,0,461,28,17271
279667,2022-02-19,Valinhos/SP,0,461,33,17304
285264,2022-02-20,Valinhos/SP,0,461,-4,17300
290861,2022-02-21,Valinhos/SP,0,461,2,17302
296458,2022-02-22,Valinhos/SP,3,464,69,17371
302055,2022-02-23,Valinhos/SP,0,464,60,17431
307652,2022-02-24,Valinhos/SP,0,464,57,17488
313249,2022-02-25,Valinhos/SP,0,464,39,17527
318846,2022-02-26,Valinhos/SP,0,464,45,17572
324443,2022-02-27,Valinhos/SP,0,464,2,17574
330040,2022-02-28,Valinhos/SP,0,464,3,17577
335637,2022-03-01,Valinhos/SP,0,464,5,17582
341234,2022-03-02,Valinhos/SP,0,464,0,17582
346831,2022-03-03,Valinhos/SP,3,467,81,17663
352428,2022-03-04,Valinhos/SP,0,467,13,17676
358025,2022-03-05,Valinhos/SP,3,470,60,17736
363622,2022-03-06,Valinhos/SP,0,470,0,17736
369219,2022-03-07,Valinhos/SP,0,470,2,17738
374816,2022-03-08,Valinhos/SP,1,471,55,17793
380413,2022-03-09,Valinhos/SP,0,471,16,17809
386010,2022-03-10,Valinhos/SP,0,471,65,17874
391607,2022-03-11,Valinhos/SP,0,471,21,17895
397204,2022-03-12,Valinhos/SP,0,471,37,17932
402801,2022-03-13,Valinhos/SP,0,471,28,17960
408398,2022-03-14,Valinhos/SP,0,471,1,17961
413995,2022-03-15,Valinhos/SP,0,471,13,17974
419592,2022-03-16,Valinhos/SP,0,471,26,18000
425189,2022-03-17,Valinhos/SP,0,471,35,18035
430786,2022-03-18,Valinhos/SP,-1,470,39,18074
436383,2022-03-19,Valinhos/SP,0,470,16,18090
441980,2022-03-20,Valinhos/SP,0,470,21,18111
447577,2022-03-21,Valinhos/SP,0,470,1,18112
453174,2022-03-22,Valinhos/SP,1,471,25,18137
458771,2022-03-23,Valinhos/SP,0,471,15,18152
464368,2022-03-24,Valinhos/SP,0,471,13,18165
469965,2022-03-25,Valinhos/SP,0,471,2,18167
475562,2022-03-26,Valinhos/SP,0,471,13,18180
481159,2022-03-27,Valinhos/SP,0,471,13,18193
486756,2022-03-28,Valinhos/SP,0,471,0,18193
492353,2022-03-29,Valinhos/SP,1,472,16,18209
497950,2022-03-30,Valinhos/SP,1,473,10,18219
503547,2022-03-31,Valinhos/SP,0,473,36,18255
509144,2022-04-01,Valinhos/SP,2,475,9,18264
514741,2022-04-02,Valinhos/SP,0,475,8,18272
520338,2022-04-03,Valinhos/SP,0,475,2,18274
525935,2022-04-04,Valinhos/SP,-1,474,-1,18273
531532,2022-04-05,Valinhos/SP,0,474,16,18289
537129,2022-04-06,Valinhos/SP,0,474,28,18317
542726,2022-04-07,Valinhos/SP,0,474,4,18321
548323,2022-04-08,Valinhos/SP,0,474,12,18333
553920,2022-04-09,Valinhos/SP,0,474,17,18350
559517,2022-04-10,Valinhos/SP,0,474,65,18415
565114,2022-04-11,Valinhos/SP,0,474,1,18416
570711,2022-04-12,Valinhos/SP,0,474,15,18431
576308,2022-04-13,Valinhos/SP,0,474,0,18431
581905,2022-04-14,Valinhos/SP,0,474,14,18445
587502,2022-04-15,Valinhos/SP,0,474,35,18480
593099,2022-04-16,Valinhos/SP,0,474,1,18481
598696,2022-04-17,Valinhos/SP,0,474,0,18481
604293,2022-04-18,Valinhos/SP,0,474,35,18516
609890,2022-04-19,Valinhos/SP,0,474,0,18516
615487,2022-04-20,Valinhos/SP,0,474,57,18573
621084,2022-04-21,Valinhos/SP,0,474,49,18622
626681,2022-04-22,Valinhos/SP,0,474,2,18624
632278,2022-04-23,Valinhos/SP,0,474,2,18626
637875,2022-04-24,Valinhos/SP,0,474,29,18655
643472,2022-04-25,Valinhos/SP,0,474,1,18656
649069,2022-04-26,Valinhos/SP,0,474,41,18697
654666,2022-04-27,Valinhos/SP,0,474,38,18735
660263,2022-04-28,Valinhos/SP,0,474,67,18802
665860,2022-04-29,Valinhos/SP,0,474,4,18806
671457,2022-04-30,Valinhos/SP,0,474,32,18838
677054,2022-05-01,Valinhos/SP,0,474,-10,18828
682651,2022-05-02,Valinhos/SP,0,474,4,18832
688248,2022-05-03,Valinhos/SP,0,474,58,18890
693845,2022-05-04,Valinhos/SP,0,474,44,18934
699442,2022-05-05,Valinhos/SP,0,474,35,18969
705039,2022-05-06,Valinhos/SP,0,474,40,19009
710636,2022-05-07,Valinhos/SP,0,474,27,19036
716233,2022-05-08,Valinhos/SP,0,474,2,19038
721830,2022-05-09,Valinhos/SP,0,474,0,19038
727427,2022-05-10,Valinhos/SP,0,474,43,19081
733024,2022-05-11,Valinhos/SP,0,474,59,19140
738621,2022-05-12,Valinhos/SP,0,474,51,19191
744218,2022-05-13,Valinhos/SP,0,474,17,19208
749815,2022-05-14,Valinhos/SP,0,474,3,19211
755412,2022-05-15,Valinhos/SP,0,474,1,19212
761009,2022-05-16,Valinhos/SP,0,474,1,19213
766606,2022-05-17,Valinhos/SP,0,474,-1,19212
772203,2022-05-18,Valinhos/SP,0,474,-2,19210
777800,2022-05-19,Valinhos/SP,1,475,5,19215
783397,2022-05-20,Valinhos/SP,0,475,0,19215
788994,2022-05-21,Valinhos/SP,0,475,0,19215
794591,2022-05-22,Valinhos/SP,0,475,5,19220
800188,2022-05-23,Valinhos/SP,0,475,2,19222
805785,2022-05-24,Valinhos/SP,0,475,16,19238
811382,2022-05-25,Valinhos/SP,0,475,1,19239
816979,2022-05-26,Valinhos/SP,1,476,6,19245
822576,2022-05-27,Valinhos/SP,1,477,10,19255
828173,2022-05-28,Valinhos/SP,1,478,5,19260
833770,2022-05-29,Valinhos/SP,0,478,36,19296
839367,2022-05-30,Valinhos/SP,0,478,8,19304
844964,2022-05-31,Valinhos/SP,0,478,9,19313
850561,2022-06-01,Valinhos/SP,0,478,17,19330
856158,2022-06-02,Valinhos/SP,0,478,8,19338
861755,2022-06-03,Valinhos/SP,0,478,0,19338
867352,2022-06-04,Valinhos/SP,0,478,0,19338
872949,2022-06-05,Valinhos/SP,0,478,0,19338
878546,2022-06-06,Valinhos/SP,0,478,0,19338
884143,2022-06-07,Valinhos/SP,1,479,49,19387
889740,2022-06-08,Valinhos/SP,1,480,18,19405
895337,2022-06-09,Valinhos/SP,0,480,17,19422
900934,2022-06-10,Valinhos/SP,0,480,6,19428
906531,2022-06-11,Valinhos/SP,2,482,24,19452
912128,2022-06-12,Valinhos/SP,0,482,6,19458
917725,2022-06-13,Valinhos/SP,0,482,2,19460
923322,2022-06-14,Valinhos/SP,0,482,0,19460
928919,2022-06-15,Valinhos/SP,0,482,25,19485
934516,2022-06-16,Valinhos/SP,3,485,36,19521
940113,2022-06-17,Valinhos/SP,0,485,91,19612
945710,2022-06-18,Valinhos/SP,0,485,7,19619
951307,2022-06-19,Valinhos/SP,0,485,5,19624
956904,2022-06-20,Valinhos/SP,0,485,1,19625
962501,2022-06-21,Valinhos/SP,0,485,29,19654
968098,2022-06-22,Valinhos/SP,0,485,6,19660
973695,2022-06-23,Valinhos/SP,2,487,28,19688
979292,2022-06-24,Valinhos/SP,0,487,0,19688
984889,2022-06-25,Valinhos/SP,0,487,24,19712
990486,2022-06-26,Valinhos/SP,0,487,1,19713
996083,2022-06-27,Valinhos/SP,0,487,4,19717
1001680,2022-06-28,Valinhos/SP,0,487,35,19752
1007277,2022-06-29,Valinhos/SP,1,488,29,19781
1012874,2022-06-30,Valinhos/SP,0,488,23,19804
1018471,2022-07-01,Valinhos/SP,0,488,9,19813
1024068,2022-07-02,Valinhos/SP,0,488,14,19827
1029665,2022-07-03,Valinhos/SP,0,488,54,19881
1035262,2022-07-04,Valinhos/SP,0,488,0,19881
1040859,2022-07-05,Valinhos/SP,1,489,17,19898
1046456,2022-07-06,Valinhos/SP,2,491,20,19918
1052053,2022-07-07,Valinhos/SP,3,494,0,19918
1057650,2022-07-08,Valinhos/SP,1,495,25,19943
1063247,2022-07-09,Valinhos/SP,1,496,9,19952
1068844,2022-07-10,Valinhos/SP,0,496,1,19953
1074441,2022-07-11,Valinhos/SP,0,496,1,19954
1080038,2022-07-12,Valinhos/SP,0,496,45,19999
1085635,2022-07-13,Valinhos/SP,0,496,68,20067
1091232,2022-07-14,Valinhos/SP,0,496,49,20116
1096829,2022-07-15,Valinhos/SP,1,497,50,20166
1102426,2022-07-16,Valinhos/SP,0,497,39,20205
1108023,2022-07-17,Valinhos/SP,0,497,0,20205
1113620,2022-07-18,Valinhos/SP,0,497,1,20206
1119217,2022-07-19,Valinhos/SP,1,498,22,20228
1124814,2022-07-20,Valinhos/SP,0,498,11,20239
1130411,2022-07-21,Valinhos/SP,2,500,20,20259
1136008,2022-07-22,Valinhos/SP,0,500,19,20278
1141605,2022-07-23,Valinhos/SP,0,500,37,20315
1147202,2022-07-24,Valinhos/SP,0,500,22,20337
1152799,2022-07-25,Valinhos/SP,0,500,1,20338
1158396,2022-07-26,Valinhos/SP,0,500,8,20346
1163993,2022-07-27,Valinhos/SP,0,500,26,20372
1169590,2022-07-28,Valinhos/SP,0,500,71,20443
1175187,2022-07-29,Valinhos/SP,1,501,3,20446
1180784,2022-07-30,Valinhos/SP,0,501,13,20459
1186381,2022-07-31,Valinhos/SP,0,501,0,20459
1191978,2022-08-01,Valinhos/SP,0,501,0,20459
1197575,2022-08-02,Valinhos/SP,0,501,57,20516
1203172,2022-08-03,Valinhos/SP,0,501,25,20541
1208769,2022-08-04,Valinhos/SP,0,501,5,20546
1214366,2022-08-05,Valinhos/SP,0,501,19,20565
1219963,2022-08-06,Valinhos/SP,1,502,25,20590
1225560,2022-08-07,Valinhos/SP,0,502,0,20590
1231157,2022-08-08,Valinhos/SP,0,502,0,20590
1236754,2022-08-09,Valinhos/SP,1,503,54,20644
1242351,2022-08-10,Valinhos/SP,0,503,16,20660
1247948,2022-08-11,Valinhos/SP,1,504,37,20697
1253545,2022-08-12,Valinhos/SP,0,504,22,20719
1259142,2022-08-13,Valinhos/SP,1,505,24,20743
1264739,2022-08-14,Valinhos/SP,0,505,0,20743
1270336,2022-08-15,Valinhos/SP,0,505,0,20743
1275933,2022-08-16,Valinhos/SP,1,506,38,20781
1281530,2022-08-17,Valinhos/SP,2,508,36,20817
1287127,2022-08-18,Valinhos/SP,0,508,43,20860
1292724,2022-08-19,Valinhos/SP,0,508,13,20873
1298321,2022-08-20,Valinhos/SP,0,508,24,20897
1303918,2022-08-21,Valinhos/SP,0,508,-1,20896
1309515,2022-08-22,Valinhos/SP,0,508,0,20896
1315112,2022-08-23,Valinhos/SP,0,508,14,20910
1320709,2022-08-24,Valinhos/SP,0,508,29,20939
1326306,2022-08-25,Valinhos/SP,0,508,29,20968
4897,2022-01-01,São José do Rio Preto/SP,-1,2833,121,96562
10494,2022-01-02,São José do Rio Preto/SP,0,2833,-3,96559
16091,2022-01-03,São José do Rio Preto/SP,0,2833,19,96578
21688,2022-01-04,São José do Rio Preto/SP,0,2833,234,96812
27285,2022-01-05,São José do Rio Preto/SP,0,2833,193,97005
32882,2022-01-06,São José do Rio Preto/SP,1,2834,203,97208
38479,2022-01-07,São José do Rio Preto/SP,0,2834,195,97403
44076,2022-01-08,São José do Rio Preto/SP,0,2834,499,97902
49673,2022-01-09,São José do Rio Preto/SP,0,2834,140,98042
55270,2022-01-10,São José do Rio Preto/SP,0,2834,22,98064
60867,2022-01-11,São José do Rio Preto/SP,2,2836,353,98417
66464,2022-01-12,São José do Rio Preto/SP,1,2837,409,98826
72061,2022-01-13,São José do Rio Preto/SP,0,2837,424,99250
77658,2022-01-14,São José do Rio Preto/SP,0,2837,478,99728
83255,2022-01-15,São José do Rio Preto/SP,1,2838,25,99753
88852,2022-01-16,São José do Rio Preto/SP,0,2838,66,99819
94449,2022-01-17,São José do Rio Preto/SP,0,2838,94,99913
100046,2022-01-18,São José do Rio Preto/SP,4,2842,847,100760
105643,2022-01-19,São José do Rio Preto/SP,1,2843,553,101313
111240,2022-01-20,São José do Rio Preto/SP,1,2844,412,101725
116837,2022-01-21,São José do Rio Preto/SP,7,2851,380,102105
122434,2022-01-22,São José do Rio Preto/SP,0,2851,0,102105
128031,2022-01-23,São José do Rio Preto/SP,9,2860,628,102733
133628,2022-01-24,São José do Rio Preto/SP,0,2860,63,102796
139225,2022-01-25,São José do Rio Preto/SP,4,2864,649,103445
144822,2022-01-26,São José do Rio Preto/SP,6,2870,647,104092
150419,2022-01-27,São José do Rio Preto/SP,5,2875,612,104704
156016,2022-01-28,São José do Rio Preto/SP,3,2878,570,105274
161613,2022-01-29,São José do Rio Preto/SP,5,2883,388,105662
167210,2022-01-30,São José do Rio Preto/SP,1,2884,241,105903
172807,2022-01-31,São José do Rio Preto/SP,0,2884,0,105903
178404,2022-02-01,São José do Rio Preto/SP,7,2891,861,106764
184001,2022-02-02,São José do Rio Preto/SP,14,2905,13,106777
189598,2022-02-03,São José do Rio Preto/SP,4,2909,944,107721
195195,2022-02-04,São José do Rio Preto/SP,0,2909,0,107721
200792,2022-02-05,São José do Rio Preto/SP,12,2921,799,108520
206389,2022-02-06,São José do Rio Preto/SP,9,2930,173,108693
211986,2022-02-07,São José do Rio Preto/SP,5,2935,129,108822
217583,2022-02-08,São José do Rio Preto/SP,11,2946,339,109161
223180,2022-02-09,São José do Rio Preto/SP,8,2954,265,109426
228777,2022-02-10,São José do Rio Preto/SP,3,2957,503,109929
234374,2022-02-11,São José do Rio Preto/SP,6,2963,436,110365
239971,2022-02-12,São José do Rio Preto/SP,4,2967,460,110825
245568,2022-02-13,São José do Rio Preto/SP,5,2972,255,111080
251165,2022-02-14,São José do Rio Preto/SP,1,2973,226,111306
256762,2022-02-15,São José do Rio Preto/SP,1,2974,377,111683
262359,2022-02-16,São José do Rio Preto/SP,6,2980,425,112108
267956,2022-02-17,São José do Rio Preto/SP,3,2983,216,112324
273553,2022-02-18,São José do Rio Preto/SP,2,2985,187,112511
279150,2022-02-19,São José do Rio Preto/SP,3,2988,359,112870
284747,2022-02-20,São José do Rio Preto/SP,1,2989,163,113033
290344,2022-02-21,São José do Rio Preto/SP,2,2991,176,113209
295941,2022-02-22,São José do Rio Preto/SP,3,2994,272,113481
301538,2022-02-23,São José do Rio Preto/SP,4,2998,247,113728
307135,2022-02-24,São José do Rio Preto/SP,2,3000,174,113902
312732,2022-02-25,São José do Rio Preto/SP,1,3001,34,113936
318329,2022-02-26,São José do Rio Preto/SP,0,3001,47,113983
323926,2022-02-27,São José do Rio Preto/SP,0,3001,31,114014
329523,2022-02-28,São José do Rio Preto/SP,2,3003,94,114108
335120,2022-03-01,São José do Rio Preto/SP,1,3004,203,114311
340717,2022-03-02,São José do Rio Preto/SP,0,3004,447,114758
346314,2022-03-03,São José do Rio Preto/SP,5,3009,144,114902
351911,2022-03-04,São José do Rio Preto/SP,2,3011,167,115069
357508,2022-03-05,São José do Rio Preto/SP,2,3013,95,115164
363105,2022-03-06,São José do Rio Preto/SP,1,3014,639,115803
368702,2022-03-07,São José do Rio Preto/SP,2,3016,78,115881
374299,2022-03-08,São José do Rio Preto/SP,1,3017,82,115963
379896,2022-03-09,São José do Rio Preto/SP,4,3021,211,116174
385493,2022-03-10,São José do Rio Preto/SP,1,3022,187,116361
391090,2022-03-11,São José do Rio Preto/SP,1,3023,286,116647
396687,2022-03-12,São José do Rio Preto/SP,2,3025,88,116735
402284,2022-03-13,São José do Rio Preto/SP,2,3027,46,116781
407881,2022-03-14,São José do Rio Preto/SP,3,3030,45,116826
413478,2022-03-15,São José do Rio Preto/SP,-1,3029,85,116911
419075,2022-03-16,São José do Rio Preto/SP,7,3036,187,117098
424672,2022-03-17,São José do Rio Preto/SP,1,3037,67,117165
430269,2022-03-18,São José do Rio Preto/SP,2,3039,131,117296
435866,2022-03-19,São José do Rio Preto/SP,2,3041,135,117431
441463,2022-03-20,São José do Rio Preto/SP,0,3041,248,117679
447060,2022-03-21,São José do Rio Preto/SP,2,3043,263,117942
452657,2022-03-22,São José do Rio Preto/SP,1,3044,239,118181
458254,2022-03-23,São José do Rio Preto/SP,0,3044,187,118368
463851,2022-03-24,São José do Rio Preto/SP,2,3046,459,118827
469448,2022-03-25,São José do Rio Preto/SP,0,3046,432,119259
475045,2022-03-26,São José do Rio Preto/SP,0,3046,242,119501
480642,2022-03-27,São José do Rio Preto/SP,0,3046,518,120019
486239,2022-03-28,São José do Rio Preto/SP,1,3047,328,120347
491836,2022-03-29,São José do Rio Preto/SP,1,3048,160,120507
497433,2022-03-30,São José do Rio Preto/SP,4,3052,478,120985
503030,2022-03-31,São José do Rio Preto/SP,1,3053,385,121370
508627,2022-04-01,São José do Rio Preto/SP,0,3053,33,121403
514224,2022-04-02,São José do Rio Preto/SP,2,3055,289,121692
519821,2022-04-03,São José do Rio Preto/SP,0,3055,36,121728
525418,2022-04-04,São José do Rio Preto/SP,1,3056,-1,121727
531015,2022-04-05,São José do Rio Preto/SP,1,3057,122,121849
536612,2022-04-06,São José do Rio Preto/SP,0,3057,82,121931
542209,2022-04-07,São José do Rio Preto/SP,1,3058,79,122010
547806,2022-04-08,São José do Rio Preto/SP,0,3058,97,122107
553403,2022-04-09,São José do Rio Preto/SP,1,3059,61,122168
559000,2022-04-10,São José do Rio Preto/SP,0,3059,68,122236
564597,2022-04-11,São José do Rio Preto/SP,0,3059,-1,122235
570194,2022-04-12,São José do Rio Preto/SP,0,3059,11,122246
575791,2022-04-13,São José do Rio Preto/SP,0,3059,85,122331
581388,2022-04-14,São José do Rio Preto/SP,1,3060,44,122375
586985,2022-04-15,São José do Rio Preto/SP,1,3061,21,122396
592582,2022-04-16,São José do Rio Preto/SP,0,3061,57,122453
598179,2022-04-17,São José do Rio Preto/SP,0,3061,0,122453
603776,2022-04-18,São José do Rio Preto/SP,1,3062,-1,122452
609373,2022-04-19,São José do Rio Preto/SP,0,3062,0,122452
614970,2022-04-20,São José do Rio Preto/SP,2,3064,222,122674
620567,2022-04-21,São José do Rio Preto/SP,0,3064,21,122695
626164,2022-04-22,São José do Rio Preto/SP,0,3064,12,122707
631761,2022-04-23,São José do Rio Preto/SP,0,3064,-2,122705
637358,2022-04-24,São José do Rio Preto/SP,0,3064,-2,122703
642955,2022-04-25,São José do Rio Preto/SP,0,3064,0,122703
648552,2022-04-26,São José do Rio Preto/SP,1,3065,60,122763
654149,2022-04-27,São José do Rio Preto/SP,0,3065,62,122825
659746,2022-04-28,São José do Rio Preto/SP,0,3065,52,122877
665343,2022-04-29,São José do Rio Preto/SP,0,3065,41,122918
670940,2022-04-30,São José do Rio Preto/SP,1,3066,20,122938
676537,2022-05-01,São José do Rio Preto/SP,0,3066,38,122976
682134,2022-05-02,São José do Rio Preto/SP,0,3066,-1,122975
687731,2022-05-03,São José do Rio Preto/SP,0,3066,28,123003
693328,2022-05-04,São José do Rio Preto/SP,0,3066,76,123079
698925,2022-05-05,São José do Rio Preto/SP,0,3066,71,123150
704522,2022-05-06,São José do Rio Preto/SP,0,3066,99,123249
710119,2022-05-07,São José do Rio Preto/SP,0,3066,29,123278
715716,2022-05-08,São José do Rio Preto/SP,0,3066,61,123339
721313,2022-05-09,São José do Rio Preto/SP,0,3066,0,123339
726910,2022-05-10,São José do Rio Preto/SP,0,3066,29,123368
732507,2022-05-11,São José do Rio Preto/SP,0,3066,52,123420
738104,2022-05-12,São José do Rio Preto/SP,1,3067,54,123474
743701,2022-05-13,São José do Rio Preto/SP,0,3067,15,123489
749298,2022-05-14,São José do Rio Preto/SP,0,3067,5,123494
754895,2022-05-15,São José do Rio Preto/SP,0,3067,179,123673
760492,2022-05-16,São José do Rio Preto/SP,0,3067,-1,123672
766089,2022-05-17,São José do Rio Preto/SP,0,3067,4,123676
771686,2022-05-18,São José do Rio Preto/SP,0,3067,1,123677
777283,2022-05-19,São José do Rio Preto/SP,0,3067,2,123679
782880,2022-05-20,São José do Rio Preto/SP,0,3067,0,123679
788477,2022-05-21,São José do Rio Preto/SP,0,3067,0,123679
794074,2022-05-22,São José do Rio Preto/SP,1,3068,450,124129
799671,2022-05-23,São José do Rio Preto/SP,0,3068,25,124154
805268,2022-05-24,São José do Rio Preto/SP,1,3069,226,124380
810865,2022-05-25,São José do Rio Preto/SP,0,3069,159,124539
816462,2022-05-26,São José do Rio Preto/SP,1,3070,119,124658
822059,2022-05-27,São José do Rio Preto/SP,0,3070,62,124720
827656,2022-05-28,São José do Rio Preto/SP,0,3070,43,124763
833253,2022-05-29,São José do Rio Preto/SP,0,3070,377,125140
838850,2022-05-30,São José do Rio Preto/SP,0,3070,117,125257
844447,2022-05-31,São José do Rio Preto/SP,0,3070,109,125366
850044,2022-06-01,São José do Rio Preto/SP,1,3071,56,125422
855641,2022-06-02,São José do Rio Preto/SP,2,3073,72,125494
861238,2022-06-03,São José do Rio Preto/SP,0,3073,0,125494
866835,2022-06-04,São José do Rio Preto/SP,0,3073,0,125494
872432,2022-06-05,São José do Rio Preto/SP,0,3073,0,125494
878029,2022-06-06,São José do Rio Preto/SP,0,3073,0,125494
883626,2022-06-07,São José do Rio Preto/SP,6,3079,1194,126688
889223,2022-06-08,São José do Rio Preto/SP,2,3081,162,126850
894820,2022-06-09,São José do Rio Preto/SP,2,3083,118,126968
900417,2022-06-10,São José do Rio Preto/SP,0,3083,307,127275
906014,2022-06-11,São José do Rio Preto/SP,0,3083,260,127535
911611,2022-06-12,São José do Rio Preto/SP,0,3083,393,127928
917208,2022-06-13,São José do Rio Preto/SP,0,3083,161,128089
922805,2022-06-14,São José do Rio Preto/SP,0,3083,0,128089
928402,2022-06-15,São José do Rio Preto/SP,10,3093,193,128282
933999,2022-06-16,São José do Rio Preto/SP,1,3094,45,128327
939596,2022-06-17,São José do Rio Preto/SP,0,3094,667,128994
945193,2022-06-18,São José do Rio Preto/SP,0,3094,509,129503
950790,2022-06-19,São José do Rio Preto/SP,0,3094,633,130136
956387,2022-06-20,São José do Rio Preto/SP,1,3095,322,130458
961984,2022-06-21,São José do Rio Preto/SP,3,3098,103,130561
967581,2022-06-22,São José do Rio Preto/SP,0,3098,82,130643
973178,2022-06-23,São José do Rio Preto/SP,7,3105,116,130759
978775,2022-06-24,São José do Rio Preto/SP,1,3106,5,130764
984372,2022-06-25,São José do Rio Preto/SP,3,3109,178,130942
989969,2022-06-26,São José do Rio Preto/SP,0,3109,469,131411
995566,2022-06-27,São José do Rio Preto/SP,0,3109,494,131905
1001163,2022-06-28,São José do Rio Preto/SP,3,3112,124,132029
1006760,2022-06-29,São José do Rio Preto/SP,1,3113,180,132209
1012357,2022-06-30,São José do Rio Preto/SP,2,3115,101,132310
1017954,2022-07-01,São José do Rio Preto/SP,3,3118,58,132368
1023551,2022-07-02,São José do Rio Preto/SP,1,3119,33,132401
1029148,2022-07-03,São José do Rio Preto/SP,0,3119,361,132762
1034745,2022-07-04,São José do Rio Preto/SP,0,3119,420,133182
1040342,2022-07-05,São José do Rio Preto/SP,4,3123,30,133212
1045939,2022-07-06,São José do Rio Preto/SP,2,3125,40,133252
1051536,2022-07-07,São José do Rio Preto/SP,2,3127,137,133389
1057133,2022-07-08,São José do Rio Preto/SP,0,3127,35,133424
1062730,2022-07-09,São José do Rio Preto/SP,1,3128,125,133549
1068327,2022-07-10,São José do Rio Preto/SP,0,3128,125,133674
1073924,2022-07-11,São José do Rio Preto/SP,0,3128,276,133950
1079521,2022-07-12,São José do Rio Preto/SP,3,3131,39,133989
1085118,2022-07-13,São José do Rio Preto/SP,3,3134,27,134016
1090715,2022-07-14,São José do Rio Preto/SP,0,3134,17,134033
1096312,2022-07-15,São José do Rio Preto/SP,1,3135,28,134061
1101909,2022-07-16,São José do Rio Preto/SP,1,3136,0,134061
1107506,2022-07-17,São José do Rio Preto/SP,0,3136,269,134330
1113103,2022-07-18,São José do Rio Preto/SP,0,3136,375,134705
1118700,2022-07-19,São José do Rio Preto/SP,2,3138,16,134721
1124297,2022-07-20,São José do Rio Preto/SP,3,3141,23,134744
1129894,2022-07-21,São José do Rio Preto/SP,1,3142,21,134765
1135491,2022-07-22,São José do Rio Preto/SP,0,3142,107,134872
1141088,2022-07-23,São José do Rio Preto/SP,4,3146,2,134874
1146685,2022-07-24,São José do Rio Preto/SP,1,3147,259,135133
1152282,2022-07-25,São José do Rio Preto/SP,0,3147,205,135338
1157879,2022-07-26,São José do Rio Preto/SP,5,3152,122,135460
1163476,2022-07-27,São José do Rio Preto/SP,2,3154,8,135468
1169073,2022-07-28,São José do Rio Preto/SP,0,3154,22,135490
1174670,2022-07-29,São José do Rio Preto/SP,1,3155,7,135497
1180267,2022-07-30,São José do Rio Preto/SP,-1,3154,12,135509
1185864,2022-07-31,São José do Rio Preto/SP,1,3155,134,135643
1191461,2022-08-01,São José do Rio Preto/SP,0,3155,405,136048
1197058,2022-08-02,São José do Rio Preto/SP,2,3157,10,136058
1202655,2022-08-03,São José do Rio Preto/SP,3,3160,102,136160
1208252,2022-08-04,São José do Rio Preto/SP,2,3162,280,136440
1213849,2022-08-05,São José do Rio Preto/SP,0,3162,216,136656
1219446,2022-08-06,São José do Rio Preto/SP,-1,3161,41,136697
1225043,2022-08-07,São José do Rio Preto/SP,0,3161,227,136924
1230640,2022-08-08,São José do Rio Preto/SP,0,3161,372,137296
1236237,2022-08-09,São José do Rio Preto/SP,0,3161,353,137649
1241834,2022-08-10,São José do Rio Preto/SP,1,3162,446,138095
1247431,2022-08-11,São José do Rio Preto/SP,0,3162,258,138353
1253028,2022-08-12,São José do Rio Preto/SP,-1,3161,31,138384
1258625,2022-08-13,São José do Rio Preto/SP,0,3161,7,138391
1264222,2022-08-14,São José do Rio Preto/SP,0,3161,0,138391
1269819,2022-08-15,São José do Rio Preto/SP,0,3161,0,138391
1275416,2022-08-16,São José do Rio Preto/SP,2,3163,17,138408
1281013,2022-08-17,São José do Rio Preto/SP,0,3163,98,138506
1286610,2022-08-18,São José do Rio Preto/SP,0,3163,99,138605
1292207,2022-08-19,São José do Rio Preto/SP,0,3163,8,138613
1297804,2022-08-20,São José do Rio Preto/SP,0,3163,12,138625
1303401,2022-08-21,São José do Rio Preto/SP,0,3163,0,138625
1308998,2022-08-22,São José do Rio Preto/SP,0,3163,0,138625
1314595,2022-08-23,São José do Rio Preto/SP,0,3163,7,138632
1320192,2022-08-24,São José do Rio Preto/SP,1,3164,41,138673
1325789,2022-08-25,São José do Rio Preto/SP,0,3164,4,138677
1828,2022-01-01,Franca/SP,0,967,0,38493
7425,2022-01-02,Franca/SP,0,967,0,38493
13022,2022-01-03,Franca/SP,0,967,-6,38487
18619,2022-01-04,Franca/SP,0,967,-9,38478
24216,2022-01-05,Franca/SP,0,967,3,38481
29813,2022-01-06,Franca/SP,0,967,0,38481
35410,2022-01-07,Franca/SP,0,967,-6,38475
41007,2022-01-08,Franca/SP,0,967,-1,38474
46604,2022-01-09,Franca/SP,0,967,-3,38471
52201,2022-01-10,Franca/SP,0,967,0,38471
57798,2022-01-11,Franca/SP,0,967,0,38471
63395,2022-01-12,Franca/SP,0,967,2,38473
68992,2022-01-13,Franca/SP,0,967,2,38475
74589,2022-01-14,Franca/SP,0,967,0,38475
80186,2022-01-15,Franca/SP,1,968,1,38476
85783,2022-01-16,Franca/SP,0,968,0,38476
91380,2022-01-17,Franca/SP,0,968,0,38476
96977,2022-01-18,Franca/SP,0,968,0,38476
102574,2022-01-19,Franca/SP,1,969,8,38484
108171,2022-01-20,Franca/SP,0,969,12,38496
113768,2022-01-21,Franca/SP,0,969,7,38503
119365,2022-01-22,Franca/SP,0,969,0,38503
124962,2022-01-23,Franca/SP,0,969,-7,38496
130559,2022-01-24,Franca/SP,0,969,1,38497
136156,2022-01-25,Franca/SP,2,971,0,38497
141753,2022-01-26,Franca/SP,4,975,13,38510
147350,2022-01-27,Franca/SP,1,976,5,38515
152947,2022-01-28,Franca/SP,0,976,-4,38511
158544,2022-01-29,Franca/SP,0,976,-1,38510
164141,2022-01-30,Franca/SP,0,976,-6,38504
169738,2022-01-31,Franca/SP,0,976,0,38504
175335,2022-02-01,Franca/SP,1,977,-6,38498
180932,2022-02-02,Franca/SP,1,978,2,38500
186529,2022-02-03,Franca/SP,1,979,-8,38492
192126,2022-02-04,Franca/SP,0,979,0,38492
197723,2022-02-05,Franca/SP,2,981,-2,38490
203320,2022-02-06,Franca/SP,0,981,-14,38476
208917,2022-02-07,Franca/SP,0,981,-5,38471
214514,2022-02-08,Franca/SP,10,991,7,38478
220111,2022-02-09,Franca/SP,4,995,8,38486
225708,2022-02-10,Franca/SP,2,997,6,38492
231305,2022-02-11,Franca/SP,3,1000,9,38501
236902,2022-02-12,Franca/SP,1,1001,1,38502
242499,2022-02-13,Franca/SP,0,1001,-4,38498
248096,2022-02-14,Franca/SP,0,1001,-2,38496
253693,2022-02-15,Franca/SP,1,1002,4,38500
259290,2022-02-16,Franca/SP,6,1008,4,38504
264887,2022-02-17,Franca/SP,3,1011,1,38505
270484,2022-02-18,Franca/SP,2,1013,0,38505
276081,2022-02-19,Franca/SP,1,1014,-6,38499
281678,2022-02-20,Franca/SP,0,1014,-2,38497
287275,2022-02-21,Franca/SP,0,1014,0,38497
292872,2022-02-22,Franca/SP,2,1016,1,38498
298469,2022-02-23,Franca/SP,1,1017,1,38499
304066,2022-02-24,Franca/SP,2,1019,4,38503
309663,2022-02-25,Franca/SP,1,1020,2,38505
315260,2022-02-26,Franca/SP,2,1022,6,38511
320857,2022-02-27,Franca/SP,0,1022,-1,38510
326454,2022-02-28,Franca/SP,0,1022,1,38511
332051,2022-03-01,Franca/SP,0,1022,0,38511
337648,2022-03-02,Franca/SP,0,1022,0,38511
343245,2022-03-03,Franca/SP,2,1024,2,38513
348842,2022-03-04,Franca/SP,0,1024,0,38513
354439,2022-03-05,Franca/SP,0,1024,0,38513
360036,2022-03-06,Franca/SP,0,1024,-3,38510
365633,2022-03-07,Franca/SP,0,1024,0,38510
371230,2022-03-08,Franca/SP,3,1027,3,38513
376827,2022-03-09,Franca/SP,4,1031,15,38528
382424,2022-03-10,Franca/SP,0,1031,7,38535
388021,2022-03-11,Franca/SP,0,1031,2,38537
393618,2022-03-12,Franca/SP,0,1031,-1,38536
399215,2022-03-13,Franca/SP,0,1031,-3,38533
404812,2022-03-14,Franca/SP,1,1032,0,38533
410409,2022-03-15,Franca/SP,0,1032,-1,38532
416006,2022-03-16,Franca/SP,1,1033,1,38533
421603,2022-03-17,Franca/SP,1,1034,1,38534
427200,2022-03-18,Franca/SP,1,1035,6,38540
432797,2022-03-19,Franca/SP,0,1035,8,38548
438394,2022-03-20,Franca/SP,0,1035,0,38548
443991,2022-03-21,Franca/SP,0,1035,1,38549
449588,2022-03-22,Franca/SP,2,1037,6,38555
455185,2022-03-23,Franca/SP,0,1037,1,38556
460782,2022-03-24,Franca/SP,0,1037,7,38563
466379,2022-03-25,Franca/SP,6,1043,3,38566
471976,2022-03-26,Franca/SP,1,1044,4,38570
477573,2022-03-27,Franca/SP,0,1044,-1,38569
483170,2022-03-28,Franca/SP,0,1044,0,38569
488767,2022-03-29,Franca/SP,0,1044,5,38574
494364,2022-03-30,Franca/SP,0,1044,6,38580
499961,2022-03-31,Franca/SP,1,1045,0,38580
505558,2022-04-01,Franca/SP,0,1045,3,38583
511155,2022-04-02,Franca/SP,0,1045,1,38584
516752,2022-04-03,Franca/SP,0,1045,-1,38583
522349,2022-04-04,Franca/SP,0,1045,0,38583
527946,2022-04-05,Franca/SP,0,1045,0,38583
533543,2022-04-06,Franca/SP,0,1045,-1,38582
539140,2022-04-07,Franca/SP,0,1045,3,38585
544737,2022-04-08,Franca/SP,0,1045,0,38585
550334,2022-04-09,Franca/SP,0,1045,8,38593
555931,2022-04-10,Franca/SP,0,1045,0,38593
561528,2022-04-11,Franca/SP,0,1045,0,38593
567125,2022-04-12,Franca/SP,0,1045,0,38593
572722,2022-04-13,Franca/SP,0,1045,0,38593
578319,2022-04-14,Franca/SP,0,1045,1,38594
583916,2022-04-15,Franca/SP,0,1045,0,38594
589513,2022-04-16,Franca/SP,0,1045,0,38594
595110,2022-04-17,Franca/SP,0,1045,0,38594
600707,2022-04-18,Franca/SP,0,1045,0,38594
606304,2022-04-19,Franca/SP,0,1045,0,38594
611901,2022-04-20,Franca/SP,0,1045,3,38597
617498,2022-04-21,Franca/SP,0,1045,0,38597
623095,2022-04-22,Franca/SP,0,1045,0,38597
628692,2022-04-23,Franca/SP,0,1045,0,38597
634289,2022-04-24,Franca/SP,0,1045,0,38597
639886,2022-04-25,Franca/SP,0,1045,0,38597
645483,2022-04-26,Franca/SP,0,1045,1,38598
651080,2022-04-27,Franca/SP,0,1045,0,38598
656677,2022-04-28,Franca/SP,0,1045,0,38598
662274,2022-04-29,Franca/SP,0,1045,0,38598
667871,2022-04-30,Franca/SP,0,1045,0,38598
673468,2022-05-01,Franca/SP,0,1045,0,38598
679065,2022-05-02,Franca/SP,0,1045,0,38598
684662,2022-05-03,Franca/SP,0,1045,0,38598
690259,2022-05-04,Franca/SP,0,1045,0,38598
695856,2022-05-05,Franca/SP,0,1045,0,38598
701453,2022-05-06,Franca/SP,0,1045,-1,38597
707050,2022-05-07,Franca/SP,0,1045,-1,38596
712647,2022-05-08,Franca/SP,0,1045,0,38596
718244,2022-05-09,Franca/SP,0,1045,0,38596
723841,2022-05-10,Franca/SP,0,1045,0,38596
729438,2022-05-11,Franca/SP,0,1045,0,38596
735035,2022-05-12,Franca/SP,0,1045,0,38596
740632,2022-05-13,Franca/SP,1,1046,7,38603
746229,2022-05-14,Franca/SP,0,1046,0,38603
751826,2022-05-15,Franca/SP,0,1046,-2,38601
757423,2022-05-16,Franca/SP,0,1046,0,38601
763020,2022-05-17,Franca/SP,0,1046,0,38601
768617,2022-05-18,Franca/SP,0,1046,0,38601
774214,2022-05-19,Franca/SP,0,1046,0,38601
779811,2022-05-20,Franca/SP,0,1046,0,38601
785408,2022-05-21,Franca/SP,0,1046,0,38601
791005,2022-05-22,Franca/SP,0,1046,-7,38594
796602,2022-05-23,Franca/SP,0,1046,0,38594
802199,2022-05-24,Franca/SP,0,1046,1,38595
807796,2022-05-25,Franca/SP,0,1046,0,38595
813393,2022-05-26,Franca/SP,0,1046,0,38595
818990,2022-05-27,Franca/SP,0,1046,0,38595
824587,2022-05-28,Franca/SP,0,1046,0,38595
830184,2022-05-29,Franca/SP,0,1046,-2,38593
835781,2022-05-30,Franca/SP,0,1046,0,38593
841378,2022-05-31,Franca/SP,0,1046,0,38593
846975,2022-06-01,Franca/SP,4,1050,11,38604
852572,2022-06-02,Franca/SP,7,1057,27,38631
858169,2022-06-03,Franca/SP,0,1057,0,38631
863766,2022-06-04,Franca/SP,0,1057,0,38631
869363,2022-06-05,Franca/SP,0,1057,0,38631
874960,2022-06-06,Franca/SP,0,1057,0,38631
880557,2022-06-07,Franca/SP,0,1057,6,38637
886154,2022-06-08,Franca/SP,0,1057,0,38637
891751,2022-06-09,Franca/SP,0,1057,1,38638
897348,2022-06-10,Franca/SP,0,1057,0,38638
902945,2022-06-11,Franca/SP,0,1057,1,38639
908542,2022-06-12,Franca/SP,0,1057,0,38639
914139,2022-06-13,Franca/SP,0,1057,0,38639
919736,2022-06-14,Franca/SP,0,1057,0,38639
925333,2022-06-15,Franca/SP,0,1057,1,38640
930930,2022-06-16,Franca/SP,0,1057,1,38641
936527,2022-06-17,Franca/SP,0,1057,0,38641
942124,2022-06-18,Franca/SP,0,1057,0,38641
947721,2022-06-19,Franca/SP,0,1057,0,38641
953318,2022-06-20,Franca/SP,0,1057,0,38641
958915,2022-06-21,Franca/SP,0,1057,0,38641
964512,2022-06-22,Franca/SP,0,1057,0,38641
970109,2022-06-23,Franca/SP,0,1057,0,38641
975706,2022-06-24,Franca/SP,0,1057,0,38641
981303,2022-06-25,Franca/SP,0,1057,0,38641
986900,2022-06-26,Franca/SP,0,1057,-1,38640
992497,2022-06-27,Franca/SP,0,1057,0,38640
998094,2022-06-28,Franca/SP,0,1057,5,38645
1003691,2022-06-29,Franca/SP,0,1057,0,38645
1009288,2022-06-30,Franca/SP,0,1057,1,38646
1014885,2022-07-01,Franca/SP,0,1057,0,38646
1020482,2022-07-02,Franca/SP,0,1057,0,38646
1026079,2022-07-03,Franca/SP,0,1057,0,38646
1031676,2022-07-04,Franca/SP,0,1057,0,38646
1037273,2022-07-05,Franca/SP,0,1057,1,38647
1042870,2022-07-06,Franca/SP,0,1057,0,38647
1048467,2022-07-07,Franca/SP,0,1057,0,38647
1054064,2022-07-08,Franca/SP,0,1057,0,38647
1059661,2022-07-09,Franca/SP,0,1057,0,38647
1065258,2022-07-10,Franca/SP,0,1057,-1,38646
1070855,2022-07-11,Franca/SP,0,1057,0,38646
1076452,2022-07-12,Franca/SP,2,1059,3,38649
1082049,2022-07-13,Franca/SP,0,1059,1,38650
1087646,2022-07-14,Franca/SP,0,1059,1,38651
1093243,2022-07-15,Franca/SP,0,1059,0,38651
1098840,2022-07-16,Franca/SP,0,1059,1,38652
1104437,2022-07-17,Franca/SP,0,1059,0,38652
1110034,2022-07-18,Franca/SP,0,1059,0,38652
1115631,2022-07-19,Franca/SP,0,1059,0,38652
1121228,2022-07-20,Franca/SP,0,1059,3,38655
1126825,2022-07-21,Franca/SP,0,1059,0,38655
1132422,2022-07-22,Franca/SP,0,1059,0,38655
1138019,2022-07-23,Franca/SP,0,1059,0,38655
1143616,2022-07-24,Franca/SP,0,1059,0,38655
1149213,2022-07-25,Franca/SP,0,1059,0,38655
1154810,2022-07-26,Franca/SP,0,1059,2,38657
1160407,2022-07-27,Franca/SP,2,1061,2,38659
1166004,2022-07-28,Franca/SP,1,1062,12,38671
1171601,2022-07-29,Franca/SP,0,1062,1,38672
1177198,2022-07-30,Franca/SP,0,1062,0,38672
1182795,2022-07-31,Franca/SP,0,1062,8,38680
1188392,2022-08-01,Franca/SP,0,1062,0,38680
1193989,2022-08-02,Franca/SP,0,1062,0,38680
1199586,2022-08-03,Franca/SP,0,1062,0,38680
1205183,2022-08-04,Franca/SP,0,1062,0,38680
1210780,2022-08-05,Franca/SP,0,1062,1,38681
1216377,2022-08-06,Franca/SP,0,1062,1,38682
1221974,2022-08-07,Franca/SP,0,1062,0,38682
1227571,2022-08-08,Franca/SP,0,1062,0,38682
1233168,2022-08-09,Franca/SP,0,1062,0,38682
1238765,2022-08-10,Franca/SP,0,1062,1,38683
1244362,2022-08-11,Franca/SP,0,1062,0,38683
1249959,2022-08-12,Franca/SP,0,1062,1,38684
1255556,2022-08-13,Franca/SP,0,1062,0,38684
1261153,2022-08-14,Franca/SP,0,1062,0,38684
1266750,2022-08-15,Franca/SP,0,1062,0,38684
1272347,2022-08-16,Franca/SP,0,1062,1,38685
1277944,2022-08-17,Franca/SP,0,1062,0,38685
1283541,2022-08-18,Franca/SP,0,1062,0,38685
1289138,2022-08-19,Franca/SP,0,1062,0,38685
1294735,2022-08-20,Franca/SP,0,1062,0,38685
1300332,2022-08-21,Franca/SP,0,1062,0,38685
1305929,2022-08-22,Franca/SP,0,1062,0,38685
1311526,2022-08-23,Franca/SP,1,1063,6,38691
1317123,2022-08-24,Franca/SP,4,1067,10,38701
1322720,2022-08-25,Franca/SP,1,1068,5,38706
4161,2022-01-01,Ribeirão Preto/SP,0,3020,0,88167
9758,2022-01-02,Ribeirão Preto/SP,1,3021,-1,88166
15355,2022-01-03,Ribeirão Preto/SP,0,3021,0,88166
20952,2022-01-04,Ribeirão Preto/SP,2,3023,12,88178
26549,2022-01-05,Ribeirão Preto/SP,0,3023,0,88178
32146,2022-01-06,Ribeirão Preto/SP,0,3023,8,88186
37743,2022-01-07,Ribeirão Preto/SP,1,3024,7,88193
43340,2022-01-08,Ribeirão Preto/SP,0,3024,5,88198
48937,2022-01-09,Ribeirão Preto/SP,0,3024,36,88234
54534,2022-01-10,Ribeirão Preto/SP,0,3024,0,88234
60131,2022-01-11,Ribeirão Preto/SP,0,3024,9,88243
65728,2022-01-12,Ribeirão Preto/SP,1,3025,8,88251
71325,2022-01-13,Ribeirão Preto/SP,2,3027,9,88260
76922,2022-01-14,Ribeirão Preto/SP,2,3029,10,88270
82519,2022-01-15,Ribeirão Preto/SP,4,3033,14,88284
88116,2022-01-16,Ribeirão Preto/SP,2,3035,3,88287
93713,2022-01-17,Ribeirão Preto/SP,1,3036,19,88306
99310,2022-01-18,Ribeirão Preto/SP,2,3038,11,88317
104907,2022-01-19,Ribeirão Preto/SP,1,3039,107,88424
110504,2022-01-20,Ribeirão Preto/SP,4,3043,65,88489
116101,2022-01-21,Ribeirão Preto/SP,2,3045,155,88644
121698,2022-01-22,Ribeirão Preto/SP,0,3045,0,88644
127295,2022-01-23,Ribeirão Preto/SP,12,3057,94,88738
132892,2022-01-24,Ribeirão Preto/SP,0,3057,97,88835
138489,2022-01-25,Ribeirão Preto/SP,11,3068,129,88964
144086,2022-01-26,Ribeirão Preto/SP,3,3071,80,89044
149683,2022-01-27,Ribeirão Preto/SP,4,3075,33,89077
155280,2022-01-28,Ribeirão Preto/SP,8,3083,20,89097
160877,2022-01-29,Ribeirão Preto/SP,7,3090,75,89172
166474,2022-01-30,Ribeirão Preto/SP,2,3092,201,89373
172071,2022-01-31,Ribeirão Preto/SP,0,3092,0,89373
177668,2022-02-01,Ribeirão Preto/SP,8,3100,88,89461
183265,2022-02-02,Ribeirão Preto/SP,10,3110,33,89494
188862,2022-02-03,Ribeirão Preto/SP,4,3114,462,89956
194459,2022-02-04,Ribeirão Preto/SP,0,3114,0,89956
200056,2022-02-05,Ribeirão Preto/SP,16,3130,116,90072
205653,2022-02-06,Ribeirão Preto/SP,1,3131,128,90200
211250,2022-02-07,Ribeirão Preto/SP,0,3131,267,90467
216847,2022-02-08,Ribeirão Preto/SP,22,3153,51,90518
222444,2022-02-09,Ribeirão Preto/SP,11,3164,163,90681
228041,2022-02-10,Ribeirão Preto/SP,6,3170,260,90941
233638,2022-02-11,Ribeirão Preto/SP,12,3182,68,91009
239235,2022-02-12,Ribeirão Preto/SP,2,3184,53,91062
244832,2022-02-13,Ribeirão Preto/SP,3,3187,73,91135
250429,2022-02-14,Ribeirão Preto/SP,0,3187,267,91402
256026,2022-02-15,Ribeirão Preto/SP,14,3201,310,91712
261623,2022-02-16,Ribeirão Preto/SP,9,3210,185,91897
267220,2022-02-17,Ribeirão Preto/SP,6,3216,369,92266
272817,2022-02-18,Ribeirão Preto/SP,3,3219,208,92474
278414,2022-02-19,Ribeirão Preto/SP,5,3224,52,92526
284011,2022-02-20,Ribeirão Preto/SP,1,3225,395,92921
289608,2022-02-21,Ribeirão Preto/SP,0,3225,362,93283
295205,2022-02-22,Ribeirão Preto/SP,9,3234,118,93401
300802,2022-02-23,Ribeirão Preto/SP,3,3237,173,93574
306399,2022-02-24,Ribeirão Preto/SP,1,3238,206,93780
311996,2022-02-25,Ribeirão Preto/SP,6,3244,336,94116
317593,2022-02-26,Ribeirão Preto/SP,3,3247,107,94223
323190,2022-02-27,Ribeirão Preto/SP,0,3247,592,94815
328787,2022-02-28,Ribeirão Preto/SP,0,3247,391,95206
334384,2022-03-01,Ribeirão Preto/SP,1,3248,111,95317
339981,2022-03-02,Ribeirão Preto/SP,2,3250,32,95349
345578,2022-03-03,Ribeirão Preto/SP,2,3252,23,95372
351175,2022-03-04,Ribeirão Preto/SP,4,3256,34,95406
356772,2022-03-05,Ribeirão Preto/SP,4,3260,31,95437
362369,2022-03-06,Ribeirão Preto/SP,1,3261,17,95454
367966,2022-03-07,Ribeirão Preto/SP,0,3261,0,95454
373563,2022-03-08,Ribeirão Preto/SP,4,3265,13,95467
379160,2022-03-09,Ribeirão Preto/SP,0,3265,59,95526
384757,2022-03-10,Ribeirão Preto/SP,0,3265,47,95573
390354,2022-03-11,Ribeirão Preto/SP,0,3265,4,95577
395951,2022-03-12,Ribeirão Preto/SP,1,3266,15,95592
401548,2022-03-13,Ribeirão Preto/SP,0,3266,26,95618
407145,2022-03-14,Ribeirão Preto/SP,1,3267,2,95620
412742,2022-03-15,Ribeirão Preto/SP,1,3268,16,95636
418339,2022-03-16,Ribeirão Preto/SP,3,3271,29,95665
423936,2022-03-17,Ribeirão Preto/SP,2,3273,72,95737
429533,2022-03-18,Ribeirão Preto/SP,0,3273,23,95760
435130,2022-03-19,Ribeirão Preto/SP,1,3274,9,95769
440727,2022-03-20,Ribeirão Preto/SP,2,3276,336,96105
446324,2022-03-21,Ribeirão Preto/SP,0,3276,229,96334
451921,2022-03-22,Ribeirão Preto/SP,1,3277,168,96502
457518,2022-03-23,Ribeirão Preto/SP,1,3278,78,96580
463115,2022-03-24,Ribeirão Preto/SP,1,3279,159,96739
468712,2022-03-25,Ribeirão Preto/SP,3,3282,238,96977
474309,2022-03-26,Ribeirão Preto/SP,1,3283,62,97039
479906,2022-03-27,Ribeirão Preto/SP,0,3283,717,97756
485503,2022-03-28,Ribeirão Preto/SP,0,3283,204,97960
491100,2022-03-29,Ribeirão Preto/SP,1,3284,238,98198
496697,2022-03-30,Ribeirão Preto/SP,-1,3283,240,98438
502294,2022-03-31,Ribeirão Preto/SP,2,3285,127,98565
507891,2022-04-01,Ribeirão Preto/SP,0,3285,122,98687
513488,2022-04-02,Ribeirão Preto/SP,0,3285,29,98716
519085,2022-04-03,Ribeirão Preto/SP,0,3285,472,99188
524682,2022-04-04,Ribeirão Preto/SP,0,3285,116,99304
530279,2022-04-05,Ribeirão Preto/SP,1,3286,143,99447
535876,2022-04-06,Ribeirão Preto/SP,0,3286,181,99628
541473,2022-04-07,Ribeirão Preto/SP,1,3287,84,99712
547070,2022-04-08,Ribeirão Preto/SP,0,3287,79,99791
552667,2022-04-09,Ribeirão Preto/SP,1,3288,37,99828
558264,2022-04-10,Ribeirão Preto/SP,0,3288,603,100431
563861,2022-04-11,Ribeirão Preto/SP,0,3288,134,100565
569458,2022-04-12,Ribeirão Preto/SP,0,3288,56,100621
575055,2022-04-13,Ribeirão Preto/SP,0,3288,159,100780
580652,2022-04-14,Ribeirão Preto/SP,1,3289,104,100884
586249,2022-04-15,Ribeirão Preto/SP,2,3291,47,100931
591846,2022-04-16,Ribeirão Preto/SP,0,3291,150,101081
597443,2022-04-17,Ribeirão Preto/SP,0,3291,0,101081
603040,2022-04-18,Ribeirão Preto/SP,0,3291,980,102061
608637,2022-04-19,Ribeirão Preto/SP,0,3291,0,102061
614234,2022-04-20,Ribeirão Preto/SP,2,3293,300,102361
619831,2022-04-21,Ribeirão Preto/SP,0,3293,202,102563
625428,2022-04-22,Ribeirão Preto/SP,1,3294,409,102972
631025,2022-04-23,Ribeirão Preto/SP,0,3294,3,102975
636622,2022-04-24,Ribeirão Preto/SP,0,3294,0,102975
642219,2022-04-25,Ribeirão Preto/SP,0,3294,0,102975
647816,2022-04-26,Ribeirão Preto/SP,1,3295,3,102978
653413,2022-04-27,Ribeirão Preto/SP,1,3296,3,102981
659010,2022-04-28,Ribeirão Preto/SP,0,3296,5,102986
664607,2022-04-29,Ribeirão Preto/SP,0,3296,0,102986
670204,2022-04-30,Ribeirão Preto/SP,0,3296,4,102990
675801,2022-05-01,Ribeirão Preto/SP,0,3296,3,102993
681398,2022-05-02,Ribeirão Preto/SP,0,3296,2,102995
686995,2022-05-03,Ribeirão Preto/SP,0,3296,0,102995
692592,2022-05-04,Ribeirão Preto/SP,0,3296,3,102998
698189,2022-05-05,Ribeirão Preto/SP,1,3297,5,103003
703786,2022-05-06,Ribeirão Preto/SP,1,3298,4,103007
709383,2022-05-07,Ribeirão Preto/SP,0,3298,2,103009
714980,2022-05-08,Ribeirão Preto/SP,0,3298,3,103012
720577,2022-05-09,Ribeirão Preto/SP,0,3298,0,103012
726174,2022-05-10,Ribeirão Preto/SP,-1,3297,0,103012
731771,2022-05-11,Ribeirão Preto/SP,0,3297,12,103024
737368,2022-05-12,Ribeirão Preto/SP,1,3298,7,103031
742965,2022-05-13,Ribeirão Preto/SP,0,3298,62,103093
748562,2022-05-14,Ribeirão Preto/SP,1,3299,4,103097
754159,2022-05-15,Ribeirão Preto/SP,0,3299,107,103204
759756,2022-05-16,Ribeirão Preto/SP,0,3299,1,103205
765353,2022-05-17,Ribeirão Preto/SP,-1,3298,0,103205
770950,2022-05-18,Ribeirão Preto/SP,0,3298,10,103215
776547,2022-05-19,Ribeirão Preto/SP,0,3298,3,103218
782144,2022-05-20,Ribeirão Preto/SP,0,3298,0,103218
787741,2022-05-21,Ribeirão Preto/SP,0,3298,0,103218
793338,2022-05-22,Ribeirão Preto/SP,0,3298,37,103255
798935,2022-05-23,Ribeirão Preto/SP,0,3298,0,103255
804532,2022-05-24,Ribeirão Preto/SP,0,3298,4,103259
810129,2022-05-25,Ribeirão Preto/SP,1,3299,9,103268
815726,2022-05-26,Ribeirão Preto/SP,0,3299,36,103304
821323,2022-05-27,Ribeirão Preto/SP,0,3299,8,103312
826920,2022-05-28,Ribeirão Preto/SP,0,3299,14,103326
832517,2022-05-29,Ribeirão Preto/SP,0,3299,49,103375
838114,2022-05-30,Ribeirão Preto/SP,0,3299,11,103386
843711,2022-05-31,Ribeirão Preto/SP,6,3305,9,103395
849308,2022-06-01,Ribeirão Preto/SP,1,3306,34,103429
854905,2022-06-02,Ribeirão Preto/SP,0,3306,35,103464
860502,2022-06-03,Ribeirão Preto/SP,0,3306,0,103464
866099,2022-06-04,Ribeirão Preto/SP,0,3306,0,103464
871696,2022-06-05,Ribeirão Preto/SP,0,3306,0,103464
877293,2022-06-06,Ribeirão Preto/SP,0,3306,0,103464
882890,2022-06-07,Ribeirão Preto/SP,5,3311,50,103514
888487,2022-06-08,Ribeirão Preto/SP,5,3316,54,103568
894084,2022-06-09,Ribeirão Preto/SP,3,3319,10,103578
899681,2022-06-10,Ribeirão Preto/SP,2,3321,27,103605
905278,2022-06-11,Ribeirão Preto/SP,2,3323,4,103609
910875,2022-06-12,Ribeirão Preto/SP,0,3323,18,103627
916472,2022-06-13,Ribeirão Preto/SP,0,3323,30,103657
922069,2022-06-14,Ribeirão Preto/SP,0,3323,0,103657
927666,2022-06-15,Ribeirão Preto/SP,8,3331,68,103725
933263,2022-06-16,Ribeirão Preto/SP,3,3334,8,103733
938860,2022-06-17,Ribeirão Preto/SP,0,3334,35,103768
944457,2022-06-18,Ribeirão Preto/SP,0,3334,5,103773
950054,2022-06-19,Ribeirão Preto/SP,0,3334,5,103778
955651,2022-06-20,Ribeirão Preto/SP,0,3334,0,103778
961248,2022-06-21,Ribeirão Preto/SP,3,3337,5,103783
966845,2022-06-22,Ribeirão Preto/SP,0,3337,3,103786
972442,2022-06-23,Ribeirão Preto/SP,5,3342,39,103825
978039,2022-06-24,Ribeirão Preto/SP,0,3342,5,103830
983636,2022-06-25,Ribeirão Preto/SP,2,3344,13,103843
989233,2022-06-26,Ribeirão Preto/SP,0,3344,43,103886
994830,2022-06-27,Ribeirão Preto/SP,0,3344,0,103886
1000427,2022-06-28,Ribeirão Preto/SP,3,3347,18,103904
1006024,2022-06-29,Ribeirão Preto/SP,2,3349,62,103966
1011621,2022-06-30,Ribeirão Preto/SP,1,3350,18,103984
1017218,2022-07-01,Ribeirão Preto/SP,1,3351,19,104003
1022815,2022-07-02,Ribeirão Preto/SP,1,3352,5,104008
1028412,2022-07-03,Ribeirão Preto/SP,0,3352,58,104066
1034009,2022-07-04,Ribeirão Preto/SP,0,3352,0,104066
1039606,2022-07-05,Ribeirão Preto/SP,3,3355,34,104100
1045203,2022-07-06,Ribeirão Preto/SP,2,3357,22,104122
1050800,2022-07-07,Ribeirão Preto/SP,0,3357,5,104127
1056397,2022-07-08,Ribeirão Preto/SP,1,3358,10,104137
1061994,2022-07-09,Ribeirão Preto/SP,3,3361,13,104150
1067591,2022-07-10,Ribeirão Preto/SP,0,3361,5,104155
1073188,2022-07-11,Ribeirão Preto/SP,0,3361,0,104155
1078785,2022-07-12,Ribeirão Preto/SP,2,3363,64,104219
1084382,2022-07-13,Ribeirão Preto/SP,2,3365,16,104235
1089979,2022-07-14,Ribeirão Preto/SP,2,3367,20,104255
1095576,2022-07-15,Ribeirão Preto/SP,2,3369,5,104260
1101173,2022-07-16,Ribeirão Preto/SP,2,3371,11,104271
1106770,2022-07-17,Ribeirão Preto/SP,0,3371,35,104306
1112367,2022-07-18,Ribeirão Preto/SP,0,3371,0,104306
1117964,2022-07-19,Ribeirão Preto/SP,7,3378,37,104343
1123561,2022-07-20,Ribeirão Preto/SP,2,3380,13,104356
1129158,2022-07-21,Ribeirão Preto/SP,3,3383,9,104365
1134755,2022-07-22,Ribeirão Preto/SP,2,3385,5,104370
1140352,2022-07-23,Ribeirão Preto/SP,2,3387,16,104386
1145949,2022-07-24,Ribeirão Preto/SP,0,3387,43,104429
1151546,2022-07-25,Ribeirão Preto/SP,0,3387,1,104430
1157143,2022-07-26,Ribeirão Preto/SP,3,3390,8,104438
1162740,2022-07-27,Ribeirão Preto/SP,1,3391,29,104467
1168337,2022-07-28,Ribeirão Preto/SP,1,3392,7,104474
1173934,2022-07-29,Ribeirão Preto/SP,1,3393,19,104493
1179531,2022-07-30,Ribeirão Preto/SP,1,3394,7,104500
1185128,2022-07-31,Ribeirão Preto/SP,1,3395,48,104548
1190725,2022-08-01,Ribeirão Preto/SP,1,3396,2,104550
1196322,2022-08-02,Ribeirão Preto/SP,1,3397,4,104554
1201919,2022-08-03,Ribeirão Preto/SP,2,3399,11,104565
1207516,2022-08-04,Ribeirão Preto/SP,1,3400,35,104600
1213113,2022-08-05,Ribeirão Preto/SP,1,3401,28,104628
1218710,2022-08-06,Ribeirão Preto/SP,1,3402,6,104634
1224307,2022-08-07,Ribeirão Preto/SP,0,3402,17,104651
1229904,2022-08-08,Ribeirão Preto/SP,0,3402,0,104651
1235501,2022-08-09,Ribeirão Preto/SP,4,3406,16,104667
1241098,2022-08-10,Ribeirão Preto/SP,0,3406,12,104679
1246695,2022-08-11,Ribeirão Preto/SP,1,3407,15,104694
1252292,2022-08-12,Ribeirão Preto/SP,1,3408,4,104698
1257889,2022-08-13,Ribeirão Preto/SP,1,3409,2,104700
1263486,2022-08-14,Ribeirão Preto/SP,0,3409,0,104700
1269083,2022-08-15,Ribeirão Preto/SP,0,3409,0,104700
1274680,2022-08-16,Ribeirão Preto/SP,0,3409,23,104723
1280277,2022-08-17,Ribeirão Preto/SP,3,3412,15,104738
1285874,2022-08-18,Ribeirão Preto/SP,1,3413,7,104745
1291471,2022-08-19,Ribeirão Preto/SP,1,3414,2,104747
1297068,2022-08-20,Ribeirão Preto/SP,2,3416,2,104749
1302665,2022-08-21,Ribeirão Preto/SP,0,3416,16,104765
1308262,2022-08-22,Ribeirão Preto/SP,0,3416,1,104766
1313859,2022-08-23,Ribeirão Preto/SP,1,3417,1,104767
1319456,2022-08-24,Ribeirão Preto/SP,0,3417,7,104774
1325053,2022-08-25,Ribeirão Preto/SP,-1,3416,6,104780
2400,2022-01-01,Itatiba/SP,0,216,0,13163
7997,2022-01-02,Itatiba/SP,0,216,0,13163
13594,2022-01-03,Itatiba/SP,0,216,0,13163
19191,2022-01-04,Itatiba/SP,0,216,3,13166
24788,2022-01-05,Itatiba/SP,0,216,59,13225
30385,2022-01-06,Itatiba/SP,0,216,53,13278
35982,2022-01-07,Itatiba/SP,0,216,3,13281
41579,2022-01-08,Itatiba/SP,0,216,110,13391
47176,2022-01-09,Itatiba/SP,0,216,0,13391
52773,2022-01-10,Itatiba/SP,0,216,0,13391
58370,2022-01-11,Itatiba/SP,0,216,71,13462
63967,2022-01-12,Itatiba/SP,0,216,93,13555
69564,2022-01-13,Itatiba/SP,0,216,65,13620
75161,2022-01-14,Itatiba/SP,0,216,103,13723
80758,2022-01-15,Itatiba/SP,0,216,0,13723
86355,2022-01-16,Itatiba/SP,0,216,1,13724
91952,2022-01-17,Itatiba/SP,0,216,0,13724
97549,2022-01-18,Itatiba/SP,0,216,65,13789
103146,2022-01-19,Itatiba/SP,0,216,73,13862
108743,2022-01-20,Itatiba/SP,0,216,127,13989
114340,2022-01-21,Itatiba/SP,0,216,145,14134
119937,2022-01-22,Itatiba/SP,0,216,0,14134
125534,2022-01-23,Itatiba/SP,1,217,166,14300
131131,2022-01-24,Itatiba/SP,0,217,0,14300
136728,2022-01-25,Itatiba/SP,0,217,66,14366
142325,2022-01-26,Itatiba/SP,0,217,122,14488
147922,2022-01-27,Itatiba/SP,1,218,51,14539
153519,2022-01-28,Itatiba/SP,0,218,78,14617
159116,2022-01-29,Itatiba/SP,1,219,139,14756
164713,2022-01-30,Itatiba/SP,0,219,20,14776
170310,2022-01-31,Itatiba/SP,0,219,0,14776
175907,2022-02-01,Itatiba/SP,0,219,81,14857
181504,2022-02-02,Itatiba/SP,1,220,3,14860
187101,2022-02-03,Itatiba/SP,2,222,344,15204
192698,2022-02-04,Itatiba/SP,0,222,0,15204
198295,2022-02-05,Itatiba/SP,3,225,201,15405
203892,2022-02-06,Itatiba/SP,0,225,0,15405
209489,2022-02-07,Itatiba/SP,0,225,0,15405
215086,2022-02-08,Itatiba/SP,4,229,104,15509
220683,2022-02-09,Itatiba/SP,2,231,69,15578
226280,2022-02-10,Itatiba/SP,2,233,111,15689
231877,2022-02-11,Itatiba/SP,0,233,130,15819
237474,2022-02-12,Itatiba/SP,1,234,36,15855
243071,2022-02-13,Itatiba/SP,0,234,5,15860
248668,2022-02-14,Itatiba/SP,0,234,0,15860
254265,2022-02-15,Itatiba/SP,0,234,37,15897
259862,2022-02-16,Itatiba/SP,0,234,82,15979
265459,2022-02-17,Itatiba/SP,0,234,8,15987
271056,2022-02-18,Itatiba/SP,0,234,117,16104
276653,2022-02-19,Itatiba/SP,0,234,63,16167
282250,2022-02-20,Itatiba/SP,0,234,0,16167
287847,2022-02-21,Itatiba/SP,0,234,0,16167
293444,2022-02-22,Itatiba/SP,0,234,228,16395
299041,2022-02-23,Itatiba/SP,0,234,268,16663
304638,2022-02-24,Itatiba/SP,0,234,378,17041
310235,2022-02-25,Itatiba/SP,0,234,360,17401
315832,2022-02-26,Itatiba/SP,1,235,300,17701
321429,2022-02-27,Itatiba/SP,0,235,1,17702
327026,2022-02-28,Itatiba/SP,0,235,0,17702
332623,2022-03-01,Itatiba/SP,0,235,0,17702
338220,2022-03-02,Itatiba/SP,0,235,0,17702
343817,2022-03-03,Itatiba/SP,0,235,326,18028
349414,2022-03-04,Itatiba/SP,0,235,429,18457
355011,2022-03-05,Itatiba/SP,0,235,420,18877
360608,2022-03-06,Itatiba/SP,0,235,0,18877
366205,2022-03-07,Itatiba/SP,0,235,6,18883
371802,2022-03-08,Itatiba/SP,4,239,550,19433
377399,2022-03-09,Itatiba/SP,0,239,345,19778
382996,2022-03-10,Itatiba/SP,0,239,216,19994
388593,2022-03-11,Itatiba/SP,0,239,120,20114
394190,2022-03-12,Itatiba/SP,0,239,262,20376
399787,2022-03-13,Itatiba/SP,0,239,0,20376
405384,2022-03-14,Itatiba/SP,1,240,1,20377
410981,2022-03-15,Itatiba/SP,0,240,100,20477
416578,2022-03-16,Itatiba/SP,1,241,82,20559
422175,2022-03-17,Itatiba/SP,0,241,51,20610
427772,2022-03-18,Itatiba/SP,0,241,108,20718
433369,2022-03-19,Itatiba/SP,0,241,136,20854
438966,2022-03-20,Itatiba/SP,0,241,2,20856
444563,2022-03-21,Itatiba/SP,0,241,2,20858
450160,2022-03-22,Itatiba/SP,0,241,70,20928
455757,2022-03-23,Itatiba/SP,0,241,60,20988
461354,2022-03-24,Itatiba/SP,0,241,76,21064
466951,2022-03-25,Itatiba/SP,0,241,21,21085
472548,2022-03-26,Itatiba/SP,0,241,58,21143
478145,2022-03-27,Itatiba/SP,0,241,0,21143
483742,2022-03-28,Itatiba/SP,0,241,-1,21142
489339,2022-03-29,Itatiba/SP,0,241,18,21160
494936,2022-03-30,Itatiba/SP,0,241,19,21179
500533,2022-03-31,Itatiba/SP,1,242,34,21213
506130,2022-04-01,Itatiba/SP,0,242,47,21260
511727,2022-04-02,Itatiba/SP,0,242,40,21300
517324,2022-04-03,Itatiba/SP,0,242,0,21300
522921,2022-04-04,Itatiba/SP,0,242,0,21300
528518,2022-04-05,Itatiba/SP,0,242,13,21313
534115,2022-04-06,Itatiba/SP,0,242,9,21322
539712,2022-04-07,Itatiba/SP,0,242,16,21338
545309,2022-04-08,Itatiba/SP,0,242,2,21340
550906,2022-04-09,Itatiba/SP,0,242,20,21360
556503,2022-04-10,Itatiba/SP,0,242,0,21360
562100,2022-04-11,Itatiba/SP,0,242,0,21360
567697,2022-04-12,Itatiba/SP,0,242,1,21361
573294,2022-04-13,Itatiba/SP,0,242,3,21364
578891,2022-04-14,Itatiba/SP,0,242,3,21367
584488,2022-04-15,Itatiba/SP,0,242,-1,21366
590085,2022-04-16,Itatiba/SP,0,242,0,21366
595682,2022-04-17,Itatiba/SP,0,242,0,21366
601279,2022-04-18,Itatiba/SP,0,242,0,21366
606876,2022-04-19,Itatiba/SP,0,242,0,21366
612473,2022-04-20,Itatiba/SP,0,242,0,21366
618070,2022-04-21,Itatiba/SP,0,242,1,21367
623667,2022-04-22,Itatiba/SP,0,242,0,21367
629264,2022-04-23,Itatiba/SP,0,242,0,21367
634861,2022-04-24,Itatiba/SP,0,242,0,21367
640458,2022-04-25,Itatiba/SP,0,242,0,21367
646055,2022-04-26,Itatiba/SP,0,242,1,21368
651652,2022-04-27,Itatiba/SP,0,242,4,21372
657249,2022-04-28,Itatiba/SP,0,242,1,21373
662846,2022-04-29,Itatiba/SP,1,243,6,21379
668443,2022-04-30,Itatiba/SP,0,243,20,21399
674040,2022-05-01,Itatiba/SP,0,243,0,21399
679637,2022-05-02,Itatiba/SP,0,243,0,21399
685234,2022-05-03,Itatiba/SP,0,243,25,21424
690831,2022-05-04,Itatiba/SP,0,243,13,21437
696428,2022-05-05,Itatiba/SP,0,243,1,21438
702025,2022-05-06,Itatiba/SP,0,243,-3,21435
707622,2022-05-07,Itatiba/SP,0,243,3,21438
713219,2022-05-08,Itatiba/SP,0,243,0,21438
718816,2022-05-09,Itatiba/SP,0,243,0,21438
724413,2022-05-10,Itatiba/SP,0,243,-2,21436
730010,2022-05-11,Itatiba/SP,0,243,12,21448
735607,2022-05-12,Itatiba/SP,22,265,7,21455
741204,2022-05-13,Itatiba/SP,14,279,18,21473
746801,2022-05-14,Itatiba/SP,15,294,4,21477
752398,2022-05-15,Itatiba/SP,0,294,0,21477
757995,2022-05-16,Itatiba/SP,0,294,0,21477
763592,2022-05-17,Itatiba/SP,21,315,30,21507
769189,2022-05-18,Itatiba/SP,5,320,3,21510
774786,2022-05-19,Itatiba/SP,16,336,9,21519
780383,2022-05-20,Itatiba/SP,0,336,0,21519
785980,2022-05-21,Itatiba/SP,0,336,0,21519
791577,2022-05-22,Itatiba/SP,1,337,11,21530
797174,2022-05-23,Itatiba/SP,0,337,0,21530
802771,2022-05-24,Itatiba/SP,0,337,19,21549
808368,2022-05-25,Itatiba/SP,0,337,16,21565
813965,2022-05-26,Itatiba/SP,0,337,28,21593
819562,2022-05-27,Itatiba/SP,0,337,23,21616
825159,2022-05-28,Itatiba/SP,2,339,55,21671
830756,2022-05-29,Itatiba/SP,0,339,1,21672
836353,2022-05-30,Itatiba/SP,0,339,0,21672
841950,2022-05-31,Itatiba/SP,0,339,16,21688
847547,2022-06-01,Itatiba/SP,5,344,27,21715
853144,2022-06-02,Itatiba/SP,0,344,16,21731
858741,2022-06-03,Itatiba/SP,0,344,0,21731
864338,2022-06-04,Itatiba/SP,0,344,0,21731
869935,2022-06-05,Itatiba/SP,0,344,0,21731
875532,2022-06-06,Itatiba/SP,0,344,0,21731
881129,2022-06-07,Itatiba/SP,1,345,81,21812
886726,2022-06-08,Itatiba/SP,0,345,74,21886
892323,2022-06-09,Itatiba/SP,1,346,33,21919
897920,2022-06-10,Itatiba/SP,0,346,100,22019
903517,2022-06-11,Itatiba/SP,0,346,99,22118
909114,2022-06-12,Itatiba/SP,0,346,0,22118
914711,2022-06-13,Itatiba/SP,0,346,0,22118
920308,2022-06-14,Itatiba/SP,0,346,0,22118
925905,2022-06-15,Itatiba/SP,0,346,50,22168
931502,2022-06-16,Itatiba/SP,1,347,10,22178
937099,2022-06-17,Itatiba/SP,0,347,0,22178
942696,2022-06-18,Itatiba/SP,0,347,0,22178
948293,2022-06-19,Itatiba/SP,0,347,0,22178
953890,2022-06-20,Itatiba/SP,0,347,0,22178
959487,2022-06-21,Itatiba/SP,1,348,1,22179
965084,2022-06-22,Itatiba/SP,0,348,16,22195
970681,2022-06-23,Itatiba/SP,3,351,14,22209
976278,2022-06-24,Itatiba/SP,0,351,1,22210
981875,2022-06-25,Itatiba/SP,0,351,27,22237
987472,2022-06-26,Itatiba/SP,0,351,0,22237
993069,2022-06-27,Itatiba/SP,0,351,0,22237
998666,2022-06-28,Itatiba/SP,1,352,22,22259
1004263,2022-06-29,Itatiba/SP,3,355,3,22262
1009860,2022-06-30,Itatiba/SP,1,356,7,22269
1015457,2022-07-01,Itatiba/SP,0,356,15,22284
1021054,2022-07-02,Itatiba/SP,0,356,6,22290
1026651,2022-07-03,Itatiba/SP,0,356,83,22373
1032248,2022-07-04,Itatiba/SP,0,356,0,22373
1037845,2022-07-05,Itatiba/SP,0,356,30,22403
1043442,2022-07-06,Itatiba/SP,0,356,54,22457
1049039,2022-07-07,Itatiba/SP,0,356,58,22515
1054636,2022-07-08,Itatiba/SP,0,356,56,22571
1060233,2022-07-09,Itatiba/SP,0,356,62,22633
1065830,2022-07-10,Itatiba/SP,0,356,0,22633
1071427,2022-07-11,Itatiba/SP,0,356,0,22633
1077024,2022-07-12,Itatiba/SP,0,356,3,22636
1082621,2022-07-13,Itatiba/SP,2,358,39,22675
1088218,2022-07-14,Itatiba/SP,0,358,30,22705
1093815,2022-07-15,Itatiba/SP,0,358,15,22720
1099412,2022-07-16,Itatiba/SP,0,358,60,22780
1105009,2022-07-17,Itatiba/SP,0,358,0,22780
1110606,2022-07-18,Itatiba/SP,0,358,1,22781
1116203,2022-07-19,Itatiba/SP,0,358,16,22797
1121800,2022-07-20,Itatiba/SP,1,359,2,22799
1127397,2022-07-21,Itatiba/SP,0,359,34,22833
1132994,2022-07-22,Itatiba/SP,0,359,39,22872
1138591,2022-07-23,Itatiba/SP,0,359,7,22879
1144188,2022-07-24,Itatiba/SP,0,359,1,22880
1149785,2022-07-25,Itatiba/SP,0,359,0,22880
1155382,2022-07-26,Itatiba/SP,0,359,20,22900
1160979,2022-07-27,Itatiba/SP,0,359,39,22939
1166576,2022-07-28,Itatiba/SP,0,359,60,22999
1172173,2022-07-29,Itatiba/SP,0,359,24,23023
1177770,2022-07-30,Itatiba/SP,0,359,38,23061
1183367,2022-07-31,Itatiba/SP,0,359,0,23061
1188964,2022-08-01,Itatiba/SP,0,359,0,23061
1194561,2022-08-02,Itatiba/SP,1,360,41,23102
1200158,2022-08-03,Itatiba/SP,0,360,3,23105
1205755,2022-08-04,Itatiba/SP,0,360,9,23114
1211352,2022-08-05,Itatiba/SP,0,360,21,23135
1216949,2022-08-06,Itatiba/SP,0,360,8,23143
1222546,2022-08-07,Itatiba/SP,0,360,84,23227
1228143,2022-08-08,Itatiba/SP,0,360,0,23227
1233740,2022-08-09,Itatiba/SP,0,360,0,23227
1239337,2022-08-10,Itatiba/SP,0,360,18,23245
1244934,2022-08-11,Itatiba/SP,0,360,23,23268
1250531,2022-08-12,Itatiba/SP,-1,359,72,23340
1256128,2022-08-13,Itatiba/SP,0,359,2,23342
1261725,2022-08-14,Itatiba/SP,0,359,1,23343
1267322,2022-08-15,Itatiba/SP,0,359,0,23343
1272919,2022-08-16,Itatiba/SP,0,359,18,23361
1278516,2022-08-17,Itatiba/SP,0,359,22,23383
1284113,2022-08-18,Itatiba/SP,0,359,18,23401
1289710,2022-08-19,Itatiba/SP,0,359,14,23415
1295307,2022-08-20,Itatiba/SP,0,359,21,23436
1300904,2022-08-21,Itatiba/SP,0,359,0,23436
1306501,2022-08-22,Itatiba/SP,0,359,0,23436
1312098,2022-08-23,Itatiba/SP,0,359,86,23522
1317695,2022-08-24,Itatiba/SP,0,359,0,23522
1323292,2022-08-25,Itatiba/SP,1,360,7,23529
385,2022-01-01,Atibaia/SP,0,293,0,12752
5982,2022-01-02,Atibaia/SP,0,293,0,12752
11579,2022-01-03,Atibaia/SP,0,293,0,12752
17176,2022-01-04,Atibaia/SP,0,293,0,12752
22773,2022-01-05,Atibaia/SP,0,293,1,12753
28370,2022-01-06,Atibaia/SP,0,293,0,12753
33967,2022-01-07,Atibaia/SP,0,293,0,12753
39564,2022-01-08,Atibaia/SP,0,293,0,12753
45161,2022-01-09,Atibaia/SP,0,293,0,12753
50758,2022-01-10,Atibaia/SP,0,293,1,12754
56355,2022-01-11,Atibaia/SP,0,293,1,12755
61952,2022-01-12,Atibaia/SP,0,293,1,12756
67549,2022-01-13,Atibaia/SP,0,293,0,12756
73146,2022-01-14,Atibaia/SP,0,293,3,12759
78743,2022-01-15,Atibaia/SP,0,293,1,12760
84340,2022-01-16,Atibaia/SP,0,293,0,12760
89937,2022-01-17,Atibaia/SP,0,293,0,12760
95534,2022-01-18,Atibaia/SP,0,293,4,12764
101131,2022-01-19,Atibaia/SP,2,295,3,12767
106728,2022-01-20,Atibaia/SP,1,296,5,12772
112325,2022-01-21,Atibaia/SP,0,296,1,12773
117922,2022-01-22,Atibaia/SP,0,296,0,12773
123519,2022-01-23,Atibaia/SP,0,296,4,12777
129116,2022-01-24,Atibaia/SP,0,296,0,12777
134713,2022-01-25,Atibaia/SP,0,296,6,12783
140310,2022-01-26,Atibaia/SP,0,296,6,12789
145907,2022-01-27,Atibaia/SP,2,298,7,12796
151504,2022-01-28,Atibaia/SP,0,298,1,12797
157101,2022-01-29,Atibaia/SP,0,298,1,12798
162698,2022-01-30,Atibaia/SP,0,298,1,12799
168295,2022-01-31,Atibaia/SP,0,298,0,12799
173892,2022-02-01,Atibaia/SP,3,301,4,12803
179489,2022-02-02,Atibaia/SP,1,302,0,12803
185086,2022-02-03,Atibaia/SP,0,302,3,12806
190683,2022-02-04,Atibaia/SP,0,302,0,12806
196280,2022-02-05,Atibaia/SP,0,302,13,12819
201877,2022-02-06,Atibaia/SP,0,302,1,12820
207474,2022-02-07,Atibaia/SP,0,302,0,12820
213071,2022-02-08,Atibaia/SP,0,302,0,12820
218668,2022-02-09,Atibaia/SP,0,302,2,12822
224265,2022-02-10,Atibaia/SP,2,304,6,12828
229862,2022-02-11,Atibaia/SP,1,305,2,12830
235459,2022-02-12,Atibaia/SP,0,305,3,12833
241056,2022-02-13,Atibaia/SP,0,305,1,12834
246653,2022-02-14,Atibaia/SP,0,305,0,12834
252250,2022-02-15,Atibaia/SP,4,309,4,12838
257847,2022-02-16,Atibaia/SP,0,309,0,12838
263444,2022-02-17,Atibaia/SP,1,310,1,12839
269041,2022-02-18,Atibaia/SP,0,310,0,12839
274638,2022-02-19,Atibaia/SP,2,312,6,12845
280235,2022-02-20,Atibaia/SP,0,312,0,12845
285832,2022-02-21,Atibaia/SP,0,312,0,12845
291429,2022-02-22,Atibaia/SP,0,312,2,12847
297026,2022-02-23,Atibaia/SP,0,312,2,12849
302623,2022-02-24,Atibaia/SP,4,316,6,12855
308220,2022-02-25,Atibaia/SP,0,316,2,12857
313817,2022-02-26,Atibaia/SP,0,316,0,12857
319414,2022-02-27,Atibaia/SP,0,316,1,12858
325011,2022-02-28,Atibaia/SP,0,316,0,12858
330608,2022-03-01,Atibaia/SP,0,316,0,12858
336205,2022-03-02,Atibaia/SP,0,316,0,12858
341802,2022-03-03,Atibaia/SP,1,317,4,12862
347399,2022-03-04,Atibaia/SP,0,317,-1,12861
352996,2022-03-05,Atibaia/SP,0,317,14,12875
358593,2022-03-06,Atibaia/SP,0,317,0,12875
364190,2022-03-07,Atibaia/SP,0,317,2,12877
369787,2022-03-08,Atibaia/SP,2,319,1,12878
375384,2022-03-09,Atibaia/SP,0,319,0,12878
380981,2022-03-10,Atibaia/SP,0,319,1,12879
386578,2022-03-11,Atibaia/SP,0,319,0,12879
392175,2022-03-12,Atibaia/SP,0,319,2,12881
397772,2022-03-13,Atibaia/SP,0,319,0,12881
403369,2022-03-14,Atibaia/SP,0,319,0,12881
408966,2022-03-15,Atibaia/SP,0,319,0,12881
414563,2022-03-16,Atibaia/SP,0,319,0,12881
420160,2022-03-17,Atibaia/SP,0,319,0,12881
425757,2022-03-18,Atibaia/SP,0,319,2,12883
431354,2022-03-19,Atibaia/SP,1,320,4,12887
436951,2022-03-20,Atibaia/SP,0,320,2,12889
442548,2022-03-21,Atibaia/SP,0,320,0,12889
448145,2022-03-22,Atibaia/SP,0,320,2,12891
453742,2022-03-23,Atibaia/SP,0,320,0,12891
459339,2022-03-24,Atibaia/SP,0,320,0,12891
464936,2022-03-25,Atibaia/SP,0,320,0,12891
470533,2022-03-26,Atibaia/SP,0,320,0,12891
476130,2022-03-27,Atibaia/SP,0,320,0,12891
481727,2022-03-28,Atibaia/SP,0,320,0,12891
487324,2022-03-29,Atibaia/SP,0,320,0,12891
492921,2022-03-30,Atibaia/SP,0,320,3,12894
498518,2022-03-31,Atibaia/SP,0,320,0,12894
504115,2022-04-01,Atibaia/SP,0,320,0,12894
509712,2022-04-02,Atibaia/SP,0,320,5,12899
515309,2022-04-03,Atibaia/SP,0,320,0,12899
520906,2022-04-04,Atibaia/SP,1,321,1,12900
526503,2022-04-05,Atibaia/SP,1,322,4,12904
532100,2022-04-06,Atibaia/SP,3,325,22,12926
537697,2022-04-07,Atibaia/SP,1,326,2,12928
543294,2022-04-08,Atibaia/SP,2,328,2,12930
548891,2022-04-09,Atibaia/SP,0,328,5,12935
554488,2022-04-10,Atibaia/SP,0,328,0,12935
560085,2022-04-11,Atibaia/SP,0,328,0,12935
565682,2022-04-12,Atibaia/SP,0,328,0,12935
571279,2022-04-13,Atibaia/SP,0,328,0,12935
576876,2022-04-14,Atibaia/SP,0,328,0,12935
582473,2022-04-15,Atibaia/SP,0,328,0,12935
588070,2022-04-16,Atibaia/SP,0,328,0,12935
593667,2022-04-17,Atibaia/SP,0,328,0,12935
599264,2022-04-18,Atibaia/SP,0,328,0,12935
604861,2022-04-19,Atibaia/SP,0,328,0,12935
610458,2022-04-20,Atibaia/SP,10,338,22,12957
616055,2022-04-21,Atibaia/SP,0,338,1,12958
621652,2022-04-22,Atibaia/SP,0,338,0,12958
627249,2022-04-23,Atibaia/SP,0,338,0,12958
632846,2022-04-24,Atibaia/SP,0,338,0,12958
638443,2022-04-25,Atibaia/SP,0,338,0,12958
644040,2022-04-26,Atibaia/SP,0,338,2,12960
649637,2022-04-27,Atibaia/SP,3,341,7,12967
655234,2022-04-28,Atibaia/SP,0,341,0,12967
660831,2022-04-29,Atibaia/SP,4,345,0,12967
666428,2022-04-30,Atibaia/SP,1,346,4,12971
672025,2022-05-01,Atibaia/SP,2,348,2,12973
677622,2022-05-02,Atibaia/SP,0,348,0,12973
683219,2022-05-03,Atibaia/SP,0,348,1,12974
688816,2022-05-04,Atibaia/SP,0,348,1,12975
694413,2022-05-05,Atibaia/SP,0,348,0,12975
700010,2022-05-06,Atibaia/SP,0,348,-1,12974
705607,2022-05-07,Atibaia/SP,0,348,0,12974
711204,2022-05-08,Atibaia/SP,0,348,0,12974
716801,2022-05-09,Atibaia/SP,0,348,0,12974
722398,2022-05-10,Atibaia/SP,0,348,-1,12973
727995,2022-05-11,Atibaia/SP,0,348,0,12973
733592,2022-05-12,Atibaia/SP,0,348,0,12973
739189,2022-05-13,Atibaia/SP,0,348,1,12974
744786,2022-05-14,Atibaia/SP,1,349,0,12974
750383,2022-05-15,Atibaia/SP,0,349,1,12975
755980,2022-05-16,Atibaia/SP,0,349,0,12975
761577,2022-05-17,Atibaia/SP,0,349,7,12982
767174,2022-05-18,Atibaia/SP,1,350,1,12983
772771,2022-05-19,Atibaia/SP,0,350,0,12983
778368,2022-05-20,Atibaia/SP,0,350,0,12983
783965,2022-05-21,Atibaia/SP,0,350,0,12983
789562,2022-05-22,Atibaia/SP,0,350,6,12989
795159,2022-05-23,Atibaia/SP,0,350,0,12989
800756,2022-05-24,Atibaia/SP,0,350,2,12991
806353,2022-05-25,Atibaia/SP,0,350,0,12991
811950,2022-05-26,Atibaia/SP,0,350,0,12991
817547,2022-05-27,Atibaia/SP,0,350,0,12991
823144,2022-05-28,Atibaia/SP,0,350,0,12991
828741,2022-05-29,Atibaia/SP,0,350,1,12992
834338,2022-05-30,Atibaia/SP,0,350,0,12992
839935,2022-05-31,Atibaia/SP,0,350,0,12992
845532,2022-06-01,Atibaia/SP,1,351,2,12994
851129,2022-06-02,Atibaia/SP,0,351,2,12996
856726,2022-06-03,Atibaia/SP,0,351,0,12996
862323,2022-06-04,Atibaia/SP,0,351,0,12996
867920,2022-06-05,Atibaia/SP,0,351,0,12996
873517,2022-06-06,Atibaia/SP,0,351,0,12996
879114,2022-06-07,Atibaia/SP,0,351,2,12998
884711,2022-06-08,Atibaia/SP,0,351,1,12999
890308,2022-06-09,Atibaia/SP,1,352,3,13002
895905,2022-06-10,Atibaia/SP,1,353,2,13004
901502,2022-06-11,Atibaia/SP,2,355,2,13006
907099,2022-06-12,Atibaia/SP,0,355,0,13006
912696,2022-06-13,Atibaia/SP,0,355,1,13007
918293,2022-06-14,Atibaia/SP,0,355,0,13007
923890,2022-06-15,Atibaia/SP,6,361,3,13010
929487,2022-06-16,Atibaia/SP,1,362,7,13017
935084,2022-06-17,Atibaia/SP,0,362,2,13019
940681,2022-06-18,Atibaia/SP,0,362,0,13019
946278,2022-06-19,Atibaia/SP,0,362,0,13019
951875,2022-06-20,Atibaia/SP,0,362,0,13019
957472,2022-06-21,Atibaia/SP,0,362,4,13023
963069,2022-06-22,Atibaia/SP,0,362,-2,13021
968666,2022-06-23,Atibaia/SP,2,364,3,13024
974263,2022-06-24,Atibaia/SP,1,365,1,13025
979860,2022-06-25,Atibaia/SP,0,365,2,13027
985457,2022-06-26,Atibaia/SP,0,365,0,13027
991054,2022-06-27,Atibaia/SP,0,365,0,13027
996651,2022-06-28,Atibaia/SP,0,365,0,13027
1002248,2022-06-29,Atibaia/SP,0,365,0,13027
1007845,2022-06-30,Atibaia/SP,0,365,0,13027
1013442,2022-07-01,Atibaia/SP,0,365,0,13027
1019039,2022-07-02,Atibaia/SP,1,366,7,13034
1024636,2022-07-03,Atibaia/SP,0,366,0,13034
1030233,2022-07-04,Atibaia/SP,0,366,0,13034
1035830,2022-07-05,Atibaia/SP,1,367,2,13036
1041427,2022-07-06,Atibaia/SP,1,368,7,13043
1047024,2022-07-07,Atibaia/SP,0,368,1,13044
1052621,2022-07-08,Atibaia/SP,0,368,1,13045
1058218,2022-07-09,Atibaia/SP,0,368,0,13045
1063815,2022-07-10,Atibaia/SP,0,368,0,13045
1069412,2022-07-11,Atibaia/SP,0,368,0,13045
1075009,2022-07-12,Atibaia/SP,3,371,4,13049
1080606,2022-07-13,Atibaia/SP,0,371,0,13049
1086203,2022-07-14,Atibaia/SP,0,371,0,13049
1091800,2022-07-15,Atibaia/SP,0,371,0,13049
1097397,2022-07-16,Atibaia/SP,0,371,1,13050
1102994,2022-07-17,Atibaia/SP,0,371,0,13050
1108591,2022-07-18,Atibaia/SP,0,371,0,13050
1114188,2022-07-19,Atibaia/SP,0,371,0,13050
1119785,2022-07-20,Atibaia/SP,0,371,0,13050
1125382,2022-07-21,Atibaia/SP,0,371,0,13050
1130979,2022-07-22,Atibaia/SP,0,371,1,13051
1136576,2022-07-23,Atibaia/SP,0,371,0,13051
1142173,2022-07-24,Atibaia/SP,0,371,0,13051
1147770,2022-07-25,Atibaia/SP,0,371,0,13051
1153367,2022-07-26,Atibaia/SP,0,371,0,13051
1158964,2022-07-27,Atibaia/SP,0,371,0,13051
1164561,2022-07-28,Atibaia/SP,1,372,1,13052
1170158,2022-07-29,Atibaia/SP,0,372,0,13052
1175755,2022-07-30,Atibaia/SP,1,373,1,13053
1181352,2022-07-31,Atibaia/SP,0,373,0,13053
1186949,2022-08-01,Atibaia/SP,0,373,0,13053
1192546,2022-08-02,Atibaia/SP,0,373,1,13054
1198143,2022-08-03,Atibaia/SP,0,373,1,13055
1203740,2022-08-04,Atibaia/SP,0,373,2,13057
1209337,2022-08-05,Atibaia/SP,0,373,0,13057
1214934,2022-08-06,Atibaia/SP,0,373,0,13057
1220531,2022-08-07,Atibaia/SP,0,373,0,13057
1226128,2022-08-08,Atibaia/SP,0,373,1,13058
1231725,2022-08-09,Atibaia/SP,0,373,0,13058
1237322,2022-08-10,Atibaia/SP,0,373,0,13058
1242919,2022-08-11,Atibaia/SP,0,373,1,13059
1248516,2022-08-12,Atibaia/SP,0,373,0,13059
1254113,2022-08-13,Atibaia/SP,7,380,22,13081
1259710,2022-08-14,Atibaia/SP,0,380,0,13081
1265307,2022-08-15,Atibaia/SP,0,380,0,13081
1270904,2022-08-16,Atibaia/SP,0,380,0,13081
1276501,2022-08-17,Atibaia/SP,0,380,1,13082
1282098,2022-08-18,Atibaia/SP,0,380,7,13089
1287695,2022-08-19,Atibaia/SP,0,380,0,13089
1293292,2022-08-20,Atibaia/SP,0,380,1,13090
1298889,2022-08-21,Atibaia/SP,0,380,0,13090
1304486,2022-08-22,Atibaia/SP,0,380,0,13090
1310083,2022-08-23,Atibaia/SP,1,381,5,13095
1315680,2022-08-24,Atibaia/SP,0,381,0,13095
1321277,2022-08-25,Atibaia/SP,0,381,0,13095
706,2022-01-01,Bragança Paulista/SP,0,593,1,23643
6303,2022-01-02,Bragança Paulista/SP,0,593,0,23643
11900,2022-01-03,Bragança Paulista/SP,0,593,0,23643
17497,2022-01-04,Bragança Paulista/SP,0,593,0,23643
23094,2022-01-05,Bragança Paulista/SP,0,593,31,23674
28691,2022-01-06,Bragança Paulista/SP,0,593,46,23720
34288,2022-01-07,Bragança Paulista/SP,0,593,5,23725
39885,2022-01-08,Bragança Paulista/SP,0,593,5,23730
45482,2022-01-09,Bragança Paulista/SP,0,593,0,23730
51079,2022-01-10,Bragança Paulista/SP,0,593,1,23731
56676,2022-01-11,Bragança Paulista/SP,0,593,22,23753
62273,2022-01-12,Bragança Paulista/SP,0,593,27,23780
67870,2022-01-13,Bragança Paulista/SP,0,593,132,23912
73467,2022-01-14,Bragança Paulista/SP,0,593,141,24053
79064,2022-01-15,Bragança Paulista/SP,0,593,-2,24051
84661,2022-01-16,Bragança Paulista/SP,0,593,0,24051
90258,2022-01-17,Bragança Paulista/SP,0,593,0,24051
95855,2022-01-18,Bragança Paulista/SP,0,593,47,24098
101452,2022-01-19,Bragança Paulista/SP,0,593,72,24170
107049,2022-01-20,Bragança Paulista/SP,0,593,2,24172
112646,2022-01-21,Bragança Paulista/SP,0,593,1,24173
118243,2022-01-22,Bragança Paulista/SP,0,593,0,24173
123840,2022-01-23,Bragança Paulista/SP,3,596,21,24194
129437,2022-01-24,Bragança Paulista/SP,0,596,0,24194
135034,2022-01-25,Bragança Paulista/SP,0,596,51,24245
140631,2022-01-26,Bragança Paulista/SP,0,596,42,24287
146228,2022-01-27,Bragança Paulista/SP,0,596,87,24374
151825,2022-01-28,Bragança Paulista/SP,5,601,118,24492
157422,2022-01-29,Bragança Paulista/SP,2,603,45,24537
163019,2022-01-30,Bragança Paulista/SP,0,603,1,24538
168616,2022-01-31,Bragança Paulista/SP,0,603,0,24538
174213,2022-02-01,Bragança Paulista/SP,0,603,146,24684
179810,2022-02-02,Bragança Paulista/SP,1,604,1,24685
185407,2022-02-03,Bragança Paulista/SP,2,606,139,24824
191004,2022-02-04,Bragança Paulista/SP,0,606,0,24824
196601,2022-02-05,Bragança Paulista/SP,0,606,63,24887
202198,2022-02-06,Bragança Paulista/SP,0,606,1,24888
207795,2022-02-07,Bragança Paulista/SP,0,606,0,24888
213392,2022-02-08,Bragança Paulista/SP,5,611,22,24910
218989,2022-02-09,Bragança Paulista/SP,1,612,10,24920
224586,2022-02-10,Bragança Paulista/SP,0,612,50,24970
230183,2022-02-11,Bragança Paulista/SP,0,612,9,24979
235780,2022-02-12,Bragança Paulista/SP,0,612,11,24990
241377,2022-02-13,Bragança Paulista/SP,0,612,0,24990
246974,2022-02-14,Bragança Paulista/SP,0,612,-1,24989
252571,2022-02-15,Bragança Paulista/SP,1,613,84,25073
258168,2022-02-16,Bragança Paulista/SP,0,613,167,25240
263765,2022-02-17,Bragança Paulista/SP,0,613,62,25302
269362,2022-02-18,Bragança Paulista/SP,2,615,46,25348
274959,2022-02-19,Bragança Paulista/SP,2,617,36,25384
280556,2022-02-20,Bragança Paulista/SP,0,617,0,25384
286153,2022-02-21,Bragança Paulista/SP,0,617,0,25384
291750,2022-02-22,Bragança Paulista/SP,1,618,27,25411
297347,2022-02-23,Bragança Paulista/SP,0,618,23,25434
302944,2022-02-24,Bragança Paulista/SP,4,622,43,25477
308541,2022-02-25,Bragança Paulista/SP,0,622,46,25523
314138,2022-02-26,Bragança Paulista/SP,0,622,6,25529
319735,2022-02-27,Bragança Paulista/SP,0,622,0,25529
325332,2022-02-28,Bragança Paulista/SP,0,622,0,25529
330929,2022-03-01,Bragança Paulista/SP,0,622,0,25529
336526,2022-03-02,Bragança Paulista/SP,0,622,0,25529
342123,2022-03-03,Bragança Paulista/SP,0,622,20,25549
347720,2022-03-04,Bragança Paulista/SP,0,622,18,25567
353317,2022-03-05,Bragança Paulista/SP,0,622,20,25587
358914,2022-03-06,Bragança Paulista/SP,0,622,0,25587
364511,2022-03-07,Bragança Paulista/SP,0,622,1,25588
370108,2022-03-08,Bragança Paulista/SP,0,622,161,25749
375705,2022-03-09,Bragança Paulista/SP,1,623,222,25971
381302,2022-03-10,Bragança Paulista/SP,0,623,39,26010
386899,2022-03-11,Bragança Paulista/SP,0,623,28,26038
392496,2022-03-12,Bragança Paulista/SP,0,623,54,26092
398093,2022-03-13,Bragança Paulista/SP,0,623,0,26092
403690,2022-03-14,Bragança Paulista/SP,0,623,0,26092
409287,2022-03-15,Bragança Paulista/SP,0,623,142,26234
414884,2022-03-16,Bragança Paulista/SP,0,623,184,26418
420481,2022-03-17,Bragança Paulista/SP,0,623,106,26524
426078,2022-03-18,Bragança Paulista/SP,0,623,47,26571
431675,2022-03-19,Bragança Paulista/SP,0,623,72,26643
437272,2022-03-20,Bragança Paulista/SP,0,623,0,26643
442869,2022-03-21,Bragança Paulista/SP,0,623,1,26644
448466,2022-03-22,Bragança Paulista/SP,0,623,146,26790
454063,2022-03-23,Bragança Paulista/SP,0,623,202,26992
459660,2022-03-24,Bragança Paulista/SP,0,623,203,27195
465257,2022-03-25,Bragança Paulista/SP,2,625,264,27459
470854,2022-03-26,Bragança Paulista/SP,0,625,54,27513
476451,2022-03-27,Bragança Paulista/SP,0,625,1,27514
482048,2022-03-28,Bragança Paulista/SP,0,625,0,27514
487645,2022-03-29,Bragança Paulista/SP,0,625,181,27695
493242,2022-03-30,Bragança Paulista/SP,0,625,197,27892
498839,2022-03-31,Bragança Paulista/SP,0,625,106,27998
504436,2022-04-01,Bragança Paulista/SP,0,625,60,28058
510033,2022-04-02,Bragança Paulista/SP,0,625,107,28165
515630,2022-04-03,Bragança Paulista/SP,0,625,0,28165
521227,2022-04-04,Bragança Paulista/SP,0,625,0,28165
526824,2022-04-05,Bragança Paulista/SP,0,625,192,28357
532421,2022-04-06,Bragança Paulista/SP,0,625,370,28727
538018,2022-04-07,Bragança Paulista/SP,0,625,280,29007
543615,2022-04-08,Bragança Paulista/SP,0,625,269,29276
549212,2022-04-09,Bragança Paulista/SP,0,625,196,29472
554809,2022-04-10,Bragança Paulista/SP,0,625,0,29472
560406,2022-04-11,Bragança Paulista/SP,0,625,0,29472
566003,2022-04-12,Bragança Paulista/SP,0,625,403,29875
571600,2022-04-13,Bragança Paulista/SP,0,625,397,30272
577197,2022-04-14,Bragança Paulista/SP,0,625,287,30559
582794,2022-04-15,Bragança Paulista/SP,0,625,0,30559
588391,2022-04-16,Bragança Paulista/SP,0,625,0,30559
593988,2022-04-17,Bragança Paulista/SP,0,625,0,30559
599585,2022-04-18,Bragança Paulista/SP,0,625,0,30559
605182,2022-04-19,Bragança Paulista/SP,0,625,0,30559
610779,2022-04-20,Bragança Paulista/SP,0,625,595,31154
616376,2022-04-21,Bragança Paulista/SP,2,627,280,31434
621973,2022-04-22,Bragança Paulista/SP,0,627,0,31434
627570,2022-04-23,Bragança Paulista/SP,0,627,0,31434
633167,2022-04-24,Bragança Paulista/SP,0,627,0,31434
638764,2022-04-25,Bragança Paulista/SP,0,627,0,31434
644361,2022-04-26,Bragança Paulista/SP,0,627,209,31643
649958,2022-04-27,Bragança Paulista/SP,0,627,207,31850
655555,2022-04-28,Bragança Paulista/SP,0,627,114,31964
661152,2022-04-29,Bragança Paulista/SP,0,627,42,32006
666749,2022-04-30,Bragança Paulista/SP,0,627,65,32071
672346,2022-05-01,Bragança Paulista/SP,0,627,-1,32070
677943,2022-05-02,Bragança Paulista/SP,0,627,0,32070
683540,2022-05-03,Bragança Paulista/SP,0,627,214,32284
689137,2022-05-04,Bragança Paulista/SP,0,627,242,32526
694734,2022-05-05,Bragança Paulista/SP,0,627,226,32752
700331,2022-05-06,Bragança Paulista/SP,-1,626,99,32851
705928,2022-05-07,Bragança Paulista/SP,0,626,65,32916
711525,2022-05-08,Bragança Paulista/SP,0,626,0,32916
717122,2022-05-09,Bragança Paulista/SP,0,626,0,32916
722719,2022-05-10,Bragança Paulista/SP,0,626,173,33089
728316,2022-05-11,Bragança Paulista/SP,0,626,215,33304
733913,2022-05-12,Bragança Paulista/SP,0,626,178,33482
739510,2022-05-13,Bragança Paulista/SP,0,626,118,33600
745107,2022-05-14,Bragança Paulista/SP,0,626,119,33719
750704,2022-05-15,Bragança Paulista/SP,0,626,0,33719
756301,2022-05-16,Bragança Paulista/SP,0,626,0,33719
761898,2022-05-17,Bragança Paulista/SP,0,626,68,33787
767495,2022-05-18,Bragança Paulista/SP,0,626,31,33818
773092,2022-05-19,Bragança Paulista/SP,0,626,20,33838
778689,2022-05-20,Bragança Paulista/SP,0,626,0,33838
784286,2022-05-21,Bragança Paulista/SP,0,626,0,33838
789883,2022-05-22,Bragança Paulista/SP,1,627,43,33881
795480,2022-05-23,Bragança Paulista/SP,0,627,0,33881
801077,2022-05-24,Bragança Paulista/SP,0,627,39,33920
806674,2022-05-25,Bragança Paulista/SP,0,627,91,34011
812271,2022-05-26,Bragança Paulista/SP,0,627,28,34039
817868,2022-05-27,Bragança Paulista/SP,0,627,49,34088
823465,2022-05-28,Bragança Paulista/SP,0,627,47,34135
829062,2022-05-29,Bragança Paulista/SP,0,627,0,34135
834659,2022-05-30,Bragança Paulista/SP,0,627,0,34135
840256,2022-05-31,Bragança Paulista/SP,0,627,121,34256
845853,2022-06-01,Bragança Paulista/SP,0,627,65,34321
851450,2022-06-02,Bragança Paulista/SP,0,627,54,34375
857047,2022-06-03,Bragança Paulista/SP,0,627,0,34375
862644,2022-06-04,Bragança Paulista/SP,0,627,0,34375
868241,2022-06-05,Bragança Paulista/SP,0,627,0,34375
873838,2022-06-06,Bragança Paulista/SP,0,627,0,34375
879435,2022-06-07,Bragança Paulista/SP,0,627,189,34564
885032,2022-06-08,Bragança Paulista/SP,0,627,59,34623
890629,2022-06-09,Bragança Paulista/SP,0,627,50,34673
896226,2022-06-10,Bragança Paulista/SP,0,627,69,34742
901823,2022-06-11,Bragança Paulista/SP,0,627,69,34811
907420,2022-06-12,Bragança Paulista/SP,0,627,0,34811
913017,2022-06-13,Bragança Paulista/SP,0,627,0,34811
918614,2022-06-14,Bragança Paulista/SP,0,627,0,34811
924211,2022-06-15,Bragança Paulista/SP,1,628,81,34892
929808,2022-06-16,Bragança Paulista/SP,0,628,84,34976
935405,2022-06-17,Bragança Paulista/SP,0,628,1,34977
941002,2022-06-18,Bragança Paulista/SP,0,628,0,34977
946599,2022-06-19,Bragança Paulista/SP,0,628,0,34977
952196,2022-06-20,Bragança Paulista/SP,0,628,0,34977
957793,2022-06-21,Bragança Paulista/SP,0,628,56,35033
963390,2022-06-22,Bragança Paulista/SP,0,628,91,35124
968987,2022-06-23,Bragança Paulista/SP,0,628,72,35196
974584,2022-06-24,Bragança Paulista/SP,0,628,0,35196
980181,2022-06-25,Bragança Paulista/SP,0,628,125,35321
985778,2022-06-26,Bragança Paulista/SP,0,628,0,35321
991375,2022-06-27,Bragança Paulista/SP,0,628,0,35321
996972,2022-06-28,Bragança Paulista/SP,0,628,40,35361
1002569,2022-06-29,Bragança Paulista/SP,0,628,82,35443
1008166,2022-06-30,Bragança Paulista/SP,0,628,12,35455
1013763,2022-07-01,Bragança Paulista/SP,0,628,0,35455
1019360,2022-07-02,Bragança Paulista/SP,0,628,20,35475
1024957,2022-07-03,Bragança Paulista/SP,0,628,1,35476
1030554,2022-07-04,Bragança Paulista/SP,0,628,0,35476
1036151,2022-07-05,Bragança Paulista/SP,0,628,62,35538
1041748,2022-07-06,Bragança Paulista/SP,2,630,73,35611
1047345,2022-07-07,Bragança Paulista/SP,7,637,86,35697
1052942,2022-07-08,Bragança Paulista/SP,0,637,46,35743
1058539,2022-07-09,Bragança Paulista/SP,0,637,103,35846
1064136,2022-07-10,Bragança Paulista/SP,0,637,0,35846
1069733,2022-07-11,Bragança Paulista/SP,0,637,0,35846
1075330,2022-07-12,Bragança Paulista/SP,0,637,93,35939
1080927,2022-07-13,Bragança Paulista/SP,0,637,129,36068
1086524,2022-07-14,Bragança Paulista/SP,0,637,95,36163
1092121,2022-07-15,Bragança Paulista/SP,0,637,151,36314
1097718,2022-07-16,Bragança Paulista/SP,0,637,90,36404
1103315,2022-07-17,Bragança Paulista/SP,0,637,0,36404
1108912,2022-07-18,Bragança Paulista/SP,0,637,1,36405
1114509,2022-07-19,Bragança Paulista/SP,1,638,77,36482
1120106,2022-07-20,Bragança Paulista/SP,0,638,77,36559
1125703,2022-07-21,Bragança Paulista/SP,0,638,79,36638
1131300,2022-07-22,Bragança Paulista/SP,0,638,71,36709
1136897,2022-07-23,Bragança Paulista/SP,0,638,77,36786
1142494,2022-07-24,Bragança Paulista/SP,0,638,0,36786
1148091,2022-07-25,Bragança Paulista/SP,0,638,0,36786
1153688,2022-07-26,Bragança Paulista/SP,0,638,79,36865
1159285,2022-07-27,Bragança Paulista/SP,0,638,60,36925
1164882,2022-07-28,Bragança Paulista/SP,0,638,122,37047
1170479,2022-07-29,Bragança Paulista/SP,1,639,78,37125
1176076,2022-07-30,Bragança Paulista/SP,0,639,58,37183
1181673,2022-07-31,Bragança Paulista/SP,0,639,0,37183
1187270,2022-08-01,Bragança Paulista/SP,0,639,0,37183
1192867,2022-08-02,Bragança Paulista/SP,0,639,69,37252
1198464,2022-08-03,Bragança Paulista/SP,0,639,74,37326
1204061,2022-08-04,Bragança Paulista/SP,0,639,83,37409
1209658,2022-08-05,Bragança Paulista/SP,0,639,82,37491
1215255,2022-08-06,Bragança Paulista/SP,0,639,19,37510
1220852,2022-08-07,Bragança Paulista/SP,0,639,0,37510
1226449,2022-08-08,Bragança Paulista/SP,0,639,0,37510
1232046,2022-08-09,Bragança Paulista/SP,0,639,68,37578
1237643,2022-08-10,Bragança Paulista/SP,0,639,75,37653
1243240,2022-08-11,Bragança Paulista/SP,0,639,178,37831
1248837,2022-08-12,Bragança Paulista/SP,0,639,219,38050
1254434,2022-08-13,Bragança Paulista/SP,0,639,266,38316
1260031,2022-08-14,Bragança Paulista/SP,0,639,0,38316
1265628,2022-08-15,Bragança Paulista/SP,0,639,0,38316
1271225,2022-08-16,Bragança Paulista/SP,0,639,263,38579
1276822,2022-08-17,Bragança Paulista/SP,0,639,175,38754
1282419,2022-08-18,Bragança Paulista/SP,0,639,231,38985
1288016,2022-08-19,Bragança Paulista/SP,0,639,160,39145
1293613,2022-08-20,Bragança Paulista/SP,0,639,133,39278
1299210,2022-08-21,Bragança Paulista/SP,0,639,0,39278
1304807,2022-08-22,Bragança Paulista/SP,0,639,0,39278
1310404,2022-08-23,Bragança Paulista/SP,-2,637,217,39495
1316001,2022-08-24,Bragança Paulista/SP,0,637,238,39733
1321598,2022-08-25,Bragança Paulista/SP,0,637,323,40056
2624,2022-01-01,Jundiaí/SP,0,1616,0,55635
8221,2022-01-02,Jundiaí/SP,0,1616,0,55635
13818,2022-01-03,Jundiaí/SP,0,1616,-2,55633
19415,2022-01-04,Jundiaí/SP,0,1616,21,55654
25012,2022-01-05,Jundiaí/SP,0,1616,29,55683
30609,2022-01-06,Jundiaí/SP,0,1616,1,55684
36206,2022-01-07,Jundiaí/SP,0,1616,4,55688
41803,2022-01-08,Jundiaí/SP,0,1616,1,55689
47400,2022-01-09,Jundiaí/SP,0,1616,0,55689
52997,2022-01-10,Jundiaí/SP,0,1616,0,55689
58594,2022-01-11,Jundiaí/SP,1,1617,2,55691
64191,2022-01-12,Jundiaí/SP,0,1617,139,55830
69788,2022-01-13,Jundiaí/SP,1,1618,158,55988
75385,2022-01-14,Jundiaí/SP,0,1618,-9,55979
80982,2022-01-15,Jundiaí/SP,0,1618,0,55979
86579,2022-01-16,Jundiaí/SP,0,1618,0,55979
92176,2022-01-17,Jundiaí/SP,0,1618,0,55979
97773,2022-01-18,Jundiaí/SP,3,1621,9,55988
103370,2022-01-19,Jundiaí/SP,0,1621,15,56003
108967,2022-01-20,Jundiaí/SP,0,1621,9,56012
114564,2022-01-21,Jundiaí/SP,0,1621,433,56445
120161,2022-01-22,Jundiaí/SP,0,1621,0,56445
125758,2022-01-23,Jundiaí/SP,7,1628,41,56486
131355,2022-01-24,Jundiaí/SP,0,1628,0,56486
136952,2022-01-25,Jundiaí/SP,0,1628,5,56491
142549,2022-01-26,Jundiaí/SP,0,1628,99,56590
148146,2022-01-27,Jundiaí/SP,13,1641,671,57261
153743,2022-01-28,Jundiaí/SP,2,1643,31,57292
159340,2022-01-29,Jundiaí/SP,3,1646,131,57423
164937,2022-01-30,Jundiaí/SP,1,1647,17,57440
170534,2022-01-31,Jundiaí/SP,0,1647,0,57440
176131,2022-02-01,Jundiaí/SP,7,1654,420,57860
181728,2022-02-02,Jundiaí/SP,5,1659,4,57864
187325,2022-02-03,Jundiaí/SP,0,1659,973,58837
192922,2022-02-04,Jundiaí/SP,0,1659,0,58837
198519,2022-02-05,Jundiaí/SP,12,1671,945,59782
204116,2022-02-06,Jundiaí/SP,5,1676,52,59834
209713,2022-02-07,Jundiaí/SP,0,1676,1,59835
215310,2022-02-08,Jundiaí/SP,3,1679,402,60237
220907,2022-02-09,Jundiaí/SP,3,1682,360,60597
226504,2022-02-10,Jundiaí/SP,5,1687,268,60865
232101,2022-02-11,Jundiaí/SP,3,1690,739,61604
237698,2022-02-12,Jundiaí/SP,0,1690,40,61644
243295,2022-02-13,Jundiaí/SP,3,1693,12,61656
248892,2022-02-14,Jundiaí/SP,0,1693,0,61656
254489,2022-02-15,Jundiaí/SP,9,1702,1,61657
260086,2022-02-16,Jundiaí/SP,0,1702,7,61664
265683,2022-02-17,Jundiaí/SP,1,1703,9,61673
271280,2022-02-18,Jundiaí/SP,0,1703,4,61677
276877,2022-02-19,Jundiaí/SP,12,1715,6,61683
282474,2022-02-20,Jundiaí/SP,1,1716,5,61688
288071,2022-02-21,Jundiaí/SP,0,1716,0,61688
293668,2022-02-22,Jundiaí/SP,5,1721,4,61692
299265,2022-02-23,Jundiaí/SP,1,1722,0,61692
304862,2022-02-24,Jundiaí/SP,1,1723,4,61696
310459,2022-02-25,Jundiaí/SP,1,1724,9,61705
316056,2022-02-26,Jundiaí/SP,2,1726,-2,61703
321653,2022-02-27,Jundiaí/SP,0,1726,2,61705
327250,2022-02-28,Jundiaí/SP,0,1726,0,61705
332847,2022-03-01,Jundiaí/SP,0,1726,1,61706
338444,2022-03-02,Jundiaí/SP,0,1726,1,61707
344041,2022-03-03,Jundiaí/SP,0,1726,629,62336
349638,2022-03-04,Jundiaí/SP,4,1730,2,62338
355235,2022-03-05,Jundiaí/SP,1,1731,235,62573
360832,2022-03-06,Jundiaí/SP,0,1731,0,62573
366429,2022-03-07,Jundiaí/SP,0,1731,0,62573
372026,2022-03-08,Jundiaí/SP,0,1731,802,63375
377623,2022-03-09,Jundiaí/SP,5,1736,8,63383
383220,2022-03-10,Jundiaí/SP,1,1737,95,63478
388817,2022-03-11,Jundiaí/SP,0,1737,507,63985
394414,2022-03-12,Jundiaí/SP,1,1738,422,64407
400011,2022-03-13,Jundiaí/SP,0,1738,0,64407
405608,2022-03-14,Jundiaí/SP,0,1738,0,64407
411205,2022-03-15,Jundiaí/SP,0,1738,371,64778
416802,2022-03-16,Jundiaí/SP,1,1739,62,64840
422399,2022-03-17,Jundiaí/SP,1,1740,470,65310
427996,2022-03-18,Jundiaí/SP,0,1740,509,65819
433593,2022-03-19,Jundiaí/SP,3,1743,332,66151
439190,2022-03-20,Jundiaí/SP,0,1743,2,66153
444787,2022-03-21,Jundiaí/SP,0,1743,1,66154
450384,2022-03-22,Jundiaí/SP,2,1745,188,66342
455981,2022-03-23,Jundiaí/SP,0,1745,271,66613
461578,2022-03-24,Jundiaí/SP,0,1745,235,66848
467175,2022-03-25,Jundiaí/SP,1,1746,362,67210
472772,2022-03-26,Jundiaí/SP,0,1746,3,67213
478369,2022-03-27,Jundiaí/SP,0,1746,1,67214
483966,2022-03-28,Jundiaí/SP,0,1746,0,67214
489563,2022-03-29,Jundiaí/SP,0,1746,2,67216
495160,2022-03-30,Jundiaí/SP,0,1746,1,67217
500757,2022-03-31,Jundiaí/SP,0,1746,414,67631
506354,2022-04-01,Jundiaí/SP,0,1746,23,67654
511951,2022-04-02,Jundiaí/SP,0,1746,62,67716
517548,2022-04-03,Jundiaí/SP,0,1746,0,67716
523145,2022-04-04,Jundiaí/SP,0,1746,0,67716
528742,2022-04-05,Jundiaí/SP,2,1748,2,67718
534339,2022-04-06,Jundiaí/SP,0,1748,263,67981
539936,2022-04-07,Jundiaí/SP,0,1748,464,68445
545533,2022-04-08,Jundiaí/SP,0,1748,5,68450
551130,2022-04-09,Jundiaí/SP,0,1748,4,68454
556727,2022-04-10,Jundiaí/SP,0,1748,0,68454
562324,2022-04-11,Jundiaí/SP,0,1748,0,68454
567921,2022-04-12,Jundiaí/SP,0,1748,1,68455
573518,2022-04-13,Jundiaí/SP,0,1748,0,68455
579115,2022-04-14,Jundiaí/SP,0,1748,0,68455
584712,2022-04-15,Jundiaí/SP,0,1748,1,68456
590309,2022-04-16,Jundiaí/SP,0,1748,0,68456
595906,2022-04-17,Jundiaí/SP,0,1748,0,68456
601503,2022-04-18,Jundiaí/SP,0,1748,2,68458
607100,2022-04-19,Jundiaí/SP,0,1748,0,68458
612697,2022-04-20,Jundiaí/SP,0,1748,309,68767
618294,2022-04-21,Jundiaí/SP,0,1748,229,68996
623891,2022-04-22,Jundiaí/SP,0,1748,0,68996
629488,2022-04-23,Jundiaí/SP,0,1748,0,68996
635085,2022-04-24,Jundiaí/SP,0,1748,0,68996
640682,2022-04-25,Jundiaí/SP,0,1748,0,68996
646279,2022-04-26,Jundiaí/SP,0,1748,4,69000
651876,2022-04-27,Jundiaí/SP,0,1748,3,69003
657473,2022-04-28,Jundiaí/SP,0,1748,5,69008
663070,2022-04-29,Jundiaí/SP,1,1749,29,69037
668667,2022-04-30,Jundiaí/SP,0,1749,3,69040
674264,2022-05-01,Jundiaí/SP,1,1750,1,69041
679861,2022-05-02,Jundiaí/SP,0,1750,0,69041
685458,2022-05-03,Jundiaí/SP,0,1750,233,69274
691055,2022-05-04,Jundiaí/SP,1,1751,80,69354
696652,2022-05-05,Jundiaí/SP,0,1751,0,69354
702249,2022-05-06,Jundiaí/SP,0,1751,1,69355
707846,2022-05-07,Jundiaí/SP,0,1751,0,69355
713443,2022-05-08,Jundiaí/SP,0,1751,-1,69354
719040,2022-05-09,Jundiaí/SP,0,1751,0,69354
724637,2022-05-10,Jundiaí/SP,0,1751,3,69357
730234,2022-05-11,Jundiaí/SP,0,1751,0,69357
735831,2022-05-12,Jundiaí/SP,0,1751,-12,69345
741428,2022-05-13,Jundiaí/SP,4,1755,3,69348
747025,2022-05-14,Jundiaí/SP,0,1755,146,69494
752622,2022-05-15,Jundiaí/SP,0,1755,0,69494
758219,2022-05-16,Jundiaí/SP,0,1755,0,69494
763816,2022-05-17,Jundiaí/SP,1,1756,382,69876
769413,2022-05-18,Jundiaí/SP,0,1756,1,69877
775010,2022-05-19,Jundiaí/SP,0,1756,14,69891
780607,2022-05-20,Jundiaí/SP,0,1756,0,69891
786204,2022-05-21,Jundiaí/SP,0,1756,0,69891
791801,2022-05-22,Jundiaí/SP,1,1757,2,69893
797398,2022-05-23,Jundiaí/SP,0,1757,0,69893
802995,2022-05-24,Jundiaí/SP,1,1758,2,69895
808592,2022-05-25,Jundiaí/SP,0,1758,5,69900
814189,2022-05-26,Jundiaí/SP,0,1758,16,69916
819786,2022-05-27,Jundiaí/SP,0,1758,2,69918
825383,2022-05-28,Jundiaí/SP,0,1758,106,70024
830980,2022-05-29,Jundiaí/SP,0,1758,1,70025
836577,2022-05-30,Jundiaí/SP,0,1758,0,70025
842174,2022-05-31,Jundiaí/SP,0,1758,2,70027
847771,2022-06-01,Jundiaí/SP,0,1758,149,70176
853368,2022-06-02,Jundiaí/SP,0,1758,120,70296
858965,2022-06-03,Jundiaí/SP,0,1758,0,70296
864562,2022-06-04,Jundiaí/SP,0,1758,0,70296
870159,2022-06-05,Jundiaí/SP,0,1758,0,70296
875756,2022-06-06,Jundiaí/SP,0,1758,0,70296
881353,2022-06-07,Jundiaí/SP,1,1759,485,70781
886950,2022-06-08,Jundiaí/SP,1,1760,2,70783
892547,2022-06-09,Jundiaí/SP,0,1760,2,70785
898144,2022-06-10,Jundiaí/SP,1,1761,3,70788
903741,2022-06-11,Jundiaí/SP,0,1761,19,70807
909338,2022-06-12,Jundiaí/SP,0,1761,0,70807
914935,2022-06-13,Jundiaí/SP,0,1761,0,70807
920532,2022-06-14,Jundiaí/SP,0,1761,0,70807
926129,2022-06-15,Jundiaí/SP,0,1761,14,70821
931726,2022-06-16,Jundiaí/SP,0,1761,3,70824
937323,2022-06-17,Jundiaí/SP,0,1761,0,70824
942920,2022-06-18,Jundiaí/SP,0,1761,1,70825
948517,2022-06-19,Jundiaí/SP,0,1761,0,70825
954114,2022-06-20,Jundiaí/SP,0,1761,0,70825
959711,2022-06-21,Jundiaí/SP,4,1765,6,70831
965308,2022-06-22,Jundiaí/SP,0,1765,0,70831
970905,2022-06-23,Jundiaí/SP,0,1765,21,70852
976502,2022-06-24,Jundiaí/SP,2,1767,2,70854
982099,2022-06-25,Jundiaí/SP,3,1770,19,70873
987696,2022-06-26,Jundiaí/SP,0,1770,0,70873
993293,2022-06-27,Jundiaí/SP,0,1770,0,70873
998890,2022-06-28,Jundiaí/SP,0,1770,1,70874
1004487,2022-06-29,Jundiaí/SP,1,1771,19,70893
1010084,2022-06-30,Jundiaí/SP,2,1773,7,70900
1015681,2022-07-01,Jundiaí/SP,1,1774,409,71309
1021278,2022-07-02,Jundiaí/SP,0,1774,4,71313
1026875,2022-07-03,Jundiaí/SP,0,1774,0,71313
1032472,2022-07-04,Jundiaí/SP,0,1774,0,71313
1038069,2022-07-05,Jundiaí/SP,1,1775,60,71373
1043666,2022-07-06,Jundiaí/SP,1,1776,8,71381
1049263,2022-07-07,Jundiaí/SP,0,1776,310,71691
1054860,2022-07-08,Jundiaí/SP,0,1776,731,72422
1060457,2022-07-09,Jundiaí/SP,1,1777,775,73197
1066054,2022-07-10,Jundiaí/SP,0,1777,0,73197
1071651,2022-07-11,Jundiaí/SP,0,1777,0,73197
1077248,2022-07-12,Jundiaí/SP,3,1780,10,73207
1082845,2022-07-13,Jundiaí/SP,1,1781,1,73208
1088442,2022-07-14,Jundiaí/SP,2,1783,531,73739
1094039,2022-07-15,Jundiaí/SP,0,1783,248,73987
1099636,2022-07-16,Jundiaí/SP,1,1784,5,73992
1105233,2022-07-17,Jundiaí/SP,0,1784,0,73992
1110830,2022-07-18,Jundiaí/SP,0,1784,0,73992
1116427,2022-07-19,Jundiaí/SP,1,1785,12,74004
1122024,2022-07-20,Jundiaí/SP,1,1786,1,74005
1127621,2022-07-21,Jundiaí/SP,0,1786,1,74006
1133218,2022-07-22,Jundiaí/SP,0,1786,5,74011
1138815,2022-07-23,Jundiaí/SP,2,1788,9,74020
1144412,2022-07-24,Jundiaí/SP,0,1788,0,74020
1150009,2022-07-25,Jundiaí/SP,0,1788,0,74020
1155606,2022-07-26,Jundiaí/SP,5,1793,8,74028
1161203,2022-07-27,Jundiaí/SP,0,1793,1,74029
1166800,2022-07-28,Jundiaí/SP,0,1793,1,74030
1172397,2022-07-29,Jundiaí/SP,0,1793,2,74032
1177994,2022-07-30,Jundiaí/SP,0,1793,3,74035
1183591,2022-07-31,Jundiaí/SP,0,1793,0,74035
1189188,2022-08-01,Jundiaí/SP,0,1793,0,74035
1194785,2022-08-02,Jundiaí/SP,2,1795,3,74038
1200382,2022-08-03,Jundiaí/SP,0,1795,2,74040
1205979,2022-08-04,Jundiaí/SP,0,1795,3,74043
1211576,2022-08-05,Jundiaí/SP,0,1795,1,74044
1217173,2022-08-06,Jundiaí/SP,1,1796,5,74049
1222770,2022-08-07,Jundiaí/SP,0,1796,0,74049
1228367,2022-08-08,Jundiaí/SP,0,1796,0,74049
1233964,2022-08-09,Jundiaí/SP,1,1797,0,74049
1239561,2022-08-10,Jundiaí/SP,0,1797,3,74052
1245158,2022-08-11,Jundiaí/SP,0,1797,2,74054
1250755,2022-08-12,Jundiaí/SP,0,1797,0,74054
1256352,2022-08-13,Jundiaí/SP,2,1799,4,74058
1261949,2022-08-14,Jundiaí/SP,0,1799,0,74058
1267546,2022-08-15,Jundiaí/SP,0,1799,0,74058
1273143,2022-08-16,Jundiaí/SP,0,1799,0,74058
1278740,2022-08-17,Jundiaí/SP,0,1799,0,74058
1284337,2022-08-18,Jundiaí/SP,0,1799,3,74061
1289934,2022-08-19,Jundiaí/SP,1,1800,3,74064
1295531,2022-08-20,Jundiaí/SP,0,1800,3,74067
1301128,2022-08-21,Jundiaí/SP,0,1800,1,74068
1306725,2022-08-22,Jundiaí/SP,0,1800,0,74068
1312322,2022-08-23,Jundiaí/SP,1,1801,5,74073
1317919,2022-08-24,Jundiaí/SP,-2,1799,-2,74071
1323516,2022-08-25,Jundiaí/SP,0,1799,-4,74067
2020,2022-01-01,Guarulhos/SP,0,5023,-1,66043
7617,2022-01-02,Guarulhos/SP,0,5023,1,66044
13214,2022-01-03,Guarulhos/SP,0,5023,1,66045
18811,2022-01-04,Guarulhos/SP,0,5023,20,66065
24408,2022-01-05,Guarulhos/SP,1,5024,15,66080
30005,2022-01-06,Guarulhos/SP,3,5027,27,66107
35602,2022-01-07,Guarulhos/SP,0,5027,25,66132
41199,2022-01-08,Guarulhos/SP,0,5027,13,66145
46796,2022-01-09,Guarulhos/SP,0,5027,2,66147
52393,2022-01-10,Guarulhos/SP,0,5027,1,66148
57990,2022-01-11,Guarulhos/SP,1,5028,25,66173
63587,2022-01-12,Guarulhos/SP,4,5032,22,66195
69184,2022-01-13,Guarulhos/SP,2,5034,17,66212
74781,2022-01-14,Guarulhos/SP,24,5058,43,66255
80378,2022-01-15,Guarulhos/SP,10,5068,27,66282
85975,2022-01-16,Guarulhos/SP,2,5070,6,66288
91572,2022-01-17,Guarulhos/SP,0,5070,1,66289
97169,2022-01-18,Guarulhos/SP,5,5075,123,66412
102766,2022-01-19,Guarulhos/SP,1,5076,97,66509
108363,2022-01-20,Guarulhos/SP,1,5077,51,66560
113960,2022-01-21,Guarulhos/SP,7,5084,48,66608
119557,2022-01-22,Guarulhos/SP,0,5084,0,66608
125154,2022-01-23,Guarulhos/SP,3,5087,44,66652
130751,2022-01-24,Guarulhos/SP,3,5090,3,66655
136348,2022-01-25,Guarulhos/SP,10,5100,54,66709
141945,2022-01-26,Guarulhos/SP,1,5101,17,66726
147542,2022-01-27,Guarulhos/SP,6,5107,51,66777
153139,2022-01-28,Guarulhos/SP,2,5109,46,66823
158736,2022-01-29,Guarulhos/SP,4,5113,40,66863
164333,2022-01-30,Guarulhos/SP,0,5113,4,66867
169930,2022-01-31,Guarulhos/SP,0,5113,0,66867
175527,2022-02-01,Guarulhos/SP,7,5120,53,66920
181124,2022-02-02,Guarulhos/SP,8,5128,27,66947
186721,2022-02-03,Guarulhos/SP,10,5138,68,67015
192318,2022-02-04,Guarulhos/SP,0,5138,0,67015
197915,2022-02-05,Guarulhos/SP,31,5169,103,67118
203512,2022-02-06,Guarulhos/SP,0,5169,7,67125
209109,2022-02-07,Guarulhos/SP,0,5169,2,67127
214706,2022-02-08,Guarulhos/SP,8,5177,27,67154
220303,2022-02-09,Guarulhos/SP,8,5185,28,67182
225900,2022-02-10,Guarulhos/SP,6,5191,34,67216
231497,2022-02-11,Guarulhos/SP,8,5199,45,67261
237094,2022-02-12,Guarulhos/SP,4,5203,25,67286
242691,2022-02-13,Guarulhos/SP,0,5203,3,67289
248288,2022-02-14,Guarulhos/SP,0,5203,2,67291
253885,2022-02-15,Guarulhos/SP,6,5209,32,67323
259482,2022-02-16,Guarulhos/SP,9,5218,30,67353
265079,2022-02-17,Guarulhos/SP,12,5230,33,67386
270676,2022-02-18,Guarulhos/SP,11,5241,18,67404
276273,2022-02-19,Guarulhos/SP,17,5258,32,67436
281870,2022-02-20,Guarulhos/SP,0,5258,7,67443
287467,2022-02-21,Guarulhos/SP,0,5258,3,67446
293064,2022-02-22,Guarulhos/SP,6,5264,91,67537
298661,2022-02-23,Guarulhos/SP,10,5274,297,67834
304258,2022-02-24,Guarulhos/SP,18,5292,97,67931
309855,2022-02-25,Guarulhos/SP,1,5293,205,68136
315452,2022-02-26,Guarulhos/SP,2,5295,256,68392
321049,2022-02-27,Guarulhos/SP,0,5295,319,68711
326646,2022-02-28,Guarulhos/SP,0,5295,2,68713
332243,2022-03-01,Guarulhos/SP,3,5298,81,68794
337840,2022-03-02,Guarulhos/SP,0,5298,43,68837
343437,2022-03-03,Guarulhos/SP,1,5299,187,69024
349034,2022-03-04,Guarulhos/SP,0,5299,134,69158
354631,2022-03-05,Guarulhos/SP,5,5304,336,69494
360228,2022-03-06,Guarulhos/SP,0,5304,99,69593
365825,2022-03-07,Guarulhos/SP,0,5304,0,69593
371422,2022-03-08,Guarulhos/SP,4,5308,174,69767
377019,2022-03-09,Guarulhos/SP,9,5317,72,69839
382616,2022-03-10,Guarulhos/SP,5,5322,47,69886
388213,2022-03-11,Guarulhos/SP,6,5328,74,69960
393810,2022-03-12,Guarulhos/SP,2,5330,98,70058
399407,2022-03-13,Guarulhos/SP,0,5330,0,70058
405004,2022-03-14,Guarulhos/SP,1,5331,7,70065
410601,2022-03-15,Guarulhos/SP,2,5333,287,70352
416198,2022-03-16,Guarulhos/SP,7,5340,26,70378
421795,2022-03-17,Guarulhos/SP,4,5344,29,70407
427392,2022-03-18,Guarulhos/SP,1,5345,96,70503
432989,2022-03-19,Guarulhos/SP,1,5346,41,70544
438586,2022-03-20,Guarulhos/SP,0,5346,107,70651
444183,2022-03-21,Guarulhos/SP,0,5346,180,70831
449780,2022-03-22,Guarulhos/SP,0,5346,206,71037
455377,2022-03-23,Guarulhos/SP,7,5353,121,71158
460974,2022-03-24,Guarulhos/SP,12,5365,58,71216
466571,2022-03-25,Guarulhos/SP,3,5368,166,71382
472168,2022-03-26,Guarulhos/SP,3,5371,150,71532
477765,2022-03-27,Guarulhos/SP,0,5371,0,71532
483362,2022-03-28,Guarulhos/SP,0,5371,0,71532
488959,2022-03-29,Guarulhos/SP,1,5372,95,71627
494556,2022-03-30,Guarulhos/SP,3,5375,12,71639
500153,2022-03-31,Guarulhos/SP,-3,5372,29,71668
505750,2022-04-01,Guarulhos/SP,0,5372,390,72058
511347,2022-04-02,Guarulhos/SP,3,5375,302,72360
516944,2022-04-03,Guarulhos/SP,0,5375,0,72360
522541,2022-04-04,Guarulhos/SP,0,5375,128,72488
528138,2022-04-05,Guarulhos/SP,0,5375,83,72571
533735,2022-04-06,Guarulhos/SP,2,5377,307,72878
539332,2022-04-07,Guarulhos/SP,0,5377,138,73016
544929,2022-04-08,Guarulhos/SP,0,5377,362,73378
550526,2022-04-09,Guarulhos/SP,0,5377,445,73823
556123,2022-04-10,Guarulhos/SP,0,5377,184,74007
561720,2022-04-11,Guarulhos/SP,0,5377,303,74310
567317,2022-04-12,Guarulhos/SP,1,5378,1120,75430
572914,2022-04-13,Guarulhos/SP,0,5378,1055,76485
578511,2022-04-14,Guarulhos/SP,0,5378,668,77153
584108,2022-04-15,Guarulhos/SP,0,5378,517,77670
589705,2022-04-16,Guarulhos/SP,0,5378,145,77815
595302,2022-04-17,Guarulhos/SP,0,5378,0,77815
600899,2022-04-18,Guarulhos/SP,1,5379,261,78076
606496,2022-04-19,Guarulhos/SP,0,5379,0,78076
612093,2022-04-20,Guarulhos/SP,1,5380,1412,79488
617690,2022-04-21,Guarulhos/SP,1,5381,605,80093
623287,2022-04-22,Guarulhos/SP,0,5381,14,80107
628884,2022-04-23,Guarulhos/SP,0,5381,1,80108
634481,2022-04-24,Guarulhos/SP,0,5381,-1,80107
640078,2022-04-25,Guarulhos/SP,0,5381,3,80110
645675,2022-04-26,Guarulhos/SP,2,5383,330,80440
651272,2022-04-27,Guarulhos/SP,0,5383,87,80527
656869,2022-04-28,Guarulhos/SP,0,5383,78,80605
662466,2022-04-29,Guarulhos/SP,0,5383,50,80655
668063,2022-04-30,Guarulhos/SP,0,5383,294,80949
673660,2022-05-01,Guarulhos/SP,0,5383,74,81023
679257,2022-05-02,Guarulhos/SP,0,5383,1,81024
684854,2022-05-03,Guarulhos/SP,3,5386,107,81131
690451,2022-05-04,Guarulhos/SP,1,5387,202,81333
696048,2022-05-05,Guarulhos/SP,1,5388,124,81457
701645,2022-05-06,Guarulhos/SP,1,5389,131,81588
707242,2022-05-07,Guarulhos/SP,0,5389,316,81904
712839,2022-05-08,Guarulhos/SP,0,5389,1,81905
718436,2022-05-09,Guarulhos/SP,0,5389,0,81905
724033,2022-05-10,Guarulhos/SP,1,5390,138,82043
729630,2022-05-11,Guarulhos/SP,0,5390,0,82043
735227,2022-05-12,Guarulhos/SP,-7,5383,77,82120
740824,2022-05-13,Guarulhos/SP,2,5385,200,82320
746421,2022-05-14,Guarulhos/SP,2,5387,31,82351
752018,2022-05-15,Guarulhos/SP,0,5387,-1,82350
757615,2022-05-16,Guarulhos/SP,0,5387,0,82350
763212,2022-05-17,Guarulhos/SP,0,5387,57,82407
768809,2022-05-18,Guarulhos/SP,0,5387,2,82409
774406,2022-05-19,Guarulhos/SP,1,5388,2,82411
780003,2022-05-20,Guarulhos/SP,0,5388,0,82411
785600,2022-05-21,Guarulhos/SP,0,5388,0,82411
791197,2022-05-22,Guarulhos/SP,-1,5387,9,82420
796794,2022-05-23,Guarulhos/SP,0,5387,0,82420
802391,2022-05-24,Guarulhos/SP,4,5391,-1,82419
807988,2022-05-25,Guarulhos/SP,-2,5389,8,82427
813585,2022-05-26,Guarulhos/SP,1,5390,13,82440
819182,2022-05-27,Guarulhos/SP,1,5391,31,82471
824779,2022-05-28,Guarulhos/SP,0,5391,82,82553
830376,2022-05-29,Guarulhos/SP,0,5391,1,82554
835973,2022-05-30,Guarulhos/SP,0,5391,76,82630
841570,2022-05-31,Guarulhos/SP,0,5391,81,82711
847167,2022-06-01,Guarulhos/SP,0,5391,5,82716
852764,2022-06-02,Guarulhos/SP,5,5396,13,82729
858361,2022-06-03,Guarulhos/SP,0,5396,0,82729
863958,2022-06-04,Guarulhos/SP,0,5396,0,82729
869555,2022-06-05,Guarulhos/SP,0,5396,0,82729
875152,2022-06-06,Guarulhos/SP,0,5396,0,82729
880749,2022-06-07,Guarulhos/SP,0,5396,36,82765
886346,2022-06-08,Guarulhos/SP,-1,5395,32,82797
891943,2022-06-09,Guarulhos/SP,1,5396,81,82878
897540,2022-06-10,Guarulhos/SP,2,5398,33,82911
903137,2022-06-11,Guarulhos/SP,1,5399,3,82914
908734,2022-06-12,Guarulhos/SP,1,5400,1,82915
914331,2022-06-13,Guarulhos/SP,0,5400,0,82915
919928,2022-06-14,Guarulhos/SP,0,5400,0,82915
925525,2022-06-15,Guarulhos/SP,4,5404,35,82950
931122,2022-06-16,Guarulhos/SP,1,5405,83,83033
936719,2022-06-17,Guarulhos/SP,0,5405,64,83097
942316,2022-06-18,Guarulhos/SP,0,5405,5,83102
947913,2022-06-19,Guarulhos/SP,0,5405,1,83103
953510,2022-06-20,Guarulhos/SP,0,5405,0,83103
959107,2022-06-21,Guarulhos/SP,1,5406,42,83145
964704,2022-06-22,Guarulhos/SP,0,5406,111,83256
970301,2022-06-23,Guarulhos/SP,3,5409,44,83300
975898,2022-06-24,Guarulhos/SP,3,5412,14,83314
981495,2022-06-25,Guarulhos/SP,3,5415,17,83331
987092,2022-06-26,Guarulhos/SP,0,5415,2,83333
992689,2022-06-27,Guarulhos/SP,0,5415,2,83335
998286,2022-06-28,Guarulhos/SP,3,5418,34,83369
1003883,2022-06-29,Guarulhos/SP,1,5419,16,83385
1009480,2022-06-30,Guarulhos/SP,1,5420,27,83412
1015077,2022-07-01,Guarulhos/SP,0,5420,37,83449
1020674,2022-07-02,Guarulhos/SP,2,5422,47,83496
1026271,2022-07-03,Guarulhos/SP,1,5423,2,83498
1031868,2022-07-04,Guarulhos/SP,0,5423,2,83500
1037465,2022-07-05,Guarulhos/SP,1,5424,56,83556
1043062,2022-07-06,Guarulhos/SP,2,5426,37,83593
1048659,2022-07-07,Guarulhos/SP,1,5427,19,83612
1054256,2022-07-08,Guarulhos/SP,0,5427,16,83628
1059853,2022-07-09,Guarulhos/SP,2,5429,59,83687
1065450,2022-07-10,Guarulhos/SP,0,5429,14,83701
1071047,2022-07-11,Guarulhos/SP,0,5429,0,83701
1076644,2022-07-12,Guarulhos/SP,4,5433,42,83743
1082241,2022-07-13,Guarulhos/SP,0,5433,11,83754
1087838,2022-07-14,Guarulhos/SP,0,5433,31,83785
1093435,2022-07-15,Guarulhos/SP,3,5436,72,83857
1099032,2022-07-16,Guarulhos/SP,2,5438,21,83878
1104629,2022-07-17,Guarulhos/SP,0,5438,3,83881
1110226,2022-07-18,Guarulhos/SP,0,5438,0,83881
1115823,2022-07-19,Guarulhos/SP,1,5439,12,83893
1121420,2022-07-20,Guarulhos/SP,1,5440,27,83920
1127017,2022-07-21,Guarulhos/SP,5,5445,17,83937
1132614,2022-07-22,Guarulhos/SP,5,5450,11,83948
1138211,2022-07-23,Guarulhos/SP,0,5450,35,83983
1143808,2022-07-24,Guarulhos/SP,0,5450,3,83986
1149405,2022-07-25,Guarulhos/SP,0,5450,1,83987
1155002,2022-07-26,Guarulhos/SP,3,5453,23,84010
1160599,2022-07-27,Guarulhos/SP,0,5453,4,84014
1166196,2022-07-28,Guarulhos/SP,0,5453,2,84016
1171793,2022-07-29,Guarulhos/SP,1,5454,13,84029
1177390,2022-07-30,Guarulhos/SP,3,5457,16,84045
1182987,2022-07-31,Guarulhos/SP,0,5457,0,84045
1188584,2022-08-01,Guarulhos/SP,0,5457,0,84045
1194181,2022-08-02,Guarulhos/SP,2,5459,16,84061
1199778,2022-08-03,Guarulhos/SP,1,5460,7,84068
1205375,2022-08-04,Guarulhos/SP,0,5460,12,84080
1210972,2022-08-05,Guarulhos/SP,6,5466,6,84086
1216569,2022-08-06,Guarulhos/SP,4,5470,16,84102
1222166,2022-08-07,Guarulhos/SP,0,5470,5,84107
1227763,2022-08-08,Guarulhos/SP,0,5470,0,84107
1233360,2022-08-09,Guarulhos/SP,0,5470,10,84117
1238957,2022-08-10,Guarulhos/SP,6,5476,11,84128
1244554,2022-08-11,Guarulhos/SP,1,5477,10,84138
1250151,2022-08-12,Guarulhos/SP,12,5489,17,84155
1255748,2022-08-13,Guarulhos/SP,7,5496,16,84171
1261345,2022-08-14,Guarulhos/SP,1,5497,1,84172
1266942,2022-08-15,Guarulhos/SP,0,5497,2,84174
1272539,2022-08-16,Guarulhos/SP,1,5498,22,84196
1278136,2022-08-17,Guarulhos/SP,0,5498,2,84198
1283733,2022-08-18,Guarulhos/SP,1,5499,7,84205
1289330,2022-08-19,Guarulhos/SP,3,5502,11,84216
1294927,2022-08-20,Guarulhos/SP,2,5504,6,84222
1300524,2022-08-21,Guarulhos/SP,1,5505,10,84232
1306121,2022-08-22,Guarulhos/SP,0,5505,8,84240
1311718,2022-08-23,Guarulhos/SP,2,5507,14,84254
1317315,2022-08-24,Guarulhos/SP,0,5507,14,84268
1322912,2022-08-25,Guarulhos/SP,0,5507,2,84270
3456,2022-01-01,Osasco/SP,1,2717,4,46280
9053,2022-01-02,Osasco/SP,0,2717,0,46280
14650,2022-01-03,Osasco/SP,0,2717,0,46280
20247,2022-01-04,Osasco/SP,0,2717,1,46281
25844,2022-01-05,Osasco/SP,2,2719,21,46302
31441,2022-01-06,Osasco/SP,2,2721,20,46322
37038,2022-01-07,Osasco/SP,2,2723,19,46341
42635,2022-01-08,Osasco/SP,0,2723,20,46361
48232,2022-01-09,Osasco/SP,0,2723,3,46364
53829,2022-01-10,Osasco/SP,2,2725,22,46386
59426,2022-01-11,Osasco/SP,1,2726,19,46405
65023,2022-01-12,Osasco/SP,2,2728,6,46411
70620,2022-01-13,Osasco/SP,0,2728,17,46428
76217,2022-01-14,Osasco/SP,2,2730,38,46466
81814,2022-01-15,Osasco/SP,0,2730,8,46474
87411,2022-01-16,Osasco/SP,0,2730,4,46478
93008,2022-01-17,Osasco/SP,1,2731,5,46483
98605,2022-01-18,Osasco/SP,2,2733,12,46495
104202,2022-01-19,Osasco/SP,12,2745,12,46507
109799,2022-01-20,Osasco/SP,10,2755,12,46519
115396,2022-01-21,Osasco/SP,6,2761,23,46542
120993,2022-01-22,Osasco/SP,0,2761,0,46542
126590,2022-01-23,Osasco/SP,3,2764,57,46599
132187,2022-01-24,Osasco/SP,1,2765,2,46601
137784,2022-01-25,Osasco/SP,2,2767,36,46637
143381,2022-01-26,Osasco/SP,0,2767,18,46655
148978,2022-01-27,Osasco/SP,0,2767,34,46689
154575,2022-01-28,Osasco/SP,4,2771,24,46713
160172,2022-01-29,Osasco/SP,2,2773,16,46729
165769,2022-01-30,Osasco/SP,1,2774,2,46731
171366,2022-01-31,Osasco/SP,0,2774,0,46731
176963,2022-02-01,Osasco/SP,4,2778,21,46752
182560,2022-02-02,Osasco/SP,3,2781,7,46759
188157,2022-02-03,Osasco/SP,5,2786,36,46795
193754,2022-02-04,Osasco/SP,0,2786,0,46795
199351,2022-02-05,Osasco/SP,8,2794,37,46832
204948,2022-02-06,Osasco/SP,1,2795,6,46838
210545,2022-02-07,Osasco/SP,0,2795,74,46912
216142,2022-02-08,Osasco/SP,0,2795,9,46921
221739,2022-02-09,Osasco/SP,5,2800,20,46941
227336,2022-02-10,Osasco/SP,2,2802,18,46959
232933,2022-02-11,Osasco/SP,2,2804,19,46978
238530,2022-02-12,Osasco/SP,1,2805,26,47004
244127,2022-02-13,Osasco/SP,1,2806,7,47011
249724,2022-02-14,Osasco/SP,1,2807,20,47031
255321,2022-02-15,Osasco/SP,1,2808,97,47128
260918,2022-02-16,Osasco/SP,3,2811,14,47142
266515,2022-02-17,Osasco/SP,2,2813,12,47154
272112,2022-02-18,Osasco/SP,3,2816,14,47168
277709,2022-02-19,Osasco/SP,4,2820,106,47274
283306,2022-02-20,Osasco/SP,0,2820,47,47321
288903,2022-02-21,Osasco/SP,0,2820,16,47337
294500,2022-02-22,Osasco/SP,5,2825,18,47355
300097,2022-02-23,Osasco/SP,7,2832,20,47375
305694,2022-02-24,Osasco/SP,31,2863,46,47421
311291,2022-02-25,Osasco/SP,37,2900,46,47467
316888,2022-02-26,Osasco/SP,7,2907,15,47482
322485,2022-02-27,Osasco/SP,0,2907,24,47506
328082,2022-02-28,Osasco/SP,0,2907,0,47506
333679,2022-03-01,Osasco/SP,7,2914,7,47513
339276,2022-03-02,Osasco/SP,2,2916,8,47521
344873,2022-03-03,Osasco/SP,0,2916,5,47526
350470,2022-03-04,Osasco/SP,2,2918,17,47543
356067,2022-03-05,Osasco/SP,1,2919,14,47557
361664,2022-03-06,Osasco/SP,0,2919,0,47557
367261,2022-03-07,Osasco/SP,0,2919,0,47557
372858,2022-03-08,Osasco/SP,2,2921,3,47560
378455,2022-03-09,Osasco/SP,0,2921,10,47570
384052,2022-03-10,Osasco/SP,1,2922,24,47594
389649,2022-03-11,Osasco/SP,2,2924,7,47601
395246,2022-03-12,Osasco/SP,2,2926,6,47607
400843,2022-03-13,Osasco/SP,1,2927,2,47609
406440,2022-03-14,Osasco/SP,1,2928,1,47610
412037,2022-03-15,Osasco/SP,0,2928,6,47616
417634,2022-03-16,Osasco/SP,5,2933,6,47622
423231,2022-03-17,Osasco/SP,3,2936,3,47625
428828,2022-03-18,Osasco/SP,0,2936,6,47631
434425,2022-03-19,Osasco/SP,0,2936,4,47635
440022,2022-03-20,Osasco/SP,0,2936,2,47637
445619,2022-03-21,Osasco/SP,0,2936,0,47637
451216,2022-03-22,Osasco/SP,0,2936,2,47639
456813,2022-03-23,Osasco/SP,3,2939,5,47644
462410,2022-03-24,Osasco/SP,2,2941,1,47645
468007,2022-03-25,Osasco/SP,2,2943,4,47649
473604,2022-03-26,Osasco/SP,1,2944,4,47653
479201,2022-03-27,Osasco/SP,2,2946,2,47655
484798,2022-03-28,Osasco/SP,1,2947,1,47656
490395,2022-03-29,Osasco/SP,0,2947,0,47656
495992,2022-03-30,Osasco/SP,4,2951,3,47659
501589,2022-03-31,Osasco/SP,3,2954,6,47665
507186,2022-04-01,Osasco/SP,2,2956,11,47676
512783,2022-04-02,Osasco/SP,0,2956,1,47677
518380,2022-04-03,Osasco/SP,0,2956,0,47677
523977,2022-04-04,Osasco/SP,1,2957,0,47677
529574,2022-04-05,Osasco/SP,2,2959,5,47682
535171,2022-04-06,Osasco/SP,1,2960,6,47688
540768,2022-04-07,Osasco/SP,1,2961,3,47691
546365,2022-04-08,Osasco/SP,3,2964,20,47711
551962,2022-04-09,Osasco/SP,0,2964,2,47713
557559,2022-04-10,Osasco/SP,0,2964,3,47716
563156,2022-04-11,Osasco/SP,0,2964,6,47722
568753,2022-04-12,Osasco/SP,0,2964,1,47723
574350,2022-04-13,Osasco/SP,0,2964,2,47725
579947,2022-04-14,Osasco/SP,0,2964,-1,47724
585544,2022-04-15,Osasco/SP,0,2964,2,47726
591141,2022-04-16,Osasco/SP,0,2964,0,47726
596738,2022-04-17,Osasco/SP,0,2964,0,47726
602335,2022-04-18,Osasco/SP,1,2965,3,47729
607932,2022-04-19,Osasco/SP,0,2965,0,47729
613529,2022-04-20,Osasco/SP,3,2968,7,47736
619126,2022-04-21,Osasco/SP,0,2968,8,47744
624723,2022-04-22,Osasco/SP,0,2968,0,47744
630320,2022-04-23,Osasco/SP,0,2968,3,47747
635917,2022-04-24,Osasco/SP,0,2968,0,47747
641514,2022-04-25,Osasco/SP,0,2968,2,47749
647111,2022-04-26,Osasco/SP,3,2971,5,47754
652708,2022-04-27,Osasco/SP,1,2972,10,47764
658305,2022-04-28,Osasco/SP,0,2972,0,47764
663902,2022-04-29,Osasco/SP,0,2972,2,47766
669499,2022-04-30,Osasco/SP,0,2972,-1,47765
675096,2022-05-01,Osasco/SP,0,2972,0,47765
680693,2022-05-02,Osasco/SP,0,2972,0,47765
686290,2022-05-03,Osasco/SP,0,2972,-1,47764
691887,2022-05-04,Osasco/SP,1,2973,1,47765
697484,2022-05-05,Osasco/SP,0,2973,5,47770
703081,2022-05-06,Osasco/SP,1,2974,2,47772
708678,2022-05-07,Osasco/SP,1,2975,1,47773
714275,2022-05-08,Osasco/SP,0,2975,0,47773
719872,2022-05-09,Osasco/SP,0,2975,0,47773
725469,2022-05-10,Osasco/SP,1,2976,1,47774
731066,2022-05-11,Osasco/SP,1,2977,3,47777
736663,2022-05-12,Osasco/SP,1,2978,4,47781
742260,2022-05-13,Osasco/SP,0,2978,2,47783
747857,2022-05-14,Osasco/SP,0,2978,8,47791
753454,2022-05-15,Osasco/SP,0,2978,0,47791
759051,2022-05-16,Osasco/SP,0,2978,0,47791
764648,2022-05-17,Osasco/SP,0,2978,7,47798
770245,2022-05-18,Osasco/SP,0,2978,1,47799
775842,2022-05-19,Osasco/SP,0,2978,1,47800
781439,2022-05-20,Osasco/SP,0,2978,0,47800
787036,2022-05-21,Osasco/SP,0,2978,0,47800
792633,2022-05-22,Osasco/SP,1,2979,4,47804
798230,2022-05-23,Osasco/SP,0,2979,0,47804
803827,2022-05-24,Osasco/SP,0,2979,6,47810
809424,2022-05-25,Osasco/SP,0,2979,0,47810
815021,2022-05-26,Osasco/SP,1,2980,5,47815
820618,2022-05-27,Osasco/SP,1,2981,11,47826
826215,2022-05-28,Osasco/SP,0,2981,3,47829
831812,2022-05-29,Osasco/SP,0,2981,0,47829
837409,2022-05-30,Osasco/SP,0,2981,3,47832
843006,2022-05-31,Osasco/SP,0,2981,9,47841
848603,2022-06-01,Osasco/SP,0,2981,8,47849
854200,2022-06-02,Osasco/SP,0,2981,10,47859
859797,2022-06-03,Osasco/SP,0,2981,0,47859
865394,2022-06-04,Osasco/SP,0,2981,0,47859
870991,2022-06-05,Osasco/SP,0,2981,0,47859
876588,2022-06-06,Osasco/SP,0,2981,0,47859
882185,2022-06-07,Osasco/SP,3,2984,50,47909
887782,2022-06-08,Osasco/SP,0,2984,15,47924
893379,2022-06-09,Osasco/SP,1,2985,9,47933
898976,2022-06-10,Osasco/SP,2,2987,11,47944
904573,2022-06-11,Osasco/SP,1,2988,12,47956
910170,2022-06-12,Osasco/SP,0,2988,0,47956
915767,2022-06-13,Osasco/SP,0,2988,1,47957
921364,2022-06-14,Osasco/SP,0,2988,0,47957
926961,2022-06-15,Osasco/SP,1,2989,33,47990
932558,2022-06-16,Osasco/SP,1,2990,8,47998
938155,2022-06-17,Osasco/SP,0,2990,2,48000
943752,2022-06-18,Osasco/SP,0,2990,6,48006
949349,2022-06-19,Osasco/SP,0,2990,0,48006
954946,2022-06-20,Osasco/SP,0,2990,4,48010
960543,2022-06-21,Osasco/SP,1,2991,37,48047
966140,2022-06-22,Osasco/SP,0,2991,22,48069
971737,2022-06-23,Osasco/SP,4,2995,11,48080
977334,2022-06-24,Osasco/SP,0,2995,3,48083
982931,2022-06-25,Osasco/SP,3,2998,38,48121
988528,2022-06-26,Osasco/SP,0,2998,3,48124
994125,2022-06-27,Osasco/SP,2,3000,2,48126
999722,2022-06-28,Osasco/SP,2,3002,16,48142
1005319,2022-06-29,Osasco/SP,1,3003,16,48158
1010916,2022-06-30,Osasco/SP,4,3007,13,48171
1016513,2022-07-01,Osasco/SP,2,3009,15,48186
1022110,2022-07-02,Osasco/SP,3,3012,14,48200
1027707,2022-07-03,Osasco/SP,1,3013,1,48201
1033304,2022-07-04,Osasco/SP,0,3013,0,48201
1038901,2022-07-05,Osasco/SP,1,3014,11,48212
1044498,2022-07-06,Osasco/SP,1,3015,16,48228
1050095,2022-07-07,Osasco/SP,0,3015,6,48234
1055692,2022-07-08,Osasco/SP,5,3020,7,48241
1061289,2022-07-09,Osasco/SP,4,3024,8,48249
1066886,2022-07-10,Osasco/SP,0,3024,0,48249
1072483,2022-07-11,Osasco/SP,0,3024,1,48250
1078080,2022-07-12,Osasco/SP,4,3028,9,48259
1083677,2022-07-13,Osasco/SP,4,3032,8,48267
1089274,2022-07-14,Osasco/SP,0,3032,8,48275
1094871,2022-07-15,Osasco/SP,4,3036,8,48283
1100468,2022-07-16,Osasco/SP,0,3036,60,48343
1106065,2022-07-17,Osasco/SP,0,3036,0,48343
1111662,2022-07-18,Osasco/SP,1,3037,3,48346
1117259,2022-07-19,Osasco/SP,6,3043,25,48371
1122856,2022-07-20,Osasco/SP,3,3046,3,48374
1128453,2022-07-21,Osasco/SP,5,3051,14,48388
1134050,2022-07-22,Osasco/SP,1,3052,14,48402
1139647,2022-07-23,Osasco/SP,1,3053,60,48462
1145244,2022-07-24,Osasco/SP,0,3053,0,48462
1150841,2022-07-25,Osasco/SP,0,3053,0,48462
1156438,2022-07-26,Osasco/SP,2,3055,4,48466
1162035,2022-07-27,Osasco/SP,2,3057,22,48488
1167632,2022-07-28,Osasco/SP,4,3061,61,48549
1173229,2022-07-29,Osasco/SP,2,3063,4,48553
1178826,2022-07-30,Osasco/SP,3,3066,19,48572
1184423,2022-07-31,Osasco/SP,0,3066,0,48572
1190020,2022-08-01,Osasco/SP,0,3066,0,48572
1195617,2022-08-02,Osasco/SP,0,3066,5,48577
1201214,2022-08-03,Osasco/SP,3,3069,8,48585
1206811,2022-08-04,Osasco/SP,0,3069,1,48586
1212408,2022-08-05,Osasco/SP,1,3070,1,48587
1218005,2022-08-06,Osasco/SP,0,3070,-1,48586
1223602,2022-08-07,Osasco/SP,0,3070,-1,48585
1229199,2022-08-08,Osasco/SP,0,3070,0,48585
1234796,2022-08-09,Osasco/SP,0,3070,5,48590
1240393,2022-08-10,Osasco/SP,0,3070,6,48596
1245990,2022-08-11,Osasco/SP,1,3071,2,48598
1251587,2022-08-12,Osasco/SP,0,3071,2,48600
1257184,2022-08-13,Osasco/SP,0,3071,2,48602
1262781,2022-08-14,Osasco/SP,0,3071,0,48602
1268378,2022-08-15,Osasco/SP,2,3073,3,48605
1273975,2022-08-16,Osasco/SP,0,3073,2,48607
1279572,2022-08-17,Osasco/SP,0,3073,3,48610
1285169,2022-08-18,Osasco/SP,0,3073,3,48613
1290766,2022-08-19,Osasco/SP,1,3074,1,48614
1296363,2022-08-20,Osasco/SP,1,3075,1,48615
1301960,2022-08-21,Osasco/SP,1,3076,7,48622
1307557,2022-08-22,Osasco/SP,0,3076,2,48624
1313154,2022-08-23,Osasco/SP,0,3076,2,48626
1318751,2022-08-24,Osasco/SP,0,3076,2,48628
1324348,2022-08-25,Osasco/SP,0,3076,0,48628
4523,2022-01-01,Santo André/SP,1,3202,1,67640
10120,2022-01-02,Santo André/SP,0,3202,1,67641
15717,2022-01-03,Santo André/SP,0,3202,0,67641
21314,2022-01-04,Santo André/SP,1,3203,13,67654
26911,2022-01-05,Santo André/SP,0,3203,264,67918
32508,2022-01-06,Santo André/SP,-2,3201,0,67918
38105,2022-01-07,Santo André/SP,1,3202,2,67920
43702,2022-01-08,Santo André/SP,1,3203,7,67927
49299,2022-01-09,Santo André/SP,0,3203,1,67928
54896,2022-01-10,Santo André/SP,0,3203,1,67929
60493,2022-01-11,Santo André/SP,1,3204,29,67958
66090,2022-01-12,Santo André/SP,0,3204,20,67978
71687,2022-01-13,Santo André/SP,0,3204,13,67991
77284,2022-01-14,Santo André/SP,3,3207,52,68043
82881,2022-01-15,Santo André/SP,0,3207,2,68045
88478,2022-01-16,Santo André/SP,0,3207,1,68046
94075,2022-01-17,Santo André/SP,0,3207,0,68046
99672,2022-01-18,Santo André/SP,4,3211,37,68083
105269,2022-01-19,Santo André/SP,1,3212,74,68157
110866,2022-01-20,Santo André/SP,1,3213,13,68170
116463,2022-01-21,Santo André/SP,1,3214,9,68179
122060,2022-01-22,Santo André/SP,0,3214,0,68179
127657,2022-01-23,Santo André/SP,1,3215,52,68231
133254,2022-01-24,Santo André/SP,0,3215,3,68234
138851,2022-01-25,Santo André/SP,1,3216,31,68265
144448,2022-01-26,Santo André/SP,0,3216,151,68416
150045,2022-01-27,Santo André/SP,3,3219,363,68779
155642,2022-01-28,Santo André/SP,3,3222,63,68842
161239,2022-01-29,Santo André/SP,5,3227,34,68876
166836,2022-01-30,Santo André/SP,0,3227,1,68877
172433,2022-01-31,Santo André/SP,0,3227,0,68877
178030,2022-02-01,Santo André/SP,4,3231,100,68977
183627,2022-02-02,Santo André/SP,0,3231,8,68985
189224,2022-02-03,Santo André/SP,4,3235,209,69194
194821,2022-02-04,Santo André/SP,0,3235,0,69194
200418,2022-02-05,Santo André/SP,10,3245,207,69401
206015,2022-02-06,Santo André/SP,0,3245,1,69402
211612,2022-02-07,Santo André/SP,0,3245,2,69404
217209,2022-02-08,Santo André/SP,20,3265,67,69471
222806,2022-02-09,Santo André/SP,1,3266,41,69512
228403,2022-02-10,Santo André/SP,10,3276,192,69704
234000,2022-02-11,Santo André/SP,4,3280,179,69883
239597,2022-02-12,Santo André/SP,4,3284,125,70008
245194,2022-02-13,Santo André/SP,0,3284,0,70008
250791,2022-02-14,Santo André/SP,0,3284,0,70008
256388,2022-02-15,Santo André/SP,2,3286,76,70084
261985,2022-02-16,Santo André/SP,22,3308,72,70156
267582,2022-02-17,Santo André/SP,1,3309,67,70223
273179,2022-02-18,Santo André/SP,9,3318,42,70265
278776,2022-02-19,Santo André/SP,6,3324,33,70298
284373,2022-02-20,Santo André/SP,1,3325,2,70300
289970,2022-02-21,Santo André/SP,0,3325,1,70301
295567,2022-02-22,Santo André/SP,11,3336,43,70344
301164,2022-02-23,Santo André/SP,8,3344,201,70545
306761,2022-02-24,Santo André/SP,11,3355,29,70574
312358,2022-02-25,Santo André/SP,1,3356,5,70579
317955,2022-02-26,Santo André/SP,5,3361,19,70598
323552,2022-02-27,Santo André/SP,0,3361,1,70599
329149,2022-02-28,Santo André/SP,0,3361,1,70600
334746,2022-03-01,Santo André/SP,1,3362,3,70603
340343,2022-03-02,Santo André/SP,0,3362,1,70604
345940,2022-03-03,Santo André/SP,-1,3361,-1,70603
351537,2022-03-04,Santo André/SP,2,3363,5,70608
357134,2022-03-05,Santo André/SP,2,3365,9,70617
362731,2022-03-06,Santo André/SP,0,3365,0,70617
368328,2022-03-07,Santo André/SP,0,3365,-1,70616
373925,2022-03-08,Santo André/SP,2,3367,4,70620
379522,2022-03-09,Santo André/SP,0,3367,2,70622
385119,2022-03-10,Santo André/SP,0,3367,8,70630
390716,2022-03-11,Santo André/SP,4,3371,6,70636
396313,2022-03-12,Santo André/SP,5,3376,5,70641
401910,2022-03-13,Santo André/SP,0,3376,0,70641
407507,2022-03-14,Santo André/SP,0,3376,0,70641
413104,2022-03-15,Santo André/SP,-1,3375,60,70701
418701,2022-03-16,Santo André/SP,0,3375,93,70794
424298,2022-03-17,Santo André/SP,4,3379,8,70802
429895,2022-03-18,Santo André/SP,-3,3376,11,70813
435492,2022-03-19,Santo André/SP,0,3376,77,70890
441089,2022-03-20,Santo André/SP,0,3376,1,70891
446686,2022-03-21,Santo André/SP,0,3376,0,70891
452283,2022-03-22,Santo André/SP,2,3378,10,70901
457880,2022-03-23,Santo André/SP,1,3379,6,70907
463477,2022-03-24,Santo André/SP,4,3383,12,70919
469074,2022-03-25,Santo André/SP,0,3383,7,70926
474671,2022-03-26,Santo André/SP,1,3384,1,70927
480268,2022-03-27,Santo André/SP,0,3384,0,70927
485865,2022-03-28,Santo André/SP,0,3384,0,70927
491462,2022-03-29,Santo André/SP,0,3384,38,70965
497059,2022-03-30,Santo André/SP,2,3386,241,71206
502656,2022-03-31,Santo André/SP,0,3386,132,71338
508253,2022-04-01,Santo André/SP,1,3387,371,71709
513850,2022-04-02,Santo André/SP,0,3387,126,71835
519447,2022-04-03,Santo André/SP,0,3387,0,71835
525044,2022-04-04,Santo André/SP,0,3387,0,71835
530641,2022-04-05,Santo André/SP,0,3387,27,71862
536238,2022-04-06,Santo André/SP,0,3387,16,71878
541835,2022-04-07,Santo André/SP,-1,3386,135,72013
547432,2022-04-08,Santo André/SP,0,3386,177,72190
553029,2022-04-09,Santo André/SP,1,3387,2,72192
558626,2022-04-10,Santo André/SP,0,3387,0,72192
564223,2022-04-11,Santo André/SP,0,3387,0,72192
569820,2022-04-12,Santo André/SP,-3,3384,318,72510
575417,2022-04-13,Santo André/SP,0,3384,416,72926
581014,2022-04-14,Santo André/SP,1,3385,162,73088
586611,2022-04-15,Santo André/SP,0,3385,560,73648
592208,2022-04-16,Santo André/SP,0,3385,0,73648
597805,2022-04-17,Santo André/SP,0,3385,0,73648
603402,2022-04-18,Santo André/SP,0,3385,0,73648
608999,2022-04-19,Santo André/SP,0,3385,0,73648
614596,2022-04-20,Santo André/SP,0,3385,2276,75924
620193,2022-04-21,Santo André/SP,0,3385,1277,77201
625790,2022-04-22,Santo André/SP,0,3385,0,77201
631387,2022-04-23,Santo André/SP,0,3385,0,77201
636984,2022-04-24,Santo André/SP,0,3385,0,77201
642581,2022-04-25,Santo André/SP,0,3385,0,77201
648178,2022-04-26,Santo André/SP,2,3387,531,77732
653775,2022-04-27,Santo André/SP,0,3387,522,78254
659372,2022-04-28,Santo André/SP,0,3387,263,78517
664969,2022-04-29,Santo André/SP,-2,3385,419,78936
670566,2022-04-30,Santo André/SP,-4,3381,1141,80077
676163,2022-05-01,Santo André/SP,0,3381,0,80077
681760,2022-05-02,Santo André/SP,0,3381,0,80077
687357,2022-05-03,Santo André/SP,-1,3380,1313,81390
692954,2022-05-04,Santo André/SP,1,3381,474,81864
698551,2022-05-05,Santo André/SP,-3,3378,727,82591
704148,2022-05-06,Santo André/SP,2,3380,816,83407
709745,2022-05-07,Santo André/SP,-1,3379,830,84237
715342,2022-05-08,Santo André/SP,0,3379,0,84237
720939,2022-05-09,Santo André/SP,0,3379,0,84237
726536,2022-05-10,Santo André/SP,3,3382,38,84275
732133,2022-05-11,Santo André/SP,0,3382,51,84326
737730,2022-05-12,Santo André/SP,0,3382,27,84353
743327,2022-05-13,Santo André/SP,0,3382,214,84567
748924,2022-05-14,Santo André/SP,1,3383,104,84671
754521,2022-05-15,Santo André/SP,0,3383,0,84671
760118,2022-05-16,Santo André/SP,0,3383,0,84671
765715,2022-05-17,Santo André/SP,0,3383,-1,84670
771312,2022-05-18,Santo André/SP,0,3383,385,85055
776909,2022-05-19,Santo André/SP,1,3384,176,85231
782506,2022-05-20,Santo André/SP,0,3384,0,85231
788103,2022-05-21,Santo André/SP,0,3384,0,85231
793700,2022-05-22,Santo André/SP,2,3386,-22,85209
799297,2022-05-23,Santo André/SP,0,3386,0,85209
804894,2022-05-24,Santo André/SP,1,3387,3,85212
810491,2022-05-25,Santo André/SP,0,3387,9,85221
816088,2022-05-26,Santo André/SP,1,3388,343,85564
821685,2022-05-27,Santo André/SP,0,3388,6,85570
827282,2022-05-28,Santo André/SP,0,3388,481,86051
832879,2022-05-29,Santo André/SP,0,3388,0,86051
838476,2022-05-30,Santo André/SP,0,3388,0,86051
844073,2022-05-31,Santo André/SP,0,3388,39,86090
849670,2022-06-01,Santo André/SP,1,3389,565,86655
855267,2022-06-02,Santo André/SP,0,3389,1,86656
860864,2022-06-03,Santo André/SP,0,3389,0,86656
866461,2022-06-04,Santo André/SP,0,3389,0,86656
872058,2022-06-05,Santo André/SP,0,3389,0,86656
877655,2022-06-06,Santo André/SP,0,3389,0,86656
883252,2022-06-07,Santo André/SP,5,3394,198,86854
888849,2022-06-08,Santo André/SP,0,3394,306,87160
894446,2022-06-09,Santo André/SP,-1,3393,192,87352
900043,2022-06-10,Santo André/SP,2,3395,341,87693
905640,2022-06-11,Santo André/SP,0,3395,159,87852
911237,2022-06-12,Santo André/SP,0,3395,0,87852
916834,2022-06-13,Santo André/SP,0,3395,1,87853
922431,2022-06-14,Santo André/SP,0,3395,0,87853
928028,2022-06-15,Santo André/SP,2,3397,267,88120
933625,2022-06-16,Santo André/SP,4,3401,362,88482
939222,2022-06-17,Santo André/SP,0,3401,3,88485
944819,2022-06-18,Santo André/SP,0,3401,0,88485
950416,2022-06-19,Santo André/SP,0,3401,0,88485
956013,2022-06-20,Santo André/SP,0,3401,0,88485
961610,2022-06-21,Santo André/SP,1,3402,16,88501
967207,2022-06-22,Santo André/SP,0,3402,493,88994
972804,2022-06-23,Santo André/SP,2,3404,539,89533
978401,2022-06-24,Santo André/SP,4,3408,10,89543
983998,2022-06-25,Santo André/SP,4,3412,747,90290
989595,2022-06-26,Santo André/SP,0,3412,1,90291
995192,2022-06-27,Santo André/SP,0,3412,1,90292
1000789,2022-06-28,Santo André/SP,0,3412,65,90357
1006386,2022-06-29,Santo André/SP,0,3412,219,90576
1011983,2022-06-30,Santo André/SP,2,3414,18,90594
1017580,2022-07-01,Santo André/SP,0,3414,85,90679
1023177,2022-07-02,Santo André/SP,0,3414,211,90890
1028774,2022-07-03,Santo André/SP,0,3414,0,90890
1034371,2022-07-04,Santo André/SP,0,3414,1,90891
1039968,2022-07-05,Santo André/SP,3,3417,225,91116
1045565,2022-07-06,Santo André/SP,6,3423,292,91408
1051162,2022-07-07,Santo André/SP,1,3424,30,91438
1056759,2022-07-08,Santo André/SP,0,3424,15,91453
1062356,2022-07-09,Santo André/SP,1,3425,7,91460
1067953,2022-07-10,Santo André/SP,0,3425,0,91460
1073550,2022-07-11,Santo André/SP,0,3425,0,91460
1079147,2022-07-12,Santo André/SP,1,3426,9,91469
1084744,2022-07-13,Santo André/SP,1,3427,7,91476
1090341,2022-07-14,Santo André/SP,1,3428,8,91484
1095938,2022-07-15,Santo André/SP,4,3432,69,91553
1101535,2022-07-16,Santo André/SP,0,3432,37,91590
1107132,2022-07-17,Santo André/SP,0,3432,1,91591
1112729,2022-07-18,Santo André/SP,0,3432,1,91592
1118326,2022-07-19,Santo André/SP,7,3439,6,91598
1123923,2022-07-20,Santo André/SP,0,3439,17,91615
1129520,2022-07-21,Santo André/SP,7,3446,20,91635
1135117,2022-07-22,Santo André/SP,3,3449,61,91696
1140714,2022-07-23,Santo André/SP,1,3450,11,91707
1146311,2022-07-24,Santo André/SP,0,3450,0,91707
1151908,2022-07-25,Santo André/SP,1,3451,0,91707
1157505,2022-07-26,Santo André/SP,0,3451,2,91709
1163102,2022-07-27,Santo André/SP,2,3453,45,91754
1168699,2022-07-28,Santo André/SP,3,3456,62,91816
1174296,2022-07-29,Santo André/SP,2,3458,6,91822
1179893,2022-07-30,Santo André/SP,0,3458,17,91839
1185490,2022-07-31,Santo André/SP,0,3458,0,91839
1191087,2022-08-01,Santo André/SP,0,3458,1,91840
1196684,2022-08-02,Santo André/SP,1,3459,84,91924
1202281,2022-08-03,Santo André/SP,0,3459,-2,91922
1207878,2022-08-04,Santo André/SP,0,3459,5,91927
1213475,2022-08-05,Santo André/SP,4,3463,3,91930
1219072,2022-08-06,Santo André/SP,1,3464,0,91930
1224669,2022-08-07,Santo André/SP,0,3464,0,91930
1230266,2022-08-08,Santo André/SP,0,3464,0,91930
1235863,2022-08-09,Santo André/SP,0,3464,2,91932
1241460,2022-08-10,Santo André/SP,2,3466,8,91940
1247057,2022-08-11,Santo André/SP,0,3466,5,91945
1252654,2022-08-12,Santo André/SP,0,3466,6,91951
1258251,2022-08-13,Santo André/SP,0,3466,1,91952
1263848,2022-08-14,Santo André/SP,0,3466,0,91952
1269445,2022-08-15,Santo André/SP,2,3468,0,91952
1275042,2022-08-16,Santo André/SP,2,3470,3,91955
1280639,2022-08-17,Santo André/SP,2,3472,1,91956
1286236,2022-08-18,Santo André/SP,3,3475,1,91957
1291833,2022-08-19,Santo André/SP,0,3475,4,91961
1297430,2022-08-20,Santo André/SP,0,3475,1,91962
1303027,2022-08-21,Santo André/SP,0,3475,1,91963
1308624,2022-08-22,Santo André/SP,0,3475,-1,91962
1314221,2022-08-23,Santo André/SP,0,3475,1,91963
1319818,2022-08-24,Santo André/SP,2,3477,5,91968
1325415,2022-08-25,Santo André/SP,1,3478,5,91973
4758,2022-01-01,São Bernardo do Campo/SP,0,3373,1,72919
10355,2022-01-02,São Bernardo do Campo/SP,0,3373,0,72919
15952,2022-01-03,São Bernardo do Campo/SP,0,3373,1,72920
21549,2022-01-04,São Bernardo do Campo/SP,0,3373,-95,72825
27146,2022-01-05,São Bernardo do Campo/SP,0,3373,-12,72813
32743,2022-01-06,São Bernardo do Campo/SP,0,3373,-63,72750
38340,2022-01-07,São Bernardo do Campo/SP,1,3374,-95,72655
43937,2022-01-08,São Bernardo do Campo/SP,1,3375,17,72672
49534,2022-01-09,São Bernardo do Campo/SP,0,3375,2,72674
55131,2022-01-10,São Bernardo do Campo/SP,0,3375,3,72677
60728,2022-01-11,São Bernardo do Campo/SP,2,3377,-97,72580
66325,2022-01-12,São Bernardo do Campo/SP,0,3377,-87,72493
71922,2022-01-13,São Bernardo do Campo/SP,1,3378,-26,72467
77519,2022-01-14,São Bernardo do Campo/SP,2,3380,11,72478
83116,2022-01-15,São Bernardo do Campo/SP,0,3380,5,72483
88713,2022-01-16,São Bernardo do Campo/SP,0,3380,1,72484
94310,2022-01-17,São Bernardo do Campo/SP,0,3380,1,72485
99907,2022-01-18,São Bernardo do Campo/SP,4,3384,12,72497
105504,2022-01-19,São Bernardo do Campo/SP,3,3387,13,72510
111101,2022-01-20,São Bernardo do Campo/SP,4,3391,21,72531
116698,2022-01-21,São Bernardo do Campo/SP,4,3395,-69,72462
122295,2022-01-22,São Bernardo do Campo/SP,0,3395,0,72462
127892,2022-01-23,São Bernardo do Campo/SP,3,3398,-23,72439
133489,2022-01-24,São Bernardo do Campo/SP,0,3398,3,72442
139086,2022-01-25,São Bernardo do Campo/SP,9,3407,-50,72392
144683,2022-01-26,São Bernardo do Campo/SP,6,3413,-19,72373
150280,2022-01-27,São Bernardo do Campo/SP,15,3428,-12,72361
155877,2022-01-28,São Bernardo do Campo/SP,0,3428,-46,72315
161474,2022-01-29,São Bernardo do Campo/SP,13,3441,2,72317
167071,2022-01-30,São Bernardo do Campo/SP,0,3441,0,72317
172668,2022-01-31,São Bernardo do Campo/SP,0,3441,0,72317
178265,2022-02-01,São Bernardo do Campo/SP,3,3444,-11,72306
183862,2022-02-02,São Bernardo do Campo/SP,11,3455,31,72337
189459,2022-02-03,São Bernardo do Campo/SP,10,3465,10,72347
195056,2022-02-04,São Bernardo do Campo/SP,0,3465,0,72347
200653,2022-02-05,São Bernardo do Campo/SP,10,3475,64,72411
206250,2022-02-06,São Bernardo do Campo/SP,1,3476,5,72416
211847,2022-02-07,São Bernardo do Campo/SP,0,3476,0,72416
217444,2022-02-08,São Bernardo do Campo/SP,4,3480,43,72459
223041,2022-02-09,São Bernardo do Campo/SP,16,3496,20,72479
228638,2022-02-10,São Bernardo do Campo/SP,12,3508,80,72559
234235,2022-02-11,São Bernardo do Campo/SP,0,3508,8,72567
239832,2022-02-12,São Bernardo do Campo/SP,8,3516,30,72597
245429,2022-02-13,São Bernardo do Campo/SP,2,3518,1,72598
251026,2022-02-14,São Bernardo do Campo/SP,0,3518,0,72598
256623,2022-02-15,São Bernardo do Campo/SP,4,3522,13,72611
262220,2022-02-16,São Bernardo do Campo/SP,13,3535,43,72654
267817,2022-02-17,São Bernardo do Campo/SP,1,3536,68,72722
273414,2022-02-18,São Bernardo do Campo/SP,3,3539,16,72738
279011,2022-02-19,São Bernardo do Campo/SP,3,3542,-7,72731
284608,2022-02-20,São Bernardo do Campo/SP,0,3542,2,72733
290205,2022-02-21,São Bernardo do Campo/SP,0,3542,0,72733
295802,2022-02-22,São Bernardo do Campo/SP,4,3546,13,72746
301399,2022-02-23,São Bernardo do Campo/SP,8,3554,-23,72723
306996,2022-02-24,São Bernardo do Campo/SP,4,3558,34,72757
312593,2022-02-25,São Bernardo do Campo/SP,3,3561,26,72783
318190,2022-02-26,São Bernardo do Campo/SP,1,3562,18,72801
323787,2022-02-27,São Bernardo do Campo/SP,0,3562,1,72802
329384,2022-02-28,São Bernardo do Campo/SP,0,3562,1,72803
334981,2022-03-01,São Bernardo do Campo/SP,0,3562,0,72803
340578,2022-03-02,São Bernardo do Campo/SP,0,3562,2,72805
346175,2022-03-03,São Bernardo do Campo/SP,1,3563,13,72818
351772,2022-03-04,São Bernardo do Campo/SP,7,3570,105,72923
357369,2022-03-05,São Bernardo do Campo/SP,5,3575,60,72983
362966,2022-03-06,São Bernardo do Campo/SP,0,3575,0,72983
368563,2022-03-07,São Bernardo do Campo/SP,0,3575,0,72983
374160,2022-03-08,São Bernardo do Campo/SP,0,3575,12,72995
379757,2022-03-09,São Bernardo do Campo/SP,4,3579,46,73041
385354,2022-03-10,São Bernardo do Campo/SP,2,3581,78,73119
390951,2022-03-11,São Bernardo do Campo/SP,1,3582,99,73218
396548,2022-03-12,São Bernardo do Campo/SP,2,3584,8,73226
402145,2022-03-13,São Bernardo do Campo/SP,0,3584,9,73235
407742,2022-03-14,São Bernardo do Campo/SP,1,3585,2,73237
413339,2022-03-15,São Bernardo do Campo/SP,0,3585,125,73362
418936,2022-03-16,São Bernardo do Campo/SP,5,3590,9,73371
424533,2022-03-17,São Bernardo do Campo/SP,3,3593,1,73372
430130,2022-03-18,São Bernardo do Campo/SP,4,3597,20,73392
435727,2022-03-19,São Bernardo do Campo/SP,0,3597,34,73426
441324,2022-03-20,São Bernardo do Campo/SP,0,3597,2,73428
446921,2022-03-21,São Bernardo do Campo/SP,0,3597,0,73428
452518,2022-03-22,São Bernardo do Campo/SP,1,3598,127,73555
458115,2022-03-23,São Bernardo do Campo/SP,1,3599,54,73609
463712,2022-03-24,São Bernardo do Campo/SP,7,3606,37,73646
469309,2022-03-25,São Bernardo do Campo/SP,1,3607,118,73764
474906,2022-03-26,São Bernardo do Campo/SP,3,3610,50,73814
480503,2022-03-27,São Bernardo do Campo/SP,0,3610,0,73814
486100,2022-03-28,São Bernardo do Campo/SP,0,3610,0,73814
491697,2022-03-29,São Bernardo do Campo/SP,1,3611,104,73918
497294,2022-03-30,São Bernardo do Campo/SP,6,3617,23,73941
502891,2022-03-31,São Bernardo do Campo/SP,-1,3616,9,73950
508488,2022-04-01,São Bernardo do Campo/SP,-1,3615,57,74007
514085,2022-04-02,São Bernardo do Campo/SP,2,3617,26,74033
519682,2022-04-03,São Bernardo do Campo/SP,0,3617,0,74033
525279,2022-04-04,São Bernardo do Campo/SP,1,3618,3,74036
530876,2022-04-05,São Bernardo do Campo/SP,1,3619,33,74069
536473,2022-04-06,São Bernardo do Campo/SP,1,3620,54,74123
542070,2022-04-07,São Bernardo do Campo/SP,2,3622,35,74158
547667,2022-04-08,São Bernardo do Campo/SP,4,3626,47,74205
553264,2022-04-09,São Bernardo do Campo/SP,-2,3624,52,74257
558861,2022-04-10,São Bernardo do Campo/SP,0,3624,0,74257
564458,2022-04-11,São Bernardo do Campo/SP,0,3624,1,74258
570055,2022-04-12,São Bernardo do Campo/SP,2,3626,61,74319
575652,2022-04-13,São Bernardo do Campo/SP,2,3628,61,74380
581249,2022-04-14,São Bernardo do Campo/SP,-1,3627,12,74392
586846,2022-04-15,São Bernardo do Campo/SP,1,3628,10,74402
592443,2022-04-16,São Bernardo do Campo/SP,0,3628,1,74403
598040,2022-04-17,São Bernardo do Campo/SP,0,3628,0,74403
603637,2022-04-18,São Bernardo do Campo/SP,0,3628,0,74403
609234,2022-04-19,São Bernardo do Campo/SP,0,3628,0,74403
614831,2022-04-20,São Bernardo do Campo/SP,3,3631,40,74443
620428,2022-04-21,São Bernardo do Campo/SP,-1,3630,47,74490
626025,2022-04-22,São Bernardo do Campo/SP,1,3631,1,74491
631622,2022-04-23,São Bernardo do Campo/SP,0,3631,0,74491
637219,2022-04-24,São Bernardo do Campo/SP,1,3632,1,74492
642816,2022-04-25,São Bernardo do Campo/SP,0,3632,1,74493
648413,2022-04-26,São Bernardo do Campo/SP,0,3632,25,74518
654010,2022-04-27,São Bernardo do Campo/SP,3,3635,5,74523
659607,2022-04-28,São Bernardo do Campo/SP,0,3635,14,74537
665204,2022-04-29,São Bernardo do Campo/SP,1,3636,7,74544
670801,2022-04-30,São Bernardo do Campo/SP,1,3637,6,74550
676398,2022-05-01,São Bernardo do Campo/SP,0,3637,4,74554
681995,2022-05-02,São Bernardo do Campo/SP,0,3637,1,74555
687592,2022-05-03,São Bernardo do Campo/SP,0,3637,26,74581
693189,2022-05-04,São Bernardo do Campo/SP,0,3637,16,74597
698786,2022-05-05,São Bernardo do Campo/SP,4,3641,-3,74594
704383,2022-05-06,São Bernardo do Campo/SP,0,3641,-10,74584
709980,2022-05-07,São Bernardo do Campo/SP,0,3641,2,74586
715577,2022-05-08,São Bernardo do Campo/SP,0,3641,0,74586
721174,2022-05-09,São Bernardo do Campo/SP,0,3641,0,74586
726771,2022-05-10,São Bernardo do Campo/SP,1,3642,0,74586
732368,2022-05-11,São Bernardo do Campo/SP,0,3642,5,74591
737965,2022-05-12,São Bernardo do Campo/SP,-1,3641,33,74624
743562,2022-05-13,São Bernardo do Campo/SP,3,3644,3,74627
749159,2022-05-14,São Bernardo do Campo/SP,3,3647,21,74648
754756,2022-05-15,São Bernardo do Campo/SP,0,3647,0,74648
760353,2022-05-16,São Bernardo do Campo/SP,0,3647,0,74648
765950,2022-05-17,São Bernardo do Campo/SP,0,3647,-18,74630
771547,2022-05-18,São Bernardo do Campo/SP,0,3647,29,74659
777144,2022-05-19,São Bernardo do Campo/SP,1,3648,18,74677
782741,2022-05-20,São Bernardo do Campo/SP,0,3648,0,74677
788338,2022-05-21,São Bernardo do Campo/SP,0,3648,0,74677
793935,2022-05-22,São Bernardo do Campo/SP,1,3649,40,74717
799532,2022-05-23,São Bernardo do Campo/SP,0,3649,0,74717
805129,2022-05-24,São Bernardo do Campo/SP,-1,3648,11,74728
810726,2022-05-25,São Bernardo do Campo/SP,2,3650,15,74743
816323,2022-05-26,São Bernardo do Campo/SP,1,3651,18,74761
821920,2022-05-27,São Bernardo do Campo/SP,0,3651,-19,74742
827517,2022-05-28,São Bernardo do Campo/SP,0,3651,0,74742
833114,2022-05-29,São Bernardo do Campo/SP,0,3651,3,74745
838711,2022-05-30,São Bernardo do Campo/SP,0,3651,0,74745
844308,2022-05-31,São Bernardo do Campo/SP,-1,3650,26,74771
849905,2022-06-01,São Bernardo do Campo/SP,0,3650,18,74789
855502,2022-06-02,São Bernardo do Campo/SP,1,3651,8,74797
861099,2022-06-03,São Bernardo do Campo/SP,0,3651,0,74797
866696,2022-06-04,São Bernardo do Campo/SP,0,3651,0,74797
872293,2022-06-05,São Bernardo do Campo/SP,0,3651,0,74797
877890,2022-06-06,São Bernardo do Campo/SP,0,3651,0,74797
883487,2022-06-07,São Bernardo do Campo/SP,3,3654,33,74830
889084,2022-06-08,São Bernardo do Campo/SP,0,3654,38,74868
894681,2022-06-09,São Bernardo do Campo/SP,1,3655,17,74885
900278,2022-06-10,São Bernardo do Campo/SP,0,3655,43,74928
905875,2022-06-11,São Bernardo do Campo/SP,3,3658,42,74970
911472,2022-06-12,São Bernardo do Campo/SP,0,3658,3,74973
917069,2022-06-13,São Bernardo do Campo/SP,0,3658,0,74973
922666,2022-06-14,São Bernardo do Campo/SP,0,3658,0,74973
928263,2022-06-15,São Bernardo do Campo/SP,1,3659,62,75035
933860,2022-06-16,São Bernardo do Campo/SP,1,3660,46,75081
939457,2022-06-17,São Bernardo do Campo/SP,1,3661,1,75082
945054,2022-06-18,São Bernardo do Campo/SP,0,3661,2,75084
950651,2022-06-19,São Bernardo do Campo/SP,0,3661,1,75085
956248,2022-06-20,São Bernardo do Campo/SP,0,3661,0,75085
961845,2022-06-21,São Bernardo do Campo/SP,2,3663,61,75146
967442,2022-06-22,São Bernardo do Campo/SP,0,3663,26,75172
973039,2022-06-23,São Bernardo do Campo/SP,5,3668,91,75263
978636,2022-06-24,São Bernardo do Campo/SP,1,3669,12,75275
984233,2022-06-25,São Bernardo do Campo/SP,2,3671,86,75361
989830,2022-06-26,São Bernardo do Campo/SP,0,3671,1,75362
995427,2022-06-27,São Bernardo do Campo/SP,0,3671,1,75363
1001024,2022-06-28,São Bernardo do Campo/SP,7,3678,71,75434
1006621,2022-06-29,São Bernardo do Campo/SP,0,3678,85,75519
1012218,2022-06-30,São Bernardo do Campo/SP,2,3680,62,75581
1017815,2022-07-01,São Bernardo do Campo/SP,3,3683,66,75647
1023412,2022-07-02,São Bernardo do Campo/SP,2,3685,34,75681
1029009,2022-07-03,São Bernardo do Campo/SP,0,3685,0,75681
1034606,2022-07-04,São Bernardo do Campo/SP,0,3685,0,75681
1040203,2022-07-05,São Bernardo do Campo/SP,4,3689,30,75711
1045800,2022-07-06,São Bernardo do Campo/SP,3,3692,51,75762
1051397,2022-07-07,São Bernardo do Campo/SP,3,3695,33,75795
1056994,2022-07-08,São Bernardo do Campo/SP,0,3695,30,75825
1062591,2022-07-09,São Bernardo do Campo/SP,3,3698,34,75859
1068188,2022-07-10,São Bernardo do Campo/SP,0,3698,2,75861
1073785,2022-07-11,São Bernardo do Campo/SP,0,3698,0,75861
1079382,2022-07-12,São Bernardo do Campo/SP,4,3702,77,75938
1084979,2022-07-13,São Bernardo do Campo/SP,3,3705,-31,75907
1090576,2022-07-14,São Bernardo do Campo/SP,4,3709,29,75936
1096173,2022-07-15,São Bernardo do Campo/SP,6,3715,51,75987
1101770,2022-07-16,São Bernardo do Campo/SP,2,3717,76,76063
1107367,2022-07-17,São Bernardo do Campo/SP,0,3717,2,76065
1112964,2022-07-18,São Bernardo do Campo/SP,1,3718,2,76067
1118561,2022-07-19,São Bernardo do Campo/SP,2,3720,101,76168
1124158,2022-07-20,São Bernardo do Campo/SP,1,3721,-15,76153
1129755,2022-07-21,São Bernardo do Campo/SP,3,3724,33,76186
1135352,2022-07-22,São Bernardo do Campo/SP,3,3727,90,76276
1140949,2022-07-23,São Bernardo do Campo/SP,0,3727,65,76341
1146546,2022-07-24,São Bernardo do Campo/SP,0,3727,2,76343
1152143,2022-07-25,São Bernardo do Campo/SP,0,3727,0,76343
1157740,2022-07-26,São Bernardo do Campo/SP,4,3731,32,76375
1163337,2022-07-27,São Bernardo do Campo/SP,0,3731,16,76391
1168934,2022-07-28,São Bernardo do Campo/SP,0,3731,-38,76353
1174531,2022-07-29,São Bernardo do Campo/SP,2,3733,7,76360
1180128,2022-07-30,São Bernardo do Campo/SP,1,3734,23,76383
1185725,2022-07-31,São Bernardo do Campo/SP,0,3734,12,76395
1191322,2022-08-01,São Bernardo do Campo/SP,0,3734,2,76397
1196919,2022-08-02,São Bernardo do Campo/SP,5,3739,50,76447
1202516,2022-08-03,São Bernardo do Campo/SP,4,3743,44,76491
1208113,2022-08-04,São Bernardo do Campo/SP,4,3747,33,76524
1213710,2022-08-05,São Bernardo do Campo/SP,1,3748,60,76584
1219307,2022-08-06,São Bernardo do Campo/SP,2,3750,11,76595
1224904,2022-08-07,São Bernardo do Campo/SP,0,3750,0,76595
1230501,2022-08-08,São Bernardo do Campo/SP,1,3751,0,76595
1236098,2022-08-09,São Bernardo do Campo/SP,1,3752,53,76648
1241695,2022-08-10,São Bernardo do Campo/SP,1,3753,38,76686
1247292,2022-08-11,São Bernardo do Campo/SP,1,3754,38,76724
1252889,2022-08-12,São Bernardo do Campo/SP,-1,3753,13,76737
1258486,2022-08-13,São Bernardo do Campo/SP,1,3754,-9,76728
1264083,2022-08-14,São Bernardo do Campo/SP,0,3754,0,76728
1269680,2022-08-15,São Bernardo do Campo/SP,0,3754,0,76728
1275277,2022-08-16,São Bernardo do Campo/SP,0,3754,-10,76718
1280874,2022-08-17,São Bernardo do Campo/SP,1,3755,-65,76653
1286471,2022-08-18,São Bernardo do Campo/SP,2,3757,-75,76578
1292068,2022-08-19,São Bernardo do Campo/SP,1,3758,-60,76518
1297665,2022-08-20,São Bernardo do Campo/SP,1,3759,-75,76443
1303262,2022-08-21,São Bernardo do Campo/SP,0,3759,-1,76442
1308859,2022-08-22,São Bernardo do Campo/SP,0,3759,0,76442
1314456,2022-08-23,São Bernardo do Campo/SP,0,3759,-10,76432
1320053,2022-08-24,São Bernardo do Campo/SP,0,3759,-45,76387
1325650,2022-08-25,São Bernardo do Campo/SP,1,3760,-51,76336
5018,2022-01-01,São Paulo/SP,5,39566,68,977986
10615,2022-01-02,São Paulo/SP,0,39566,7,977993
16212,2022-01-03,São Paulo/SP,0,39566,24,978017
21809,2022-01-04,São Paulo/SP,11,39577,457,978474
27406,2022-01-05,São Paulo/SP,6,39583,448,978922
33003,2022-01-06,São Paulo/SP,18,39601,272,979194
38600,2022-01-07,São Paulo/SP,7,39608,382,979576
44197,2022-01-08,São Paulo/SP,11,39619,275,979851
49794,2022-01-09,São Paulo/SP,0,39619,115,979966
55391,2022-01-10,São Paulo/SP,10,39629,87,980053
60988,2022-01-11,São Paulo/SP,9,39638,650,980703
66585,2022-01-12,São Paulo/SP,7,39645,471,981174
72182,2022-01-13,São Paulo/SP,15,39660,577,981751
77779,2022-01-14,São Paulo/SP,27,39687,833,982584
83376,2022-01-15,São Paulo/SP,30,39717,246,982830
88973,2022-01-16,São Paulo/SP,1,39718,176,983006
94570,2022-01-17,São Paulo/SP,4,39722,172,983178
100167,2022-01-18,São Paulo/SP,20,39742,1403,984581
105764,2022-01-19,São Paulo/SP,27,39769,1180,985761
111361,2022-01-20,São Paulo/SP,38,39807,1215,986976
116958,2022-01-21,São Paulo/SP,33,39840,1540,988516
122555,2022-01-22,São Paulo/SP,0,39840,0,988516
128152,2022-01-23,São Paulo/SP,40,39880,2357,990873
133749,2022-01-24,São Paulo/SP,27,39907,189,991062
139346,2022-01-25,São Paulo/SP,41,39948,1667,992729
144943,2022-01-26,São Paulo/SP,15,39963,501,993230
150540,2022-01-27,São Paulo/SP,54,40017,2282,995512
156137,2022-01-28,São Paulo/SP,37,40054,2017,997529
161734,2022-01-29,São Paulo/SP,65,40119,2559,1000088
167331,2022-01-30,São Paulo/SP,9,40128,691,1000779
172928,2022-01-31,São Paulo/SP,0,40128,0,1000779
178525,2022-02-01,São Paulo/SP,57,40185,2551,1003330
184122,2022-02-02,São Paulo/SP,61,40246,258,1003588
189719,2022-02-03,São Paulo/SP,84,40330,3766,1007354
195316,2022-02-04,São Paulo/SP,0,40330,0,1007354
200913,2022-02-05,São Paulo/SP,106,40436,3529,1010883
206510,2022-02-06,São Paulo/SP,16,40452,423,1011306
212107,2022-02-07,São Paulo/SP,4,40456,411,1011717
217704,2022-02-08,São Paulo/SP,65,40521,1831,1013548
223301,2022-02-09,São Paulo/SP,65,40586,2223,1015771
228898,2022-02-10,São Paulo/SP,58,40644,2050,1017821
234495,2022-02-11,São Paulo/SP,53,40697,2475,1020296
240092,2022-02-12,São Paulo/SP,37,40734,2327,1022623
245689,2022-02-13,São Paulo/SP,15,40749,355,1022978
251286,2022-02-14,São Paulo/SP,11,40760,255,1023233
256883,2022-02-15,São Paulo/SP,45,40805,1577,1024810
262480,2022-02-16,São Paulo/SP,123,40928,1667,1026477
268077,2022-02-17,São Paulo/SP,133,41061,1439,1027916
273674,2022-02-18,São Paulo/SP,63,41124,1458,1029374
279271,2022-02-19,São Paulo/SP,68,41192,1458,1030832
284868,2022-02-20,São Paulo/SP,5,41197,479,1031311
290465,2022-02-21,São Paulo/SP,12,41209,94,1031405
296062,2022-02-22,São Paulo/SP,66,41275,1411,1032816
301659,2022-02-23,São Paulo/SP,49,41324,1229,1034045
307256,2022-02-24,São Paulo/SP,45,41369,1149,1035194
312853,2022-02-25,São Paulo/SP,41,41410,733,1035927
318450,2022-02-26,São Paulo/SP,46,41456,681,1036608
324047,2022-02-27,São Paulo/SP,4,41460,169,1036777
329644,2022-02-28,São Paulo/SP,4,41464,78,1036855
335241,2022-03-01,São Paulo/SP,37,41501,181,1037036
340838,2022-03-02,São Paulo/SP,10,41511,278,1037314
346435,2022-03-03,São Paulo/SP,31,41542,690,1038004
352032,2022-03-04,São Paulo/SP,36,41578,661,1038665
357629,2022-03-05,São Paulo/SP,88,41666,877,1039542
363226,2022-03-06,São Paulo/SP,5,41671,92,1039634
368823,2022-03-07,São Paulo/SP,2,41673,96,1039730
374420,2022-03-08,São Paulo/SP,29,41702,893,1040623
380017,2022-03-09,São Paulo/SP,37,41739,779,1041402
385614,2022-03-10,São Paulo/SP,48,41787,806,1042208
391211,2022-03-11,São Paulo/SP,-4,41783,554,1042762
396808,2022-03-12,São Paulo/SP,16,41799,685,1043447
402405,2022-03-13,São Paulo/SP,-4,41795,63,1043510
408002,2022-03-14,São Paulo/SP,-5,41790,20,1043530
413599,2022-03-15,São Paulo/SP,16,41806,909,1044439
419196,2022-03-16,São Paulo/SP,30,41836,620,1045059
424793,2022-03-17,São Paulo/SP,36,41872,615,1045674
430390,2022-03-18,São Paulo/SP,39,41911,540,1046214
435987,2022-03-19,São Paulo/SP,29,41940,474,1046688
441584,2022-03-20,São Paulo/SP,-1,41939,134,1046822
447181,2022-03-21,São Paulo/SP,0,41939,13,1046835
452778,2022-03-22,São Paulo/SP,21,41960,410,1047245
458375,2022-03-23,São Paulo/SP,28,41988,349,1047594
463972,2022-03-24,São Paulo/SP,26,42014,237,1047831
469569,2022-03-25,São Paulo/SP,21,42035,316,1048147
475166,2022-03-26,São Paulo/SP,18,42053,437,1048584
480763,2022-03-27,São Paulo/SP,-1,42052,161,1048745
486360,2022-03-28,São Paulo/SP,8,42060,8,1048753
491957,2022-03-29,São Paulo/SP,25,42085,441,1049194
497554,2022-03-30,São Paulo/SP,20,42105,545,1049739
503151,2022-03-31,São Paulo/SP,8,42113,680,1050419
508748,2022-04-01,São Paulo/SP,9,42122,478,1050897
514345,2022-04-02,São Paulo/SP,4,42126,290,1051187
519942,2022-04-03,São Paulo/SP,-2,42124,-12,1051175
525539,2022-04-04,São Paulo/SP,0,42124,17,1051192
531136,2022-04-05,São Paulo/SP,11,42135,378,1051570
536733,2022-04-06,São Paulo/SP,7,42142,433,1052003
542330,2022-04-07,São Paulo/SP,5,42147,385,1052388
547927,2022-04-08,São Paulo/SP,7,42154,163,1052551
553524,2022-04-09,São Paulo/SP,4,42158,325,1052876
559121,2022-04-10,São Paulo/SP,-1,42157,128,1053004
564718,2022-04-11,São Paulo/SP,0,42157,4,1053008
570315,2022-04-12,São Paulo/SP,7,42164,314,1053322
575912,2022-04-13,São Paulo/SP,7,42171,225,1053547
581509,2022-04-14,São Paulo/SP,11,42182,588,1054135
587106,2022-04-15,São Paulo/SP,20,42202,455,1054590
592703,2022-04-16,São Paulo/SP,1,42203,-7,1054583
598300,2022-04-17,São Paulo/SP,0,42203,0,1054583
603897,2022-04-18,São Paulo/SP,0,42203,88,1054671
609494,2022-04-19,São Paulo/SP,0,42203,0,1054671
615091,2022-04-20,São Paulo/SP,20,42223,607,1055278
620688,2022-04-21,São Paulo/SP,1,42224,87,1055365
626285,2022-04-22,São Paulo/SP,2,42226,56,1055421
631882,2022-04-23,São Paulo/SP,1,42227,52,1055473
637479,2022-04-24,São Paulo/SP,1,42228,-18,1055455
643076,2022-04-25,São Paulo/SP,1,42229,93,1055548
648673,2022-04-26,São Paulo/SP,18,42247,241,1055789
654270,2022-04-27,São Paulo/SP,6,42253,349,1056138
659867,2022-04-28,São Paulo/SP,8,42261,393,1056531
665464,2022-04-29,São Paulo/SP,15,42276,131,1056662
671061,2022-04-30,São Paulo/SP,4,42280,85,1056747
676658,2022-05-01,São Paulo/SP,-1,42279,12,1056759
682255,2022-05-02,São Paulo/SP,1,42280,-51,1056708
687852,2022-05-03,São Paulo/SP,4,42284,103,1056811
693449,2022-05-04,São Paulo/SP,0,42284,223,1057034
699046,2022-05-05,São Paulo/SP,9,42293,384,1057418
704643,2022-05-06,São Paulo/SP,6,42299,918,1058336
710240,2022-05-07,São Paulo/SP,0,42299,502,1058838
715837,2022-05-08,São Paulo/SP,0,42299,53,1058891
721434,2022-05-09,São Paulo/SP,0,42299,4,1058895
727031,2022-05-10,São Paulo/SP,21,42320,168,1059063
732628,2022-05-11,São Paulo/SP,8,42328,168,1059231
738225,2022-05-12,São Paulo/SP,12,42340,189,1059420
743822,2022-05-13,São Paulo/SP,25,42365,194,1059614
749419,2022-05-14,São Paulo/SP,12,42377,285,1059899
755016,2022-05-15,São Paulo/SP,17,42394,151,1060050
760613,2022-05-16,São Paulo/SP,1,42395,8,1060058
766210,2022-05-17,São Paulo/SP,24,42419,446,1060504
771807,2022-05-18,São Paulo/SP,10,42429,342,1060846
777404,2022-05-19,São Paulo/SP,5,42434,70,1060916
783001,2022-05-20,São Paulo/SP,0,42434,0,1060916
788598,2022-05-21,São Paulo/SP,0,42434,0,1060916
794195,2022-05-22,São Paulo/SP,33,42467,671,1061587
799792,2022-05-23,São Paulo/SP,3,42470,35,1061622
805389,2022-05-24,São Paulo/SP,12,42482,327,1061949
810986,2022-05-25,São Paulo/SP,17,42499,312,1062261
816583,2022-05-26,São Paulo/SP,21,42520,305,1062566
822180,2022-05-27,São Paulo/SP,29,42549,388,1062954
827777,2022-05-28,São Paulo/SP,14,42563,1026,1063980
833374,2022-05-29,São Paulo/SP,18,42581,175,1064155
838971,2022-05-30,São Paulo/SP,5,42586,175,1064330
844568,2022-05-31,São Paulo/SP,10,42596,668,1064998
850165,2022-06-01,São Paulo/SP,3,42599,384,1065382
855762,2022-06-02,São Paulo/SP,27,42626,325,1065707
861359,2022-06-03,São Paulo/SP,0,42626,0,1065707
866956,2022-06-04,São Paulo/SP,0,42626,0,1065707
872553,2022-06-05,São Paulo/SP,0,42626,0,1065707
878150,2022-06-06,São Paulo/SP,0,42626,0,1065707
883747,2022-06-07,São Paulo/SP,32,42658,1357,1067064
889344,2022-06-08,São Paulo/SP,8,42666,541,1067605
894941,2022-06-09,São Paulo/SP,16,42682,593,1068198
900538,2022-06-10,São Paulo/SP,20,42702,611,1068809
906135,2022-06-11,São Paulo/SP,11,42713,448,1069257
911732,2022-06-12,São Paulo/SP,2,42715,270,1069527
917329,2022-06-13,São Paulo/SP,0,42715,25,1069552
922926,2022-06-14,São Paulo/SP,0,42715,0,1069552
928523,2022-06-15,São Paulo/SP,29,42744,1663,1071215
934120,2022-06-16,São Paulo/SP,8,42752,935,1072150
939717,2022-06-17,São Paulo/SP,8,42760,197,1072347
945314,2022-06-18,São Paulo/SP,3,42763,265,1072612
950911,2022-06-19,São Paulo/SP,0,42763,104,1072716
956508,2022-06-20,São Paulo/SP,2,42765,86,1072802
962105,2022-06-21,São Paulo/SP,9,42774,899,1073701
967702,2022-06-22,São Paulo/SP,0,42774,829,1074530
973299,2022-06-23,São Paulo/SP,30,42804,1117,1075647
978896,2022-06-24,São Paulo/SP,33,42837,158,1075805
984493,2022-06-25,São Paulo/SP,25,42862,1544,1077349
990090,2022-06-26,São Paulo/SP,4,42866,153,1077502
995687,2022-06-27,São Paulo/SP,1,42867,109,1077611
1001284,2022-06-28,São Paulo/SP,29,42896,1181,1078792
1006881,2022-06-29,São Paulo/SP,16,42912,1087,1079879
1012478,2022-06-30,São Paulo/SP,13,42925,1844,1081723
1018075,2022-07-01,São Paulo/SP,8,42933,1927,1083650
1023672,2022-07-02,São Paulo/SP,9,42942,1690,1085340
1029269,2022-07-03,São Paulo/SP,6,42948,408,1085748
1034866,2022-07-04,São Paulo/SP,5,42953,73,1085821
1040463,2022-07-05,São Paulo/SP,33,42986,1356,1087177
1046060,2022-07-06,São Paulo/SP,18,43004,1309,1088486
1051657,2022-07-07,São Paulo/SP,17,43021,1274,1089760
1057254,2022-07-08,São Paulo/SP,20,43041,1180,1090940
1062851,2022-07-09,São Paulo/SP,23,43064,1062,1092002
1068448,2022-07-10,São Paulo/SP,0,43064,174,1092176
1074045,2022-07-11,São Paulo/SP,1,43065,51,1092227
1079642,2022-07-12,São Paulo/SP,32,43097,1202,1093429
1085239,2022-07-13,São Paulo/SP,16,43113,888,1094317
1090836,2022-07-14,São Paulo/SP,21,43134,1103,1095420
1096433,2022-07-15,São Paulo/SP,31,43165,795,1096215
1102030,2022-07-16,São Paulo/SP,20,43185,1127,1097342
1107627,2022-07-17,São Paulo/SP,6,43191,79,1097421
1113224,2022-07-18,São Paulo/SP,13,43204,53,1097474
1118821,2022-07-19,São Paulo/SP,27,43231,948,1098422
1124418,2022-07-20,São Paulo/SP,14,43245,859,1099281
1130015,2022-07-21,São Paulo/SP,20,43265,742,1100023
1135612,2022-07-22,São Paulo/SP,17,43282,639,1100662
1141209,2022-07-23,São Paulo/SP,14,43296,773,1101435
1146806,2022-07-24,São Paulo/SP,6,43302,78,1101513
1152403,2022-07-25,São Paulo/SP,2,43304,16,1101529
1158000,2022-07-26,São Paulo/SP,27,43331,603,1102132
1163597,2022-07-27,São Paulo/SP,17,43348,723,1102855
1169194,2022-07-28,São Paulo/SP,17,43365,546,1103401
1174791,2022-07-29,São Paulo/SP,22,43387,758,1104159
1180388,2022-07-30,São Paulo/SP,10,43397,689,1104848
1185985,2022-07-31,São Paulo/SP,4,43401,22,1104870
1191582,2022-08-01,São Paulo/SP,0,43401,35,1104905
1197179,2022-08-02,São Paulo/SP,20,43421,328,1105233
1202776,2022-08-03,São Paulo/SP,14,43435,321,1105554
1208373,2022-08-04,São Paulo/SP,8,43443,507,1106061
1213970,2022-08-05,São Paulo/SP,11,43454,664,1106725
1219567,2022-08-06,São Paulo/SP,18,43472,384,1107109
1225164,2022-08-07,São Paulo/SP,-2,43470,32,1107141
1230761,2022-08-08,São Paulo/SP,2,43472,7,1107148
1236358,2022-08-09,São Paulo/SP,16,43488,401,1107549
1241955,2022-08-10,São Paulo/SP,17,43505,469,1108018
1247552,2022-08-11,São Paulo/SP,2,43507,354,1108372
1253149,2022-08-12,São Paulo/SP,4,43511,532,1108904
1258746,2022-08-13,São Paulo/SP,11,43522,510,1109414
1264343,2022-08-14,São Paulo/SP,1,43523,7,1109421
1269940,2022-08-15,São Paulo/SP,2,43525,43,1109464
1275537,2022-08-16,São Paulo/SP,8,43533,390,1109854
1281134,2022-08-17,São Paulo/SP,14,43547,309,1110163
1286731,2022-08-18,São Paulo/SP,13,43560,278,1110441
1292328,2022-08-19,São Paulo/SP,5,43565,241,1110682
1297925,2022-08-20,São Paulo/SP,7,43572,273,1110955
1303522,2022-08-21,São Paulo/SP,-2,43570,100,1111055
1309119,2022-08-22,São Paulo/SP,0,43570,107,1111162
1314716,2022-08-23,São Paulo/SP,10,43580,317,1111479
1320313,2022-08-24,São Paulo/SP,8,43588,461,1111940
1325910,2022-08-25,São Paulo/SP,8,43596,456,1112396
1459,2022-01-01,Cruzeiro/SP,0,104,1,6757
7056,2022-01-02,Cruzeiro/SP,0,104,0,6757
12653,2022-01-03,Cruzeiro/SP,0,104,0,6757
18250,2022-01-04,Cruzeiro/SP,0,104,0,6757
23847,2022-01-05,Cruzeiro/SP,0,104,0,6757
29444,2022-01-06,Cruzeiro/SP,0,104,0,6757
35041,2022-01-07,Cruzeiro/SP,0,104,0,6757
40638,2022-01-08,Cruzeiro/SP,0,104,0,6757
46235,2022-01-09,Cruzeiro/SP,0,104,0,6757
51832,2022-01-10,Cruzeiro/SP,0,104,0,6757
57429,2022-01-11,Cruzeiro/SP,0,104,0,6757
63026,2022-01-12,Cruzeiro/SP,0,104,0,6757
68623,2022-01-13,Cruzeiro/SP,0,104,0,6757
74220,2022-01-14,Cruzeiro/SP,0,104,0,6757
79817,2022-01-15,Cruzeiro/SP,0,104,0,6757
85414,2022-01-16,Cruzeiro/SP,0,104,0,6757
91011,2022-01-17,Cruzeiro/SP,0,104,1,6758
96608,2022-01-18,Cruzeiro/SP,0,104,0,6758
102205,2022-01-19,Cruzeiro/SP,0,104,0,6758
107802,2022-01-20,Cruzeiro/SP,0,104,0,6758
113399,2022-01-21,Cruzeiro/SP,0,104,0,6758
118996,2022-01-22,Cruzeiro/SP,0,104,0,6758
124593,2022-01-23,Cruzeiro/SP,0,104,1,6759
130190,2022-01-24,Cruzeiro/SP,0,104,0,6759
135787,2022-01-25,Cruzeiro/SP,0,104,0,6759
141384,2022-01-26,Cruzeiro/SP,1,105,1,6760
146981,2022-01-27,Cruzeiro/SP,0,105,0,6760
152578,2022-01-28,Cruzeiro/SP,0,105,0,6760
158175,2022-01-29,Cruzeiro/SP,0,105,0,6760
163772,2022-01-30,Cruzeiro/SP,0,105,0,6760
169369,2022-01-31,Cruzeiro/SP,0,105,0,6760
174966,2022-02-01,Cruzeiro/SP,0,105,0,6760
180563,2022-02-02,Cruzeiro/SP,0,105,0,6760
186160,2022-02-03,Cruzeiro/SP,0,105,2,6762
191757,2022-02-04,Cruzeiro/SP,0,105,0,6762
197354,2022-02-05,Cruzeiro/SP,0,105,0,6762
202951,2022-02-06,Cruzeiro/SP,0,105,0,6762
208548,2022-02-07,Cruzeiro/SP,0,105,1,6763
214145,2022-02-08,Cruzeiro/SP,0,105,0,6763
219742,2022-02-09,Cruzeiro/SP,0,105,0,6763
225339,2022-02-10,Cruzeiro/SP,0,105,0,6763
230936,2022-02-11,Cruzeiro/SP,1,106,3,6766
236533,2022-02-12,Cruzeiro/SP,0,106,0,6766
242130,2022-02-13,Cruzeiro/SP,0,106,0,6766
247727,2022-02-14,Cruzeiro/SP,0,106,0,6766
253324,2022-02-15,Cruzeiro/SP,0,106,0,6766
258921,2022-02-16,Cruzeiro/SP,0,106,0,6766
264518,2022-02-17,Cruzeiro/SP,0,106,0,6766
270115,2022-02-18,Cruzeiro/SP,1,107,2,6768
275712,2022-02-19,Cruzeiro/SP,0,107,0,6768
281309,2022-02-20,Cruzeiro/SP,0,107,0,6768
286906,2022-02-21,Cruzeiro/SP,0,107,0,6768
292503,2022-02-22,Cruzeiro/SP,0,107,0,6768
298100,2022-02-23,Cruzeiro/SP,0,107,0,6768
303697,2022-02-24,Cruzeiro/SP,0,107,0,6768
309294,2022-02-25,Cruzeiro/SP,0,107,0,6768
314891,2022-02-26,Cruzeiro/SP,0,107,0,6768
320488,2022-02-27,Cruzeiro/SP,0,107,0,6768
326085,2022-02-28,Cruzeiro/SP,0,107,0,6768
331682,2022-03-01,Cruzeiro/SP,0,107,1,6769
337279,2022-03-02,Cruzeiro/SP,0,107,0,6769
342876,2022-03-03,Cruzeiro/SP,0,107,0,6769
348473,2022-03-04,Cruzeiro/SP,1,108,0,6769
354070,2022-03-05,Cruzeiro/SP,0,108,1,6770
359667,2022-03-06,Cruzeiro/SP,0,108,0,6770
365264,2022-03-07,Cruzeiro/SP,0,108,0,6770
370861,2022-03-08,Cruzeiro/SP,0,108,1,6771
376458,2022-03-09,Cruzeiro/SP,0,108,-1,6770
382055,2022-03-10,Cruzeiro/SP,0,108,2,6772
387652,2022-03-11,Cruzeiro/SP,0,108,2,6774
393249,2022-03-12,Cruzeiro/SP,0,108,0,6774
398846,2022-03-13,Cruzeiro/SP,0,108,0,6774
404443,2022-03-14,Cruzeiro/SP,0,108,0,6774
410040,2022-03-15,Cruzeiro/SP,0,108,0,6774
415637,2022-03-16,Cruzeiro/SP,0,108,0,6774
421234,2022-03-17,Cruzeiro/SP,0,108,-5,6769
426831,2022-03-18,Cruzeiro/SP,0,108,-2,6767
432428,2022-03-19,Cruzeiro/SP,0,108,0,6767
438025,2022-03-20,Cruzeiro/SP,0,108,-1,6766
443622,2022-03-21,Cruzeiro/SP,0,108,-8,6758
449219,2022-03-22,Cruzeiro/SP,0,108,-3,6755
454816,2022-03-23,Cruzeiro/SP,0,108,-5,6750
460413,2022-03-24,Cruzeiro/SP,0,108,-2,6748
466010,2022-03-25,Cruzeiro/SP,0,108,-6,6742
471607,2022-03-26,Cruzeiro/SP,0,108,-3,6739
477204,2022-03-27,Cruzeiro/SP,0,108,-1,6738
482801,2022-03-28,Cruzeiro/SP,0,108,-4,6734
488398,2022-03-29,Cruzeiro/SP,0,108,1,6735
493995,2022-03-30,Cruzeiro/SP,0,108,-1,6734
499592,2022-03-31,Cruzeiro/SP,0,108,1,6735
505189,2022-04-01,Cruzeiro/SP,0,108,-5,6730
510786,2022-04-02,Cruzeiro/SP,0,108,0,6730
516383,2022-04-03,Cruzeiro/SP,0,108,0,6730
521980,2022-04-04,Cruzeiro/SP,0,108,0,6730
527577,2022-04-05,Cruzeiro/SP,0,108,0,6730
533174,2022-04-06,Cruzeiro/SP,0,108,0,6730
538771,2022-04-07,Cruzeiro/SP,0,108,0,6730
544368,2022-04-08,Cruzeiro/SP,0,108,0,6730
549965,2022-04-09,Cruzeiro/SP,0,108,0,6730
555562,2022-04-10,Cruzeiro/SP,0,108,0,6730
561159,2022-04-11,Cruzeiro/SP,0,108,0,6730
566756,2022-04-12,Cruzeiro/SP,0,108,0,6730
572353,2022-04-13,Cruzeiro/SP,0,108,1,6731
577950,2022-04-14,Cruzeiro/SP,0,108,0,6731
583547,2022-04-15,Cruzeiro/SP,0,108,0,6731
589144,2022-04-16,Cruzeiro/SP,0,108,0,6731
594741,2022-04-17,Cruzeiro/SP,0,108,0,6731
600338,2022-04-18,Cruzeiro/SP,0,108,0,6731
605935,2022-04-19,Cruzeiro/SP,0,108,0,6731
611532,2022-04-20,Cruzeiro/SP,0,108,1,6732
617129,2022-04-21,Cruzeiro/SP,0,108,1,6733
622726,2022-04-22,Cruzeiro/SP,0,108,0,6733
628323,2022-04-23,Cruzeiro/SP,0,108,0,6733
633920,2022-04-24,Cruzeiro/SP,0,108,0,6733
639517,2022-04-25,Cruzeiro/SP,0,108,0,6733
645114,2022-04-26,Cruzeiro/SP,0,108,0,6733
650711,2022-04-27,Cruzeiro/SP,0,108,0,6733
656308,2022-04-28,Cruzeiro/SP,0,108,0,6733
661905,2022-04-29,Cruzeiro/SP,0,108,0,6733
667502,2022-04-30,Cruzeiro/SP,0,108,1,6734
673099,2022-05-01,Cruzeiro/SP,0,108,0,6734
678696,2022-05-02,Cruzeiro/SP,0,108,0,6734
684293,2022-05-03,Cruzeiro/SP,0,108,1,6735
689890,2022-05-04,Cruzeiro/SP,0,108,0,6735
695487,2022-05-05,Cruzeiro/SP,0,108,0,6735
701084,2022-05-06,Cruzeiro/SP,0,108,0,6735
706681,2022-05-07,Cruzeiro/SP,0,108,0,6735
712278,2022-05-08,Cruzeiro/SP,0,108,0,6735
717875,2022-05-09,Cruzeiro/SP,0,108,0,6735
723472,2022-05-10,Cruzeiro/SP,0,108,0,6735
729069,2022-05-11,Cruzeiro/SP,0,108,0,6735
734666,2022-05-12,Cruzeiro/SP,0,108,0,6735
740263,2022-05-13,Cruzeiro/SP,0,108,0,6735
745860,2022-05-14,Cruzeiro/SP,0,108,0,6735
751457,2022-05-15,Cruzeiro/SP,0,108,0,6735
757054,2022-05-16,Cruzeiro/SP,0,108,0,6735
762651,2022-05-17,Cruzeiro/SP,0,108,0,6735
768248,2022-05-18,Cruzeiro/SP,0,108,0,6735
773845,2022-05-19,Cruzeiro/SP,0,108,0,6735
779442,2022-05-20,Cruzeiro/SP,0,108,0,6735
785039,2022-05-21,Cruzeiro/SP,0,108,0,6735
790636,2022-05-22,Cruzeiro/SP,0,108,0,6735
796233,2022-05-23,Cruzeiro/SP,0,108,0,6735
801830,2022-05-24,Cruzeiro/SP,0,108,0,6735
807427,2022-05-25,Cruzeiro/SP,0,108,0,6735
813024,2022-05-26,Cruzeiro/SP,0,108,0,6735
818621,2022-05-27,Cruzeiro/SP,0,108,1,6736
824218,2022-05-28,Cruzeiro/SP,0,108,0,6736
829815,2022-05-29,Cruzeiro/SP,0,108,0,6736
835412,2022-05-30,Cruzeiro/SP,0,108,0,6736
841009,2022-05-31,Cruzeiro/SP,0,108,0,6736
846606,2022-06-01,Cruzeiro/SP,0,108,1,6737
852203,2022-06-02,Cruzeiro/SP,0,108,0,6737
857800,2022-06-03,Cruzeiro/SP,0,108,0,6737
863397,2022-06-04,Cruzeiro/SP,0,108,0,6737
868994,2022-06-05,Cruzeiro/SP,0,108,0,6737
874591,2022-06-06,Cruzeiro/SP,0,108,0,6737
880188,2022-06-07,Cruzeiro/SP,0,108,1,6738
885785,2022-06-08,Cruzeiro/SP,6,114,7,6745
891382,2022-06-09,Cruzeiro/SP,2,116,-14,6731
896979,2022-06-10,Cruzeiro/SP,0,116,-3,6728
902576,2022-06-11,Cruzeiro/SP,0,116,1,6729
908173,2022-06-12,Cruzeiro/SP,1,117,2,6731
913770,2022-06-13,Cruzeiro/SP,2,119,0,6731
919367,2022-06-14,Cruzeiro/SP,0,119,0,6731
924964,2022-06-15,Cruzeiro/SP,14,133,55,6786
930561,2022-06-16,Cruzeiro/SP,2,135,9,6795
936158,2022-06-17,Cruzeiro/SP,6,141,14,6809
941755,2022-06-18,Cruzeiro/SP,21,162,70,6879
947352,2022-06-19,Cruzeiro/SP,11,173,40,6919
952949,2022-06-20,Cruzeiro/SP,0,173,1,6920
958546,2022-06-21,Cruzeiro/SP,0,173,1,6921
964143,2022-06-22,Cruzeiro/SP,0,173,0,6921
969740,2022-06-23,Cruzeiro/SP,1,174,1,6922
975337,2022-06-24,Cruzeiro/SP,0,174,0,6922
980934,2022-06-25,Cruzeiro/SP,0,174,0,6922
986531,2022-06-26,Cruzeiro/SP,1,175,1,6923
992128,2022-06-27,Cruzeiro/SP,0,175,0,6923
997725,2022-06-28,Cruzeiro/SP,0,175,0,6923
1003322,2022-06-29,Cruzeiro/SP,0,175,0,6923
1008919,2022-06-30,Cruzeiro/SP,0,175,0,6923
1014516,2022-07-01,Cruzeiro/SP,0,175,2,6925
1020113,2022-07-02,Cruzeiro/SP,0,175,0,6925
1025710,2022-07-03,Cruzeiro/SP,0,175,0,6925
1031307,2022-07-04,Cruzeiro/SP,0,175,1,6926
1036904,2022-07-05,Cruzeiro/SP,0,175,0,6926
1042501,2022-07-06,Cruzeiro/SP,0,175,0,6926
1048098,2022-07-07,Cruzeiro/SP,0,175,1,6927
1053695,2022-07-08,Cruzeiro/SP,0,175,2,6929
1059292,2022-07-09,Cruzeiro/SP,0,175,0,6929
1064889,2022-07-10,Cruzeiro/SP,0,175,0,6929
1070486,2022-07-11,Cruzeiro/SP,0,175,0,6929
1076083,2022-07-12,Cruzeiro/SP,0,175,0,6929
1081680,2022-07-13,Cruzeiro/SP,0,175,1,6930
1087277,2022-07-14,Cruzeiro/SP,0,175,0,6930
1092874,2022-07-15,Cruzeiro/SP,0,175,0,6930
1098471,2022-07-16,Cruzeiro/SP,0,175,0,6930
1104068,2022-07-17,Cruzeiro/SP,0,175,0,6930
1109665,2022-07-18,Cruzeiro/SP,0,175,0,6930
1115262,2022-07-19,Cruzeiro/SP,0,175,0,6930
1120859,2022-07-20,Cruzeiro/SP,0,175,1,6931
1126456,2022-07-21,Cruzeiro/SP,1,176,7,6938
1132053,2022-07-22,Cruzeiro/SP,8,184,12,6950
1137650,2022-07-23,Cruzeiro/SP,0,184,0,6950
1143247,2022-07-24,Cruzeiro/SP,0,184,0,6950
1148844,2022-07-25,Cruzeiro/SP,0,184,0,6950
1154441,2022-07-26,Cruzeiro/SP,0,184,0,6950
1160038,2022-07-27,Cruzeiro/SP,0,184,0,6950
1165635,2022-07-28,Cruzeiro/SP,0,184,0,6950
1171232,2022-07-29,Cruzeiro/SP,0,184,0,6950
1176829,2022-07-30,Cruzeiro/SP,0,184,0,6950
1182426,2022-07-31,Cruzeiro/SP,0,184,0,6950
1188023,2022-08-01,Cruzeiro/SP,0,184,0,6950
1193620,2022-08-02,Cruzeiro/SP,1,185,3,6953
1199217,2022-08-03,Cruzeiro/SP,1,186,2,6955
1204814,2022-08-04,Cruzeiro/SP,0,186,2,6957
1210411,2022-08-05,Cruzeiro/SP,0,186,0,6957
1216008,2022-08-06,Cruzeiro/SP,8,194,28,6985
1221605,2022-08-07,Cruzeiro/SP,18,212,52,7037
1227202,2022-08-08,Cruzeiro/SP,4,216,9,7046
1232799,2022-08-09,Cruzeiro/SP,3,219,9,7055
1238396,2022-08-10,Cruzeiro/SP,0,219,1,7056
1243993,2022-08-11,Cruzeiro/SP,1,220,7,7063
1249590,2022-08-12,Cruzeiro/SP,4,224,12,7075
1255187,2022-08-13,Cruzeiro/SP,1,225,3,7078
1260784,2022-08-14,Cruzeiro/SP,9,234,34,7112
1266381,2022-08-15,Cruzeiro/SP,3,237,11,7123
1271978,2022-08-16,Cruzeiro/SP,0,237,0,7123
1277575,2022-08-17,Cruzeiro/SP,0,237,0,7123
1283172,2022-08-18,Cruzeiro/SP,2,239,8,7131
1288769,2022-08-19,Cruzeiro/SP,0,239,18,7149
1294366,2022-08-20,Cruzeiro/SP,4,243,14,7163
1299963,2022-08-21,Cruzeiro/SP,0,243,0,7163
1305560,2022-08-22,Cruzeiro/SP,0,243,0,7163
1311157,2022-08-23,Cruzeiro/SP,0,243,0,7163
1316754,2022-08-24,Cruzeiro/SP,0,243,0,7163
1322351,2022-08-25,Cruzeiro/SP,0,243,0,7163
2008,2022-01-01,Guaratinguetá/SP,0,310,0,11545
7605,2022-01-02,Guaratinguetá/SP,0,310,0,11545
13202,2022-01-03,Guaratinguetá/SP,0,310,0,11545
18799,2022-01-04,Guaratinguetá/SP,0,310,7,11552
24396,2022-01-05,Guaratinguetá/SP,0,310,10,11562
29993,2022-01-06,Guaratinguetá/SP,0,310,3,11565
35590,2022-01-07,Guaratinguetá/SP,0,310,2,11567
41187,2022-01-08,Guaratinguetá/SP,0,310,0,11567
46784,2022-01-09,Guaratinguetá/SP,0,310,0,11567
52381,2022-01-10,Guaratinguetá/SP,0,310,0,11567
57978,2022-01-11,Guaratinguetá/SP,0,310,2,11569
63575,2022-01-12,Guaratinguetá/SP,0,310,0,11569
69172,2022-01-13,Guaratinguetá/SP,0,310,2,11571
74769,2022-01-14,Guaratinguetá/SP,0,310,15,11586
80366,2022-01-15,Guaratinguetá/SP,0,310,1,11587
85963,2022-01-16,Guaratinguetá/SP,0,310,1,11588
91560,2022-01-17,Guaratinguetá/SP,0,310,0,11588
97157,2022-01-18,Guaratinguetá/SP,0,310,1,11589
102754,2022-01-19,Guaratinguetá/SP,1,311,26,11615
108351,2022-01-20,Guaratinguetá/SP,0,311,6,11621
113948,2022-01-21,Guaratinguetá/SP,1,312,60,11681
119545,2022-01-22,Guaratinguetá/SP,0,312,0,11681
125142,2022-01-23,Guaratinguetá/SP,1,313,17,11698
130739,2022-01-24,Guaratinguetá/SP,0,313,0,11698
136336,2022-01-25,Guaratinguetá/SP,1,314,64,11762
141933,2022-01-26,Guaratinguetá/SP,0,314,117,11879
147530,2022-01-27,Guaratinguetá/SP,1,315,50,11929
153127,2022-01-28,Guaratinguetá/SP,0,315,109,12038
158724,2022-01-29,Guaratinguetá/SP,1,316,158,12196
164321,2022-01-30,Guaratinguetá/SP,0,316,0,12196
169918,2022-01-31,Guaratinguetá/SP,0,316,0,12196
175515,2022-02-01,Guaratinguetá/SP,0,316,260,12456
181112,2022-02-02,Guaratinguetá/SP,0,316,1,12457
186709,2022-02-03,Guaratinguetá/SP,0,316,493,12950
192306,2022-02-04,Guaratinguetá/SP,0,316,0,12950
197903,2022-02-05,Guaratinguetá/SP,1,317,610,13560
203500,2022-02-06,Guaratinguetá/SP,0,317,30,13590
209097,2022-02-07,Guaratinguetá/SP,0,317,0,13590
214694,2022-02-08,Guaratinguetá/SP,0,317,127,13717
220291,2022-02-09,Guaratinguetá/SP,0,317,197,13914
225888,2022-02-10,Guaratinguetá/SP,0,317,186,14100
231485,2022-02-11,Guaratinguetá/SP,4,321,117,14217
237082,2022-02-12,Guaratinguetá/SP,7,328,123,14340
242679,2022-02-13,Guaratinguetá/SP,0,328,0,14340
248276,2022-02-14,Guaratinguetá/SP,0,328,0,14340
253873,2022-02-15,Guaratinguetá/SP,0,328,147,14487
259470,2022-02-16,Guaratinguetá/SP,1,329,52,14539
265067,2022-02-17,Guaratinguetá/SP,4,333,56,14595
270664,2022-02-18,Guaratinguetá/SP,2,335,56,14651
276261,2022-02-19,Guaratinguetá/SP,1,336,90,14741
281858,2022-02-20,Guaratinguetá/SP,0,336,0,14741
287455,2022-02-21,Guaratinguetá/SP,0,336,0,14741
293052,2022-02-22,Guaratinguetá/SP,2,338,74,14815
298649,2022-02-23,Guaratinguetá/SP,1,339,50,14865
304246,2022-02-24,Guaratinguetá/SP,1,340,55,14920
309843,2022-02-25,Guaratinguetá/SP,0,340,41,14961
315440,2022-02-26,Guaratinguetá/SP,1,341,49,15010
321037,2022-02-27,Guaratinguetá/SP,0,341,0,15010
326634,2022-02-28,Guaratinguetá/SP,0,341,0,15010
332231,2022-03-01,Guaratinguetá/SP,1,342,29,15039
337828,2022-03-02,Guaratinguetá/SP,0,342,56,15095
343425,2022-03-03,Guaratinguetá/SP,0,342,19,15114
349022,2022-03-04,Guaratinguetá/SP,0,342,25,15139
354619,2022-03-05,Guaratinguetá/SP,0,342,13,15152
360216,2022-03-06,Guaratinguetá/SP,0,342,0,15152
365813,2022-03-07,Guaratinguetá/SP,0,342,0,15152
371410,2022-03-08,Guaratinguetá/SP,0,342,36,15188
377007,2022-03-09,Guaratinguetá/SP,1,343,10,15198
382604,2022-03-10,Guaratinguetá/SP,0,343,13,15211
388201,2022-03-11,Guaratinguetá/SP,1,344,21,15232
393798,2022-03-12,Guaratinguetá/SP,0,344,16,15248
399395,2022-03-13,Guaratinguetá/SP,0,344,0,15248
404992,2022-03-14,Guaratinguetá/SP,0,344,0,15248
410589,2022-03-15,Guaratinguetá/SP,0,344,8,15256
416186,2022-03-16,Guaratinguetá/SP,0,344,4,15260
421783,2022-03-17,Guaratinguetá/SP,0,344,3,15263
427380,2022-03-18,Guaratinguetá/SP,0,344,4,15267
432977,2022-03-19,Guaratinguetá/SP,0,344,7,15274
438574,2022-03-20,Guaratinguetá/SP,0,344,0,15274
444171,2022-03-21,Guaratinguetá/SP,0,344,0,15274
449768,2022-03-22,Guaratinguetá/SP,0,344,8,15282
455365,2022-03-23,Guaratinguetá/SP,0,344,7,15289
460962,2022-03-24,Guaratinguetá/SP,0,344,-1,15288
466559,2022-03-25,Guaratinguetá/SP,0,344,5,15293
472156,2022-03-26,Guaratinguetá/SP,0,344,0,15293
477753,2022-03-27,Guaratinguetá/SP,0,344,0,15293
483350,2022-03-28,Guaratinguetá/SP,0,344,0,15293
488947,2022-03-29,Guaratinguetá/SP,0,344,5,15298
494544,2022-03-30,Guaratinguetá/SP,0,344,1,15299
500141,2022-03-31,Guaratinguetá/SP,0,344,0,15299
505738,2022-04-01,Guaratinguetá/SP,0,344,1,15300
511335,2022-04-02,Guaratinguetá/SP,0,344,2,15302
516932,2022-04-03,Guaratinguetá/SP,0,344,0,15302
522529,2022-04-04,Guaratinguetá/SP,0,344,0,15302
528126,2022-04-05,Guaratinguetá/SP,0,344,0,15302
533723,2022-04-06,Guaratinguetá/SP,0,344,1,15303
539320,2022-04-07,Guaratinguetá/SP,0,344,0,15303
544917,2022-04-08,Guaratinguetá/SP,0,344,0,15303
550514,2022-04-09,Guaratinguetá/SP,0,344,0,15303
556111,2022-04-10,Guaratinguetá/SP,0,344,0,15303
561708,2022-04-11,Guaratinguetá/SP,0,344,0,15303
567305,2022-04-12,Guaratinguetá/SP,0,344,1,15304
572902,2022-04-13,Guaratinguetá/SP,0,344,5,15309
578499,2022-04-14,Guaratinguetá/SP,0,344,1,15310
584096,2022-04-15,Guaratinguetá/SP,0,344,0,15310
589693,2022-04-16,Guaratinguetá/SP,0,344,0,15310
595290,2022-04-17,Guaratinguetá/SP,0,344,0,15310
600887,2022-04-18,Guaratinguetá/SP,0,344,0,15310
606484,2022-04-19,Guaratinguetá/SP,0,344,0,15310
612081,2022-04-20,Guaratinguetá/SP,0,344,12,15322
617678,2022-04-21,Guaratinguetá/SP,0,344,7,15329
623275,2022-04-22,Guaratinguetá/SP,0,344,0,15329
628872,2022-04-23,Guaratinguetá/SP,0,344,0,15329
634469,2022-04-24,Guaratinguetá/SP,0,344,0,15329
640066,2022-04-25,Guaratinguetá/SP,0,344,0,15329
645663,2022-04-26,Guaratinguetá/SP,0,344,1,15330
651260,2022-04-27,Guaratinguetá/SP,0,344,4,15334
656857,2022-04-28,Guaratinguetá/SP,0,344,2,15336
662454,2022-04-29,Guaratinguetá/SP,0,344,6,15342
668051,2022-04-30,Guaratinguetá/SP,0,344,4,15346
673648,2022-05-01,Guaratinguetá/SP,0,344,0,15346
679245,2022-05-02,Guaratinguetá/SP,0,344,0,15346
684842,2022-05-03,Guaratinguetá/SP,0,344,2,15348
690439,2022-05-04,Guaratinguetá/SP,0,344,10,15358
696036,2022-05-05,Guaratinguetá/SP,0,344,2,15360
701633,2022-05-06,Guaratinguetá/SP,0,344,1,15361
707230,2022-05-07,Guaratinguetá/SP,0,344,0,15361
712827,2022-05-08,Guaratinguetá/SP,0,344,2,15363
718424,2022-05-09,Guaratinguetá/SP,0,344,0,15363
724021,2022-05-10,Guaratinguetá/SP,0,344,7,15370
729618,2022-05-11,Guaratinguetá/SP,1,345,3,15373
735215,2022-05-12,Guaratinguetá/SP,0,345,2,15375
740812,2022-05-13,Guaratinguetá/SP,0,345,4,15379
746409,2022-05-14,Guaratinguetá/SP,1,346,6,15385
752006,2022-05-15,Guaratinguetá/SP,0,346,0,15385
757603,2022-05-16,Guaratinguetá/SP,0,346,0,15385
763200,2022-05-17,Guaratinguetá/SP,0,346,1,15386
768797,2022-05-18,Guaratinguetá/SP,0,346,1,15387
774394,2022-05-19,Guaratinguetá/SP,0,346,1,15388
779991,2022-05-20,Guaratinguetá/SP,0,346,0,15388
785588,2022-05-21,Guaratinguetá/SP,0,346,0,15388
791185,2022-05-22,Guaratinguetá/SP,0,346,-1,15387
796782,2022-05-23,Guaratinguetá/SP,0,346,0,15387
802379,2022-05-24,Guaratinguetá/SP,0,346,0,15387
807976,2022-05-25,Guaratinguetá/SP,0,346,38,15425
813573,2022-05-26,Guaratinguetá/SP,1,347,49,15474
819170,2022-05-27,Guaratinguetá/SP,0,347,29,15503
824767,2022-05-28,Guaratinguetá/SP,0,347,9,15512
830364,2022-05-29,Guaratinguetá/SP,0,347,0,15512
835961,2022-05-30,Guaratinguetá/SP,0,347,0,15512
841558,2022-05-31,Guaratinguetá/SP,0,347,3,15515
847155,2022-06-01,Guaratinguetá/SP,0,347,58,15573
852752,2022-06-02,Guaratinguetá/SP,0,347,47,15620
858349,2022-06-03,Guaratinguetá/SP,0,347,0,15620
863946,2022-06-04,Guaratinguetá/SP,0,347,0,15620
869543,2022-06-05,Guaratinguetá/SP,0,347,0,15620
875140,2022-06-06,Guaratinguetá/SP,0,347,0,15620
880737,2022-06-07,Guaratinguetá/SP,1,348,56,15676
886334,2022-06-08,Guaratinguetá/SP,0,348,34,15710
891931,2022-06-09,Guaratinguetá/SP,3,351,43,15753
897528,2022-06-10,Guaratinguetá/SP,0,351,72,15825
903125,2022-06-11,Guaratinguetá/SP,0,351,51,15876
908722,2022-06-12,Guaratinguetá/SP,0,351,0,15876
914319,2022-06-13,Guaratinguetá/SP,0,351,0,15876
919916,2022-06-14,Guaratinguetá/SP,0,351,0,15876
925513,2022-06-15,Guaratinguetá/SP,0,351,44,15920
931110,2022-06-16,Guaratinguetá/SP,1,352,49,15969
936707,2022-06-17,Guaratinguetá/SP,1,353,0,15969
942304,2022-06-18,Guaratinguetá/SP,0,353,0,15969
947901,2022-06-19,Guaratinguetá/SP,0,353,0,15969
953498,2022-06-20,Guaratinguetá/SP,0,353,0,15969
959095,2022-06-21,Guaratinguetá/SP,0,353,59,16028
964692,2022-06-22,Guaratinguetá/SP,0,353,66,16094
970289,2022-06-23,Guaratinguetá/SP,4,357,42,16136
975886,2022-06-24,Guaratinguetá/SP,0,357,0,16136
981483,2022-06-25,Guaratinguetá/SP,0,357,64,16200
987080,2022-06-26,Guaratinguetá/SP,0,357,0,16200
992677,2022-06-27,Guaratinguetá/SP,0,357,0,16200
998274,2022-06-28,Guaratinguetá/SP,0,357,49,16249
1003871,2022-06-29,Guaratinguetá/SP,2,359,44,16293
1009468,2022-06-30,Guaratinguetá/SP,1,360,45,16338
1015065,2022-07-01,Guaratinguetá/SP,0,360,20,16358
1020662,2022-07-02,Guaratinguetá/SP,0,360,50,16408
1026259,2022-07-03,Guaratinguetá/SP,0,360,0,16408
1031856,2022-07-04,Guaratinguetá/SP,0,360,1,16409
1037453,2022-07-05,Guaratinguetá/SP,1,361,6,16415
1043050,2022-07-06,Guaratinguetá/SP,0,361,47,16462
1048647,2022-07-07,Guaratinguetá/SP,2,363,45,16507
1054244,2022-07-08,Guaratinguetá/SP,0,363,32,16539
1059841,2022-07-09,Guaratinguetá/SP,0,363,51,16590
1065438,2022-07-10,Guaratinguetá/SP,0,363,0,16590
1071035,2022-07-11,Guaratinguetá/SP,0,363,0,16590
1076632,2022-07-12,Guaratinguetá/SP,0,363,25,16615
1082229,2022-07-13,Guaratinguetá/SP,0,363,33,16648
1087826,2022-07-14,Guaratinguetá/SP,0,363,31,16679
1093423,2022-07-15,Guaratinguetá/SP,0,363,35,16714
1099020,2022-07-16,Guaratinguetá/SP,1,364,21,16735
1104617,2022-07-17,Guaratinguetá/SP,0,364,0,16735
1110214,2022-07-18,Guaratinguetá/SP,0,364,1,16736
1115811,2022-07-19,Guaratinguetá/SP,0,364,19,16755
1121408,2022-07-20,Guaratinguetá/SP,0,364,46,16801
1127005,2022-07-21,Guaratinguetá/SP,0,364,37,16838
1132602,2022-07-22,Guaratinguetá/SP,0,364,71,16909
1138199,2022-07-23,Guaratinguetá/SP,0,364,0,16909
1143796,2022-07-24,Guaratinguetá/SP,0,364,0,16909
1149393,2022-07-25,Guaratinguetá/SP,0,364,0,16909
1154990,2022-07-26,Guaratinguetá/SP,0,364,42,16951
1160587,2022-07-27,Guaratinguetá/SP,0,364,38,16989
1166184,2022-07-28,Guaratinguetá/SP,0,364,29,17018
1171781,2022-07-29,Guaratinguetá/SP,0,364,21,17039
1177378,2022-07-30,Guaratinguetá/SP,0,364,20,17059
1182975,2022-07-31,Guaratinguetá/SP,0,364,0,17059
1188572,2022-08-01,Guaratinguetá/SP,0,364,0,17059
1194169,2022-08-02,Guaratinguetá/SP,0,364,10,17069
1199766,2022-08-03,Guaratinguetá/SP,0,364,25,17094
1205363,2022-08-04,Guaratinguetá/SP,1,365,22,17116
1210960,2022-08-05,Guaratinguetá/SP,0,365,12,17128
1216557,2022-08-06,Guaratinguetá/SP,0,365,10,17138
1222154,2022-08-07,Guaratinguetá/SP,0,365,0,17138
1227751,2022-08-08,Guaratinguetá/SP,0,365,0,17138
1233348,2022-08-09,Guaratinguetá/SP,1,366,21,17159
1238945,2022-08-10,Guaratinguetá/SP,1,367,1,17160
1244542,2022-08-11,Guaratinguetá/SP,0,367,0,17160
1250139,2022-08-12,Guaratinguetá/SP,0,367,0,17160
1255736,2022-08-13,Guaratinguetá/SP,0,367,0,17160
1261333,2022-08-14,Guaratinguetá/SP,0,367,0,17160
1266930,2022-08-15,Guaratinguetá/SP,0,367,0,17160
1272527,2022-08-16,Guaratinguetá/SP,0,367,0,17160
1278124,2022-08-17,Guaratinguetá/SP,0,367,0,17160
1283721,2022-08-18,Guaratinguetá/SP,0,367,0,17160
1289318,2022-08-19,Guaratinguetá/SP,2,369,2,17162
1294915,2022-08-20,Guaratinguetá/SP,0,369,1,17163
1300512,2022-08-21,Guaratinguetá/SP,0,369,0,17163
1306109,2022-08-22,Guaratinguetá/SP,0,369,0,17163
1311706,2022-08-23,Guaratinguetá/SP,0,369,-1,17162
1317303,2022-08-24,Guaratinguetá/SP,0,369,0,17162
1322900,2022-08-25,Guaratinguetá/SP,0,369,0,17162
2463,2022-01-01,Jacareí/SP,0,771,7,25553
8060,2022-01-02,Jacareí/SP,0,771,0,25553
13657,2022-01-03,Jacareí/SP,0,771,1,25554
19254,2022-01-04,Jacareí/SP,0,771,5,25559
24851,2022-01-05,Jacareí/SP,0,771,14,25573
30448,2022-01-06,Jacareí/SP,0,771,21,25594
36045,2022-01-07,Jacareí/SP,0,771,27,25621
41642,2022-01-08,Jacareí/SP,0,771,24,25645
47239,2022-01-09,Jacareí/SP,0,771,9,25654
52836,2022-01-10,Jacareí/SP,0,771,2,25656
58433,2022-01-11,Jacareí/SP,1,772,25,25681
64030,2022-01-12,Jacareí/SP,2,774,8,25689
69627,2022-01-13,Jacareí/SP,1,775,-2,25687
75224,2022-01-14,Jacareí/SP,0,775,8,25695
80821,2022-01-15,Jacareí/SP,-1,774,2,25697
86418,2022-01-16,Jacareí/SP,0,774,12,25709
92015,2022-01-17,Jacareí/SP,0,774,3,25712
97612,2022-01-18,Jacareí/SP,0,774,19,25731
103209,2022-01-19,Jacareí/SP,0,774,20,25751
108806,2022-01-20,Jacareí/SP,2,776,32,25783
114403,2022-01-21,Jacareí/SP,2,778,56,25839
120000,2022-01-22,Jacareí/SP,0,778,0,25839
125597,2022-01-23,Jacareí/SP,1,779,72,25911
131194,2022-01-24,Jacareí/SP,0,779,4,25915
136791,2022-01-25,Jacareí/SP,1,780,36,25951
142388,2022-01-26,Jacareí/SP,1,781,140,26091
147985,2022-01-27,Jacareí/SP,6,787,88,26179
153582,2022-01-28,Jacareí/SP,8,795,111,26290
159179,2022-01-29,Jacareí/SP,1,796,59,26349
164776,2022-01-30,Jacareí/SP,0,796,25,26374
170373,2022-01-31,Jacareí/SP,0,796,0,26374
175970,2022-02-01,Jacareí/SP,1,797,55,26429
181567,2022-02-02,Jacareí/SP,6,803,10,26439
187164,2022-02-03,Jacareí/SP,0,803,100,26539
192761,2022-02-04,Jacareí/SP,0,803,0,26539
198358,2022-02-05,Jacareí/SP,2,805,127,26666
203955,2022-02-06,Jacareí/SP,0,805,11,26677
209552,2022-02-07,Jacareí/SP,0,805,9,26686
215149,2022-02-08,Jacareí/SP,2,807,96,26782
220746,2022-02-09,Jacareí/SP,11,818,88,26870
226343,2022-02-10,Jacareí/SP,2,820,76,26946
231940,2022-02-11,Jacareí/SP,2,822,138,27084
237537,2022-02-12,Jacareí/SP,1,823,65,27149
243134,2022-02-13,Jacareí/SP,1,824,74,27223
248731,2022-02-14,Jacareí/SP,0,824,26,27249
254328,2022-02-15,Jacareí/SP,0,824,36,27285
259925,2022-02-16,Jacareí/SP,1,825,65,27350
265522,2022-02-17,Jacareí/SP,1,826,89,27439
271119,2022-02-18,Jacareí/SP,0,826,108,27547
276716,2022-02-19,Jacareí/SP,7,833,56,27603
282313,2022-02-20,Jacareí/SP,0,833,0,27603
287910,2022-02-21,Jacareí/SP,1,834,4,27607
293507,2022-02-22,Jacareí/SP,0,834,33,27640
299104,2022-02-23,Jacareí/SP,1,835,33,27673
304701,2022-02-24,Jacareí/SP,0,835,38,27711
310298,2022-02-25,Jacareí/SP,-1,834,82,27793
315895,2022-02-26,Jacareí/SP,0,834,77,27870
321492,2022-02-27,Jacareí/SP,1,835,8,27878
327089,2022-02-28,Jacareí/SP,1,836,-2,27876
332686,2022-03-01,Jacareí/SP,0,836,7,27883
338283,2022-03-02,Jacareí/SP,0,836,12,27895
343880,2022-03-03,Jacareí/SP,0,836,23,27918
349477,2022-03-04,Jacareí/SP,0,836,29,27947
355074,2022-03-05,Jacareí/SP,13,849,8,27955
360671,2022-03-06,Jacareí/SP,0,849,1,27956
366268,2022-03-07,Jacareí/SP,0,849,0,27956
371865,2022-03-08,Jacareí/SP,1,850,-17,27939
377462,2022-03-09,Jacareí/SP,1,851,16,27955
383059,2022-03-10,Jacareí/SP,0,851,26,27981
388656,2022-03-11,Jacareí/SP,0,851,21,28002
394253,2022-03-12,Jacareí/SP,3,854,45,28047
399850,2022-03-13,Jacareí/SP,0,854,0,28047
405447,2022-03-14,Jacareí/SP,1,855,-3,28044
411044,2022-03-15,Jacareí/SP,0,855,6,28050
416641,2022-03-16,Jacareí/SP,0,855,24,28074
422238,2022-03-17,Jacareí/SP,3,858,15,28089
427835,2022-03-18,Jacareí/SP,0,858,26,28115
433432,2022-03-19,Jacareí/SP,0,858,7,28122
439029,2022-03-20,Jacareí/SP,0,858,0,28122
444626,2022-03-21,Jacareí/SP,0,858,0,28122
450223,2022-03-22,Jacareí/SP,0,858,0,28122
455820,2022-03-23,Jacareí/SP,2,860,13,28135
461417,2022-03-24,Jacareí/SP,1,861,4,28139
467014,2022-03-25,Jacareí/SP,1,862,4,28143
472611,2022-03-26,Jacareí/SP,0,862,22,28165
478208,2022-03-27,Jacareí/SP,0,862,0,28165
483805,2022-03-28,Jacareí/SP,0,862,1,28166
489402,2022-03-29,Jacareí/SP,1,863,15,28181
494999,2022-03-30,Jacareí/SP,1,864,14,28195
500596,2022-03-31,Jacareí/SP,0,864,15,28210
506193,2022-04-01,Jacareí/SP,0,864,19,28229
511790,2022-04-02,Jacareí/SP,0,864,19,28248
517387,2022-04-03,Jacareí/SP,0,864,0,28248
522984,2022-04-04,Jacareí/SP,0,864,-4,28244
528581,2022-04-05,Jacareí/SP,0,864,28,28272
534178,2022-04-06,Jacareí/SP,2,866,109,28381
539775,2022-04-07,Jacareí/SP,6,872,42,28423
545372,2022-04-08,Jacareí/SP,1,873,46,28469
550969,2022-04-09,Jacareí/SP,0,873,10,28479
556566,2022-04-10,Jacareí/SP,0,873,37,28516
562163,2022-04-11,Jacareí/SP,0,873,2,28518
567760,2022-04-12,Jacareí/SP,0,873,48,28566
573357,2022-04-13,Jacareí/SP,0,873,25,28591
578954,2022-04-14,Jacareí/SP,0,873,28,28619
584551,2022-04-15,Jacareí/SP,1,874,57,28676
590148,2022-04-16,Jacareí/SP,0,874,1,28677
595745,2022-04-17,Jacareí/SP,0,874,0,28677
601342,2022-04-18,Jacareí/SP,0,874,5,28682
606939,2022-04-19,Jacareí/SP,0,874,0,28682
612536,2022-04-20,Jacareí/SP,0,874,38,28720
618133,2022-04-21,Jacareí/SP,0,874,23,28743
623730,2022-04-22,Jacareí/SP,0,874,2,28745
629327,2022-04-23,Jacareí/SP,0,874,17,28762
634924,2022-04-24,Jacareí/SP,0,874,3,28765
640521,2022-04-25,Jacareí/SP,0,874,0,28765
646118,2022-04-26,Jacareí/SP,0,874,24,28789
651715,2022-04-27,Jacareí/SP,1,875,44,28833
657312,2022-04-28,Jacareí/SP,0,875,23,28856
662909,2022-04-29,Jacareí/SP,0,875,20,28876
668506,2022-04-30,Jacareí/SP,0,875,9,28885
674103,2022-05-01,Jacareí/SP,0,875,5,28890
679700,2022-05-02,Jacareí/SP,0,875,0,28890
685297,2022-05-03,Jacareí/SP,0,875,10,28900
690894,2022-05-04,Jacareí/SP,0,875,15,28915
696491,2022-05-05,Jacareí/SP,0,875,9,28924
702088,2022-05-06,Jacareí/SP,0,875,18,28942
707685,2022-05-07,Jacareí/SP,0,875,15,28957
713282,2022-05-08,Jacareí/SP,0,875,1,28958
718879,2022-05-09,Jacareí/SP,0,875,0,28958
724476,2022-05-10,Jacareí/SP,0,875,28,28986
730073,2022-05-11,Jacareí/SP,0,875,45,29031
735670,2022-05-12,Jacareí/SP,0,875,22,29053
741267,2022-05-13,Jacareí/SP,0,875,46,29099
746864,2022-05-14,Jacareí/SP,0,875,28,29127
752461,2022-05-15,Jacareí/SP,0,875,2,29129
758058,2022-05-16,Jacareí/SP,0,875,-6,29123
763655,2022-05-17,Jacareí/SP,0,875,11,29134
769252,2022-05-18,Jacareí/SP,0,875,26,29160
774849,2022-05-19,Jacareí/SP,1,876,10,29170
780446,2022-05-20,Jacareí/SP,0,876,0,29170
786043,2022-05-21,Jacareí/SP,0,876,0,29170
791640,2022-05-22,Jacareí/SP,1,877,34,29204
797237,2022-05-23,Jacareí/SP,0,877,3,29207
802834,2022-05-24,Jacareí/SP,0,877,-13,29194
808431,2022-05-25,Jacareí/SP,0,877,23,29217
814028,2022-05-26,Jacareí/SP,0,877,-1,29216
819625,2022-05-27,Jacareí/SP,0,877,12,29228
825222,2022-05-28,Jacareí/SP,0,877,31,29259
830819,2022-05-29,Jacareí/SP,0,877,4,29263
836416,2022-05-30,Jacareí/SP,0,877,-114,29149
842013,2022-05-31,Jacareí/SP,1,878,24,29173
847610,2022-06-01,Jacareí/SP,0,878,17,29190
853207,2022-06-02,Jacareí/SP,0,878,31,29221
858804,2022-06-03,Jacareí/SP,0,878,0,29221
864401,2022-06-04,Jacareí/SP,0,878,0,29221
869998,2022-06-05,Jacareí/SP,0,878,0,29221
875595,2022-06-06,Jacareí/SP,0,878,0,29221
881192,2022-06-07,Jacareí/SP,0,878,59,29280
886789,2022-06-08,Jacareí/SP,0,878,7,29287
892386,2022-06-09,Jacareí/SP,0,878,17,29304
897983,2022-06-10,Jacareí/SP,0,878,47,29351
903580,2022-06-11,Jacareí/SP,0,878,12,29363
909177,2022-06-12,Jacareí/SP,0,878,0,29363
914774,2022-06-13,Jacareí/SP,0,878,8,29371
920371,2022-06-14,Jacareí/SP,0,878,0,29371
925968,2022-06-15,Jacareí/SP,0,878,51,29422
931565,2022-06-16,Jacareí/SP,3,881,35,29457
937162,2022-06-17,Jacareí/SP,0,881,-8,29449
942759,2022-06-18,Jacareí/SP,0,881,25,29474
948356,2022-06-19,Jacareí/SP,0,881,3,29477
953953,2022-06-20,Jacareí/SP,0,881,1,29478
959550,2022-06-21,Jacareí/SP,0,881,20,29498
965147,2022-06-22,Jacareí/SP,0,881,9,29507
970744,2022-06-23,Jacareí/SP,0,881,22,29529
976341,2022-06-24,Jacareí/SP,0,881,2,29531
981938,2022-06-25,Jacareí/SP,0,881,55,29586
987535,2022-06-26,Jacareí/SP,0,881,5,29591
993132,2022-06-27,Jacareí/SP,0,881,-142,29449
998729,2022-06-28,Jacareí/SP,1,882,27,29476
1004326,2022-06-29,Jacareí/SP,2,884,31,29507
1009923,2022-06-30,Jacareí/SP,7,891,30,29537
1015520,2022-07-01,Jacareí/SP,4,895,16,29553
1021117,2022-07-02,Jacareí/SP,0,895,23,29576
1026714,2022-07-03,Jacareí/SP,0,895,5,29581
1032311,2022-07-04,Jacareí/SP,0,895,1,29582
1037908,2022-07-05,Jacareí/SP,0,895,-3,29579
1043505,2022-07-06,Jacareí/SP,0,895,10,29589
1049102,2022-07-07,Jacareí/SP,0,895,4,29593
1054699,2022-07-08,Jacareí/SP,0,895,19,29612
1060296,2022-07-09,Jacareí/SP,0,895,0,29612
1065893,2022-07-10,Jacareí/SP,0,895,2,29614
1071490,2022-07-11,Jacareí/SP,0,895,0,29614
1077087,2022-07-12,Jacareí/SP,0,895,12,29626
1082684,2022-07-13,Jacareí/SP,2,897,56,29682
1088281,2022-07-14,Jacareí/SP,0,897,52,29734
1093878,2022-07-15,Jacareí/SP,0,897,35,29769
1099475,2022-07-16,Jacareí/SP,0,897,73,29842
1105072,2022-07-17,Jacareí/SP,0,897,1,29843
1110669,2022-07-18,Jacareí/SP,0,897,-9,29834
1116266,2022-07-19,Jacareí/SP,0,897,75,29909
1121863,2022-07-20,Jacareí/SP,0,897,20,29929
1127460,2022-07-21,Jacareí/SP,0,897,10,29939
1133057,2022-07-22,Jacareí/SP,0,897,21,29960
1138654,2022-07-23,Jacareí/SP,0,897,20,29980
1144251,2022-07-24,Jacareí/SP,0,897,6,29986
1149848,2022-07-25,Jacareí/SP,0,897,-2,29984
1155445,2022-07-26,Jacareí/SP,0,897,9,29993
1161042,2022-07-27,Jacareí/SP,0,897,19,30012
1166639,2022-07-28,Jacareí/SP,1,898,1,30013
1172236,2022-07-29,Jacareí/SP,0,898,11,30024
1177833,2022-07-30,Jacareí/SP,0,898,25,30049
1183430,2022-07-31,Jacareí/SP,0,898,6,30055
1189027,2022-08-01,Jacareí/SP,0,898,-1,30054
1194624,2022-08-02,Jacareí/SP,0,898,11,30065
1200221,2022-08-03,Jacareí/SP,0,898,8,30073
1205818,2022-08-04,Jacareí/SP,1,899,-4,30069
1211415,2022-08-05,Jacareí/SP,0,899,6,30075
1217012,2022-08-06,Jacareí/SP,0,899,5,30080
1222609,2022-08-07,Jacareí/SP,0,899,-4,30076
1228206,2022-08-08,Jacareí/SP,0,899,-2,30074
1233803,2022-08-09,Jacareí/SP,0,899,1,30075
1239400,2022-08-10,Jacareí/SP,-1,898,8,30083
1244997,2022-08-11,Jacareí/SP,0,898,3,30086
1250594,2022-08-12,Jacareí/SP,1,899,3,30089
1256191,2022-08-13,Jacareí/SP,0,899,0,30089
1261788,2022-08-14,Jacareí/SP,0,899,1,30090
1267385,2022-08-15,Jacareí/SP,0,899,1,30091
1272982,2022-08-16,Jacareí/SP,0,899,5,30096
1278579,2022-08-17,Jacareí/SP,0,899,2,30098
1284176,2022-08-18,Jacareí/SP,1,900,-1,30097
1289773,2022-08-19,Jacareí/SP,0,900,0,30097
1295370,2022-08-20,Jacareí/SP,-3,897,11,30108
1300967,2022-08-21,Jacareí/SP,0,897,0,30108
1306564,2022-08-22,Jacareí/SP,0,897,0,30108
1312161,2022-08-23,Jacareí/SP,3,900,13,30121
1317758,2022-08-24,Jacareí/SP,-1,899,9,30130
1323355,2022-08-25,Jacareí/SP,0,899,1,30131
2785,2022-01-01,Lorena/SP,0,143,0,5396
8382,2022-01-02,Lorena/SP,0,143,0,5396
13979,2022-01-03,Lorena/SP,0,143,0,5396
19576,2022-01-04,Lorena/SP,0,143,0,5396
25173,2022-01-05,Lorena/SP,0,143,0,5396
30770,2022-01-06,Lorena/SP,0,143,0,5396
36367,2022-01-07,Lorena/SP,0,143,2,5398
41964,2022-01-08,Lorena/SP,0,143,0,5398
47561,2022-01-09,Lorena/SP,0,143,1,5399
53158,2022-01-10,Lorena/SP,0,143,0,5399
58755,2022-01-11,Lorena/SP,0,143,0,5399
64352,2022-01-12,Lorena/SP,0,143,0,5399
69949,2022-01-13,Lorena/SP,0,143,6,5405
75546,2022-01-14,Lorena/SP,0,143,0,5405
81143,2022-01-15,Lorena/SP,0,143,0,5405
86740,2022-01-16,Lorena/SP,0,143,1,5406
92337,2022-01-17,Lorena/SP,0,143,1,5407
97934,2022-01-18,Lorena/SP,0,143,0,5407
103531,2022-01-19,Lorena/SP,0,143,2,5409
109128,2022-01-20,Lorena/SP,0,143,5,5414
114725,2022-01-21,Lorena/SP,0,143,-2,5412
120322,2022-01-22,Lorena/SP,0,143,0,5412
125919,2022-01-23,Lorena/SP,0,143,1,5413
131516,2022-01-24,Lorena/SP,0,143,-1,5412
137113,2022-01-25,Lorena/SP,0,143,0,5412
142710,2022-01-26,Lorena/SP,0,143,0,5412
148307,2022-01-27,Lorena/SP,0,143,0,5412
153904,2022-01-28,Lorena/SP,0,143,2,5414
159501,2022-01-29,Lorena/SP,0,143,0,5414
165098,2022-01-30,Lorena/SP,0,143,0,5414
170695,2022-01-31,Lorena/SP,0,143,0,5414
176292,2022-02-01,Lorena/SP,0,143,52,5466
181889,2022-02-02,Lorena/SP,0,143,10,5476
187486,2022-02-03,Lorena/SP,0,143,0,5476
193083,2022-02-04,Lorena/SP,0,143,0,5476
198680,2022-02-05,Lorena/SP,3,146,9,5485
204277,2022-02-06,Lorena/SP,0,146,0,5485
209874,2022-02-07,Lorena/SP,0,146,0,5485
215471,2022-02-08,Lorena/SP,0,146,2,5487
221068,2022-02-09,Lorena/SP,1,147,3,5490
226665,2022-02-10,Lorena/SP,0,147,0,5490
232262,2022-02-11,Lorena/SP,0,147,4,5494
237859,2022-02-12,Lorena/SP,3,150,76,5570
243456,2022-02-13,Lorena/SP,0,150,29,5599
249053,2022-02-14,Lorena/SP,0,150,0,5599
254650,2022-02-15,Lorena/SP,3,153,14,5613
260247,2022-02-16,Lorena/SP,0,153,0,5613
265844,2022-02-17,Lorena/SP,6,159,7,5620
271441,2022-02-18,Lorena/SP,0,159,0,5620
277038,2022-02-19,Lorena/SP,11,170,31,5651
282635,2022-02-20,Lorena/SP,0,170,76,5727
288232,2022-02-21,Lorena/SP,0,170,-1,5726
293829,2022-02-22,Lorena/SP,0,170,6,5732
299426,2022-02-23,Lorena/SP,0,170,7,5739
305023,2022-02-24,Lorena/SP,0,170,66,5805
310620,2022-02-25,Lorena/SP,0,170,4,5809
316217,2022-02-26,Lorena/SP,0,170,0,5809
321814,2022-02-27,Lorena/SP,0,170,0,5809
327411,2022-02-28,Lorena/SP,0,170,0,5809
333008,2022-03-01,Lorena/SP,0,170,0,5809
338605,2022-03-02,Lorena/SP,0,170,-1,5808
344202,2022-03-03,Lorena/SP,0,170,1,5809
349799,2022-03-04,Lorena/SP,0,170,2,5811
355396,2022-03-05,Lorena/SP,0,170,7,5818
360993,2022-03-06,Lorena/SP,0,170,0,5818
366590,2022-03-07,Lorena/SP,0,170,2,5820
372187,2022-03-08,Lorena/SP,0,170,4,5824
377784,2022-03-09,Lorena/SP,6,176,6,5830
383381,2022-03-10,Lorena/SP,1,177,7,5837
388978,2022-03-11,Lorena/SP,1,178,4,5841
394575,2022-03-12,Lorena/SP,1,179,6,5847
400172,2022-03-13,Lorena/SP,0,179,0,5847
405769,2022-03-14,Lorena/SP,0,179,0,5847
411366,2022-03-15,Lorena/SP,0,179,1,5848
416963,2022-03-16,Lorena/SP,0,179,0,5848
422560,2022-03-17,Lorena/SP,2,181,43,5891
428157,2022-03-18,Lorena/SP,2,183,47,5938
433754,2022-03-19,Lorena/SP,3,186,71,6009
439351,2022-03-20,Lorena/SP,0,186,0,6009
444948,2022-03-21,Lorena/SP,0,186,0,6009
450545,2022-03-22,Lorena/SP,0,186,1,6010
456142,2022-03-23,Lorena/SP,0,186,1,6011
461739,2022-03-24,Lorena/SP,0,186,1,6012
467336,2022-03-25,Lorena/SP,1,187,6,6018
472933,2022-03-26,Lorena/SP,1,188,20,6038
478530,2022-03-27,Lorena/SP,0,188,0,6038
484127,2022-03-28,Lorena/SP,0,188,0,6038
489724,2022-03-29,Lorena/SP,2,190,5,6043
495321,2022-03-30,Lorena/SP,0,190,8,6051
500918,2022-03-31,Lorena/SP,1,191,11,6062
506515,2022-04-01,Lorena/SP,2,193,27,6089
512112,2022-04-02,Lorena/SP,0,193,22,6111
517709,2022-04-03,Lorena/SP,0,193,0,6111
523306,2022-04-04,Lorena/SP,0,193,34,6145
528903,2022-04-05,Lorena/SP,0,193,2,6147
534500,2022-04-06,Lorena/SP,0,193,42,6189
540097,2022-04-07,Lorena/SP,0,193,27,6216
545694,2022-04-08,Lorena/SP,0,193,30,6246
551291,2022-04-09,Lorena/SP,0,193,44,6290
556888,2022-04-10,Lorena/SP,0,193,0,6290
562485,2022-04-11,Lorena/SP,0,193,0,6290
568082,2022-04-12,Lorena/SP,0,193,70,6360
573679,2022-04-13,Lorena/SP,0,193,140,6500
579276,2022-04-14,Lorena/SP,0,193,1,6501
584873,2022-04-15,Lorena/SP,0,193,0,6501
590470,2022-04-16,Lorena/SP,0,193,0,6501
596067,2022-04-17,Lorena/SP,0,193,0,6501
601664,2022-04-18,Lorena/SP,0,193,0,6501
607261,2022-04-19,Lorena/SP,0,193,0,6501
612858,2022-04-20,Lorena/SP,2,195,9,6510
618455,2022-04-21,Lorena/SP,1,196,2,6512
624052,2022-04-22,Lorena/SP,0,196,0,6512
629649,2022-04-23,Lorena/SP,0,196,0,6512
635246,2022-04-24,Lorena/SP,0,196,0,6512
640843,2022-04-25,Lorena/SP,0,196,0,6512
646440,2022-04-26,Lorena/SP,0,196,9,6521
652037,2022-04-27,Lorena/SP,4,200,0,6521
657634,2022-04-28,Lorena/SP,2,202,6,6527
663231,2022-04-29,Lorena/SP,0,202,0,6527
668828,2022-04-30,Lorena/SP,0,202,0,6527
674425,2022-05-01,Lorena/SP,0,202,0,6527
680022,2022-05-02,Lorena/SP,0,202,0,6527
685619,2022-05-03,Lorena/SP,0,202,5,6532
691216,2022-05-04,Lorena/SP,0,202,3,6535
696813,2022-05-05,Lorena/SP,0,202,0,6535
702410,2022-05-06,Lorena/SP,0,202,23,6558
708007,2022-05-07,Lorena/SP,0,202,6,6564
713604,2022-05-08,Lorena/SP,0,202,5,6569
719201,2022-05-09,Lorena/SP,0,202,0,6569
724798,2022-05-10,Lorena/SP,0,202,0,6569
730395,2022-05-11,Lorena/SP,0,202,1,6570
735992,2022-05-12,Lorena/SP,0,202,12,6582
741589,2022-05-13,Lorena/SP,0,202,45,6627
747186,2022-05-14,Lorena/SP,0,202,15,6642
752783,2022-05-15,Lorena/SP,0,202,0,6642
758380,2022-05-16,Lorena/SP,0,202,30,6672
763977,2022-05-17,Lorena/SP,0,202,0,6672
769574,2022-05-18,Lorena/SP,0,202,1,6673
775171,2022-05-19,Lorena/SP,0,202,0,6673
780768,2022-05-20,Lorena/SP,0,202,0,6673
786365,2022-05-21,Lorena/SP,0,202,0,6673
791962,2022-05-22,Lorena/SP,0,202,0,6673
797559,2022-05-23,Lorena/SP,0,202,0,6673
803156,2022-05-24,Lorena/SP,0,202,38,6711
808753,2022-05-25,Lorena/SP,0,202,0,6711
814350,2022-05-26,Lorena/SP,0,202,6,6717
819947,2022-05-27,Lorena/SP,0,202,8,6725
825544,2022-05-28,Lorena/SP,0,202,41,6766
831141,2022-05-29,Lorena/SP,0,202,0,6766
836738,2022-05-30,Lorena/SP,0,202,5,6771
842335,2022-05-31,Lorena/SP,0,202,0,6771
847932,2022-06-01,Lorena/SP,0,202,0,6771
853529,2022-06-02,Lorena/SP,0,202,0,6771
859126,2022-06-03,Lorena/SP,0,202,0,6771
864723,2022-06-04,Lorena/SP,0,202,0,6771
870320,2022-06-05,Lorena/SP,0,202,0,6771
875917,2022-06-06,Lorena/SP,0,202,0,6771
881514,2022-06-07,Lorena/SP,5,207,6,6777
887111,2022-06-08,Lorena/SP,6,213,0,6777
892708,2022-06-09,Lorena/SP,6,219,0,6777
898305,2022-06-10,Lorena/SP,2,221,4,6781
903902,2022-06-11,Lorena/SP,0,221,0,6781
909499,2022-06-12,Lorena/SP,0,221,0,6781
915096,2022-06-13,Lorena/SP,0,221,0,6781
920693,2022-06-14,Lorena/SP,0,221,0,6781
926290,2022-06-15,Lorena/SP,1,222,3,6784
931887,2022-06-16,Lorena/SP,0,222,0,6784
937484,2022-06-17,Lorena/SP,0,222,0,6784
943081,2022-06-18,Lorena/SP,0,222,0,6784
948678,2022-06-19,Lorena/SP,0,222,0,6784
954275,2022-06-20,Lorena/SP,0,222,0,6784
959872,2022-06-21,Lorena/SP,0,222,0,6784
965469,2022-06-22,Lorena/SP,0,222,1,6785
971066,2022-06-23,Lorena/SP,2,224,3,6788
976663,2022-06-24,Lorena/SP,0,224,0,6788
982260,2022-06-25,Lorena/SP,0,224,0,6788
987857,2022-06-26,Lorena/SP,0,224,0,6788
993454,2022-06-27,Lorena/SP,0,224,0,6788
999051,2022-06-28,Lorena/SP,2,226,4,6792
1004648,2022-06-29,Lorena/SP,0,226,1,6793
1010245,2022-06-30,Lorena/SP,0,226,0,6793
1015842,2022-07-01,Lorena/SP,0,226,0,6793
1021439,2022-07-02,Lorena/SP,0,226,0,6793
1027036,2022-07-03,Lorena/SP,0,226,0,6793
1032633,2022-07-04,Lorena/SP,0,226,0,6793
1038230,2022-07-05,Lorena/SP,0,226,2,6795
1043827,2022-07-06,Lorena/SP,0,226,0,6795
1049424,2022-07-07,Lorena/SP,0,226,0,6795
1055021,2022-07-08,Lorena/SP,0,226,1,6796
1060618,2022-07-09,Lorena/SP,0,226,0,6796
1066215,2022-07-10,Lorena/SP,0,226,0,6796
1071812,2022-07-11,Lorena/SP,0,226,0,6796
1077409,2022-07-12,Lorena/SP,0,226,0,6796
1083006,2022-07-13,Lorena/SP,0,226,9,6805
1088603,2022-07-14,Lorena/SP,0,226,0,6805
1094200,2022-07-15,Lorena/SP,0,226,0,6805
1099797,2022-07-16,Lorena/SP,0,226,0,6805
1105394,2022-07-17,Lorena/SP,0,226,0,6805
1110991,2022-07-18,Lorena/SP,0,226,0,6805
1116588,2022-07-19,Lorena/SP,0,226,0,6805
1122185,2022-07-20,Lorena/SP,0,226,1,6806
1127782,2022-07-21,Lorena/SP,0,226,1,6807
1133379,2022-07-22,Lorena/SP,0,226,0,6807
1138976,2022-07-23,Lorena/SP,0,226,0,6807
1144573,2022-07-24,Lorena/SP,0,226,4,6811
1150170,2022-07-25,Lorena/SP,0,226,0,6811
1155767,2022-07-26,Lorena/SP,1,227,2,6813
1161364,2022-07-27,Lorena/SP,1,228,7,6820
1166961,2022-07-28,Lorena/SP,4,232,8,6828
1172558,2022-07-29,Lorena/SP,0,232,0,6828
1178155,2022-07-30,Lorena/SP,0,232,0,6828
1183752,2022-07-31,Lorena/SP,0,232,0,6828
1189349,2022-08-01,Lorena/SP,0,232,0,6828
1194946,2022-08-02,Lorena/SP,0,232,1,6829
1200543,2022-08-03,Lorena/SP,0,232,0,6829
1206140,2022-08-04,Lorena/SP,0,232,0,6829
1211737,2022-08-05,Lorena/SP,1,233,2,6831
1217334,2022-08-06,Lorena/SP,0,233,15,6846
1222931,2022-08-07,Lorena/SP,0,233,1,6847
1228528,2022-08-08,Lorena/SP,0,233,0,6847
1234125,2022-08-09,Lorena/SP,1,234,26,6873
1239722,2022-08-10,Lorena/SP,1,235,10,6883
1245319,2022-08-11,Lorena/SP,0,235,4,6887
1250916,2022-08-12,Lorena/SP,0,235,4,6891
1256513,2022-08-13,Lorena/SP,1,236,6,6897
1262110,2022-08-14,Lorena/SP,0,236,0,6897
1267707,2022-08-15,Lorena/SP,0,236,1,6898
1273304,2022-08-16,Lorena/SP,0,236,0,6898
1278901,2022-08-17,Lorena/SP,0,236,0,6898
1284498,2022-08-18,Lorena/SP,1,237,11,6909
1290095,2022-08-19,Lorena/SP,0,237,-1,6908
1295692,2022-08-20,Lorena/SP,0,237,0,6908
1301289,2022-08-21,Lorena/SP,0,237,-1,6907
1306886,2022-08-22,Lorena/SP,0,237,0,6907
1312483,2022-08-23,Lorena/SP,0,237,0,6907
1318080,2022-08-24,Lorena/SP,0,237,0,6907
1323677,2022-08-25,Lorena/SP,0,237,66,6973
3775,2022-01-01,Pindamonhangaba/SP,0,459,0,15269
9372,2022-01-02,Pindamonhangaba/SP,0,459,0,15269
14969,2022-01-03,Pindamonhangaba/SP,0,459,0,15269
20566,2022-01-04,Pindamonhangaba/SP,0,459,0,15269
26163,2022-01-05,Pindamonhangaba/SP,0,459,1,15270
31760,2022-01-06,Pindamonhangaba/SP,0,459,0,15270
37357,2022-01-07,Pindamonhangaba/SP,0,459,0,15270
42954,2022-01-08,Pindamonhangaba/SP,0,459,0,15270
48551,2022-01-09,Pindamonhangaba/SP,0,459,1,15271
54148,2022-01-10,Pindamonhangaba/SP,0,459,0,15271
59745,2022-01-11,Pindamonhangaba/SP,0,459,0,15271
65342,2022-01-12,Pindamonhangaba/SP,0,459,0,15271
70939,2022-01-13,Pindamonhangaba/SP,0,459,0,15271
76536,2022-01-14,Pindamonhangaba/SP,0,459,0,15271
82133,2022-01-15,Pindamonhangaba/SP,0,459,0,15271
87730,2022-01-16,Pindamonhangaba/SP,0,459,0,15271
93327,2022-01-17,Pindamonhangaba/SP,0,459,1,15272
98924,2022-01-18,Pindamonhangaba/SP,0,459,0,15272
104521,2022-01-19,Pindamonhangaba/SP,7,466,13,15285
110118,2022-01-20,Pindamonhangaba/SP,4,470,5,15290
115715,2022-01-21,Pindamonhangaba/SP,0,470,0,15290
121312,2022-01-22,Pindamonhangaba/SP,0,470,0,15290
126909,2022-01-23,Pindamonhangaba/SP,-1,469,0,15290
132506,2022-01-24,Pindamonhangaba/SP,0,469,0,15290
138103,2022-01-25,Pindamonhangaba/SP,0,469,0,15290
143700,2022-01-26,Pindamonhangaba/SP,0,469,0,15290
149297,2022-01-27,Pindamonhangaba/SP,0,469,0,15290
154894,2022-01-28,Pindamonhangaba/SP,0,469,2,15292
160491,2022-01-29,Pindamonhangaba/SP,0,469,0,15292
166088,2022-01-30,Pindamonhangaba/SP,0,469,0,15292
171685,2022-01-31,Pindamonhangaba/SP,0,469,0,15292
177282,2022-02-01,Pindamonhangaba/SP,0,469,0,15292
182879,2022-02-02,Pindamonhangaba/SP,0,469,0,15292
188476,2022-02-03,Pindamonhangaba/SP,0,469,2,15294
194073,2022-02-04,Pindamonhangaba/SP,0,469,0,15294
199670,2022-02-05,Pindamonhangaba/SP,0,469,22,15316
205267,2022-02-06,Pindamonhangaba/SP,0,469,0,15316
210864,2022-02-07,Pindamonhangaba/SP,0,469,0,15316
216461,2022-02-08,Pindamonhangaba/SP,10,479,12,15328
222058,2022-02-09,Pindamonhangaba/SP,2,481,6,15334
227655,2022-02-10,Pindamonhangaba/SP,0,481,3,15337
233252,2022-02-11,Pindamonhangaba/SP,0,481,0,15337
238849,2022-02-12,Pindamonhangaba/SP,0,481,7,15344
244446,2022-02-13,Pindamonhangaba/SP,0,481,0,15344
250043,2022-02-14,Pindamonhangaba/SP,0,481,0,15344
255640,2022-02-15,Pindamonhangaba/SP,0,481,0,15344
261237,2022-02-16,Pindamonhangaba/SP,12,493,12,15356
266834,2022-02-17,Pindamonhangaba/SP,1,494,13,15369
272431,2022-02-18,Pindamonhangaba/SP,0,494,1,15370
278028,2022-02-19,Pindamonhangaba/SP,0,494,0,15370
283625,2022-02-20,Pindamonhangaba/SP,0,494,2,15372
289222,2022-02-21,Pindamonhangaba/SP,0,494,0,15372
294819,2022-02-22,Pindamonhangaba/SP,17,511,16,15388
300416,2022-02-23,Pindamonhangaba/SP,0,511,28,15416
306013,2022-02-24,Pindamonhangaba/SP,0,511,16,15432
311610,2022-02-25,Pindamonhangaba/SP,1,512,4,15436
317207,2022-02-26,Pindamonhangaba/SP,0,512,0,15436
322804,2022-02-27,Pindamonhangaba/SP,0,512,0,15436
328401,2022-02-28,Pindamonhangaba/SP,0,512,1,15437
333998,2022-03-01,Pindamonhangaba/SP,0,512,0,15437
339595,2022-03-02,Pindamonhangaba/SP,0,512,0,15437
345192,2022-03-03,Pindamonhangaba/SP,0,512,30,15467
350789,2022-03-04,Pindamonhangaba/SP,2,514,2,15469
356386,2022-03-05,Pindamonhangaba/SP,3,517,5,15474
361983,2022-03-06,Pindamonhangaba/SP,0,517,0,15474
367580,2022-03-07,Pindamonhangaba/SP,0,517,0,15474
373177,2022-03-08,Pindamonhangaba/SP,8,525,5,15479
378774,2022-03-09,Pindamonhangaba/SP,1,526,1,15480
384371,2022-03-10,Pindamonhangaba/SP,1,527,2,15482
389968,2022-03-11,Pindamonhangaba/SP,3,530,3,15485
395565,2022-03-12,Pindamonhangaba/SP,0,530,2,15487
401162,2022-03-13,Pindamonhangaba/SP,0,530,0,15487
406759,2022-03-14,Pindamonhangaba/SP,0,530,1,15488
412356,2022-03-15,Pindamonhangaba/SP,0,530,4,15492
417953,2022-03-16,Pindamonhangaba/SP,4,534,12,15504
423550,2022-03-17,Pindamonhangaba/SP,4,538,6,15510
429147,2022-03-18,Pindamonhangaba/SP,0,538,0,15510
434744,2022-03-19,Pindamonhangaba/SP,0,538,0,15510
440341,2022-03-20,Pindamonhangaba/SP,0,538,0,15510
445938,2022-03-21,Pindamonhangaba/SP,0,538,0,15510
451535,2022-03-22,Pindamonhangaba/SP,0,538,2,15512
457132,2022-03-23,Pindamonhangaba/SP,0,538,0,15512
462729,2022-03-24,Pindamonhangaba/SP,0,538,0,15512
468326,2022-03-25,Pindamonhangaba/SP,1,539,16,15528
473923,2022-03-26,Pindamonhangaba/SP,0,539,2,15530
479520,2022-03-27,Pindamonhangaba/SP,0,539,0,15530
485117,2022-03-28,Pindamonhangaba/SP,0,539,0,15530
490714,2022-03-29,Pindamonhangaba/SP,4,543,3,15533
496311,2022-03-30,Pindamonhangaba/SP,0,543,0,15533
501908,2022-03-31,Pindamonhangaba/SP,0,543,0,15533
507505,2022-04-01,Pindamonhangaba/SP,0,543,0,15533
513102,2022-04-02,Pindamonhangaba/SP,0,543,0,15533
518699,2022-04-03,Pindamonhangaba/SP,0,543,0,15533
524296,2022-04-04,Pindamonhangaba/SP,0,543,0,15533
529893,2022-04-05,Pindamonhangaba/SP,0,543,-1,15532
535490,2022-04-06,Pindamonhangaba/SP,0,543,0,15532
541087,2022-04-07,Pindamonhangaba/SP,0,543,2,15534
546684,2022-04-08,Pindamonhangaba/SP,0,543,0,15534
552281,2022-04-09,Pindamonhangaba/SP,0,543,0,15534
557878,2022-04-10,Pindamonhangaba/SP,0,543,0,15534
563475,2022-04-11,Pindamonhangaba/SP,0,543,0,15534
569072,2022-04-12,Pindamonhangaba/SP,0,543,1,15535
574669,2022-04-13,Pindamonhangaba/SP,0,543,1,15536
580266,2022-04-14,Pindamonhangaba/SP,1,544,5,15541
585863,2022-04-15,Pindamonhangaba/SP,0,544,0,15541
591460,2022-04-16,Pindamonhangaba/SP,0,544,0,15541
597057,2022-04-17,Pindamonhangaba/SP,0,544,0,15541
602654,2022-04-18,Pindamonhangaba/SP,0,544,0,15541
608251,2022-04-19,Pindamonhangaba/SP,0,544,0,15541
613848,2022-04-20,Pindamonhangaba/SP,0,544,0,15541
619445,2022-04-21,Pindamonhangaba/SP,2,546,3,15544
625042,2022-04-22,Pindamonhangaba/SP,0,546,0,15544
630639,2022-04-23,Pindamonhangaba/SP,0,546,0,15544
636236,2022-04-24,Pindamonhangaba/SP,0,546,0,15544
641833,2022-04-25,Pindamonhangaba/SP,0,546,0,15544
647430,2022-04-26,Pindamonhangaba/SP,0,546,0,15544
653027,2022-04-27,Pindamonhangaba/SP,0,546,0,15544
658624,2022-04-28,Pindamonhangaba/SP,0,546,0,15544
664221,2022-04-29,Pindamonhangaba/SP,0,546,0,15544
669818,2022-04-30,Pindamonhangaba/SP,0,546,1,15545
675415,2022-05-01,Pindamonhangaba/SP,0,546,0,15545
681012,2022-05-02,Pindamonhangaba/SP,0,546,0,15545
686609,2022-05-03,Pindamonhangaba/SP,0,546,0,15545
692206,2022-05-04,Pindamonhangaba/SP,0,546,0,15545
697803,2022-05-05,Pindamonhangaba/SP,0,546,0,15545
703400,2022-05-06,Pindamonhangaba/SP,0,546,0,15545
708997,2022-05-07,Pindamonhangaba/SP,0,546,0,15545
714594,2022-05-08,Pindamonhangaba/SP,0,546,0,15545
720191,2022-05-09,Pindamonhangaba/SP,0,546,0,15545
725788,2022-05-10,Pindamonhangaba/SP,0,546,2,15547
731385,2022-05-11,Pindamonhangaba/SP,0,546,4,15551
736982,2022-05-12,Pindamonhangaba/SP,0,546,0,15551
742579,2022-05-13,Pindamonhangaba/SP,0,546,0,15551
748176,2022-05-14,Pindamonhangaba/SP,0,546,0,15551
753773,2022-05-15,Pindamonhangaba/SP,0,546,0,15551
759370,2022-05-16,Pindamonhangaba/SP,0,546,0,15551
764967,2022-05-17,Pindamonhangaba/SP,0,546,0,15551
770564,2022-05-18,Pindamonhangaba/SP,0,546,0,15551
776161,2022-05-19,Pindamonhangaba/SP,0,546,0,15551
781758,2022-05-20,Pindamonhangaba/SP,0,546,0,15551
787355,2022-05-21,Pindamonhangaba/SP,0,546,0,15551
792952,2022-05-22,Pindamonhangaba/SP,0,546,-2,15549
798549,2022-05-23,Pindamonhangaba/SP,0,546,0,15549
804146,2022-05-24,Pindamonhangaba/SP,0,546,0,15549
809743,2022-05-25,Pindamonhangaba/SP,0,546,0,15549
815340,2022-05-26,Pindamonhangaba/SP,0,546,0,15549
820937,2022-05-27,Pindamonhangaba/SP,1,547,2,15551
826534,2022-05-28,Pindamonhangaba/SP,0,547,1,15552
832131,2022-05-29,Pindamonhangaba/SP,0,547,0,15552
837728,2022-05-30,Pindamonhangaba/SP,0,547,0,15552
843325,2022-05-31,Pindamonhangaba/SP,0,547,0,15552
848922,2022-06-01,Pindamonhangaba/SP,0,547,1,15553
854519,2022-06-02,Pindamonhangaba/SP,0,547,1,15554
860116,2022-06-03,Pindamonhangaba/SP,0,547,0,15554
865713,2022-06-04,Pindamonhangaba/SP,0,547,0,15554
871310,2022-06-05,Pindamonhangaba/SP,0,547,0,15554
876907,2022-06-06,Pindamonhangaba/SP,0,547,0,15554
882504,2022-06-07,Pindamonhangaba/SP,1,548,7,15561
888101,2022-06-08,Pindamonhangaba/SP,0,548,2,15563
893698,2022-06-09,Pindamonhangaba/SP,0,548,0,15563
899295,2022-06-10,Pindamonhangaba/SP,-1,547,-3,15560
904892,2022-06-11,Pindamonhangaba/SP,0,547,1,15561
910489,2022-06-12,Pindamonhangaba/SP,0,547,0,15561
916086,2022-06-13,Pindamonhangaba/SP,0,547,0,15561
921683,2022-06-14,Pindamonhangaba/SP,0,547,0,15561
927280,2022-06-15,Pindamonhangaba/SP,0,547,0,15561
932877,2022-06-16,Pindamonhangaba/SP,0,547,2,15563
938474,2022-06-17,Pindamonhangaba/SP,0,547,0,15563
944071,2022-06-18,Pindamonhangaba/SP,0,547,0,15563
949668,2022-06-19,Pindamonhangaba/SP,0,547,0,15563
955265,2022-06-20,Pindamonhangaba/SP,0,547,0,15563
960862,2022-06-21,Pindamonhangaba/SP,0,547,3,15566
966459,2022-06-22,Pindamonhangaba/SP,0,547,1,15567
972056,2022-06-23,Pindamonhangaba/SP,4,551,3,15570
977653,2022-06-24,Pindamonhangaba/SP,0,551,0,15570
983250,2022-06-25,Pindamonhangaba/SP,0,551,1,15571
988847,2022-06-26,Pindamonhangaba/SP,0,551,1,15572
994444,2022-06-27,Pindamonhangaba/SP,0,551,0,15572
1000041,2022-06-28,Pindamonhangaba/SP,0,551,0,15572
1005638,2022-06-29,Pindamonhangaba/SP,0,551,9,15581
1011235,2022-06-30,Pindamonhangaba/SP,0,551,1,15582
1016832,2022-07-01,Pindamonhangaba/SP,1,552,9,15591
1022429,2022-07-02,Pindamonhangaba/SP,0,552,0,15591
1028026,2022-07-03,Pindamonhangaba/SP,0,552,0,15591
1033623,2022-07-04,Pindamonhangaba/SP,0,552,0,15591
1039220,2022-07-05,Pindamonhangaba/SP,0,552,1,15592
1044817,2022-07-06,Pindamonhangaba/SP,0,552,0,15592
1050414,2022-07-07,Pindamonhangaba/SP,0,552,10,15602
1056011,2022-07-08,Pindamonhangaba/SP,0,552,1,15603
1061608,2022-07-09,Pindamonhangaba/SP,3,555,4,15607
1067205,2022-07-10,Pindamonhangaba/SP,0,555,0,15607
1072802,2022-07-11,Pindamonhangaba/SP,0,555,0,15607
1078399,2022-07-12,Pindamonhangaba/SP,0,555,0,15607
1083996,2022-07-13,Pindamonhangaba/SP,0,555,1,15608
1089593,2022-07-14,Pindamonhangaba/SP,0,555,0,15608
1095190,2022-07-15,Pindamonhangaba/SP,3,558,10,15618
1100787,2022-07-16,Pindamonhangaba/SP,1,559,1,15619
1106384,2022-07-17,Pindamonhangaba/SP,0,559,0,15619
1111981,2022-07-18,Pindamonhangaba/SP,0,559,0,15619
1117578,2022-07-19,Pindamonhangaba/SP,0,559,3,15622
1123175,2022-07-20,Pindamonhangaba/SP,0,559,1,15623
1128772,2022-07-21,Pindamonhangaba/SP,0,559,1,15624
1134369,2022-07-22,Pindamonhangaba/SP,3,562,3,15627
1139966,2022-07-23,Pindamonhangaba/SP,0,562,6,15633
1145563,2022-07-24,Pindamonhangaba/SP,0,562,0,15633
1151160,2022-07-25,Pindamonhangaba/SP,0,562,1,15634
1156757,2022-07-26,Pindamonhangaba/SP,0,562,0,15634
1162354,2022-07-27,Pindamonhangaba/SP,0,562,0,15634
1167951,2022-07-28,Pindamonhangaba/SP,0,562,1,15635
1173548,2022-07-29,Pindamonhangaba/SP,8,570,12,15647
1179145,2022-07-30,Pindamonhangaba/SP,0,570,0,15647
1184742,2022-07-31,Pindamonhangaba/SP,0,570,0,15647
1190339,2022-08-01,Pindamonhangaba/SP,0,570,0,15647
1195936,2022-08-02,Pindamonhangaba/SP,0,570,0,15647
1201533,2022-08-03,Pindamonhangaba/SP,0,570,0,15647
1207130,2022-08-04,Pindamonhangaba/SP,0,570,0,15647
1212727,2022-08-05,Pindamonhangaba/SP,1,571,1,15648
1218324,2022-08-06,Pindamonhangaba/SP,0,571,4,15652
1223921,2022-08-07,Pindamonhangaba/SP,0,571,0,15652
1229518,2022-08-08,Pindamonhangaba/SP,0,571,0,15652
1235115,2022-08-09,Pindamonhangaba/SP,0,571,0,15652
1240712,2022-08-10,Pindamonhangaba/SP,0,571,1,15653
1246309,2022-08-11,Pindamonhangaba/SP,0,571,0,15653
1251906,2022-08-12,Pindamonhangaba/SP,0,571,0,15653
1257503,2022-08-13,Pindamonhangaba/SP,0,571,0,15653
1263100,2022-08-14,Pindamonhangaba/SP,0,571,0,15653
1268697,2022-08-15,Pindamonhangaba/SP,0,571,0,15653
1274294,2022-08-16,Pindamonhangaba/SP,0,571,-1,15652
1279891,2022-08-17,Pindamonhangaba/SP,1,572,3,15655
1285488,2022-08-18,Pindamonhangaba/SP,0,572,0,15655
1291085,2022-08-19,Pindamonhangaba/SP,0,572,0,15655
1296682,2022-08-20,Pindamonhangaba/SP,0,572,0,15655
1302279,2022-08-21,Pindamonhangaba/SP,0,572,0,15655
1307876,2022-08-22,Pindamonhangaba/SP,0,572,0,15655
1313473,2022-08-23,Pindamonhangaba/SP,3,575,1,15656
1319070,2022-08-24,Pindamonhangaba/SP,0,575,1,15657
1324667,2022-08-25,Pindamonhangaba/SP,0,575,0,15657
4905,2022-01-01,São José dos Campos/SP,0,1978,62,94347
10502,2022-01-02,São José dos Campos/SP,0,1978,92,94439
16099,2022-01-03,São José dos Campos/SP,0,1978,49,94488
21696,2022-01-04,São José dos Campos/SP,2,1980,105,94593
27293,2022-01-05,São José dos Campos/SP,0,1980,198,94791
32890,2022-01-06,São José dos Campos/SP,0,1980,231,95022
38487,2022-01-07,São José dos Campos/SP,0,1980,167,95189
44084,2022-01-08,São José dos Campos/SP,1,1981,267,95456
49681,2022-01-09,São José dos Campos/SP,0,1981,142,95598
55278,2022-01-10,São José dos Campos/SP,0,1981,160,95758
60875,2022-01-11,São José dos Campos/SP,2,1983,246,96004
66472,2022-01-12,São José dos Campos/SP,0,1983,260,96264
72069,2022-01-13,São José dos Campos/SP,0,1983,279,96543
77666,2022-01-14,São José dos Campos/SP,2,1985,320,96863
83263,2022-01-15,São José dos Campos/SP,5,1990,58,96921
88860,2022-01-16,São José dos Campos/SP,0,1990,185,97106
94457,2022-01-17,São José dos Campos/SP,1,1991,181,97287
100054,2022-01-18,São José dos Campos/SP,3,1994,400,97687
105651,2022-01-19,São José dos Campos/SP,0,1994,230,97917
111248,2022-01-20,São José dos Campos/SP,8,2002,391,98308
116845,2022-01-21,São José dos Campos/SP,6,2008,388,98696
122442,2022-01-22,São José dos Campos/SP,0,2008,0,98696
128039,2022-01-23,São José dos Campos/SP,6,2014,875,99571
133636,2022-01-24,São José dos Campos/SP,4,2018,208,99779
139233,2022-01-25,São José dos Campos/SP,6,2024,229,100008
144830,2022-01-26,São José dos Campos/SP,11,2035,352,100360
150427,2022-01-27,São José dos Campos/SP,8,2043,293,100653
156024,2022-01-28,São José dos Campos/SP,12,2055,335,100988
161621,2022-01-29,São José dos Campos/SP,8,2063,266,101254
167218,2022-01-30,São José dos Campos/SP,6,2069,148,101402
172815,2022-01-31,São José dos Campos/SP,0,2069,0,101402
178412,2022-02-01,São José dos Campos/SP,-1,2068,298,101700
184009,2022-02-02,São José dos Campos/SP,17,2085,19,101719
189606,2022-02-03,São José dos Campos/SP,6,2091,410,102129
195203,2022-02-04,São José dos Campos/SP,0,2091,0,102129
200800,2022-02-05,São José dos Campos/SP,12,2103,400,102529
206397,2022-02-06,São José dos Campos/SP,6,2109,38,102567
211994,2022-02-07,São José dos Campos/SP,0,2109,121,102688
217591,2022-02-08,São José dos Campos/SP,0,2109,171,102859
223188,2022-02-09,São José dos Campos/SP,8,2117,207,103066
228785,2022-02-10,São José dos Campos/SP,4,2121,199,103265
234382,2022-02-11,São José dos Campos/SP,5,2126,305,103570
239979,2022-02-12,São José dos Campos/SP,3,2129,145,103715
245576,2022-02-13,São José dos Campos/SP,0,2129,184,103899
251173,2022-02-14,São José dos Campos/SP,0,2129,76,103975
256770,2022-02-15,São José dos Campos/SP,9,2138,176,104151
262367,2022-02-16,São José dos Campos/SP,3,2141,252,104403
267964,2022-02-17,São José dos Campos/SP,4,2145,95,104498
273561,2022-02-18,São José dos Campos/SP,4,2149,202,104700
279158,2022-02-19,São José dos Campos/SP,3,2152,182,104882
284755,2022-02-20,São José dos Campos/SP,0,2152,113,104995
290352,2022-02-21,São José dos Campos/SP,0,2152,175,105170
295949,2022-02-22,São José dos Campos/SP,7,2159,243,105413
301546,2022-02-23,São José dos Campos/SP,2,2161,177,105590
307143,2022-02-24,São José dos Campos/SP,4,2165,391,105981
312740,2022-02-25,São José dos Campos/SP,4,2169,269,106250
318337,2022-02-26,São José dos Campos/SP,5,2174,193,106443
323934,2022-02-27,São José dos Campos/SP,0,2174,113,106556
329531,2022-02-28,São José dos Campos/SP,0,2174,147,106703
335128,2022-03-01,São José dos Campos/SP,0,2174,221,106924
340725,2022-03-02,São José dos Campos/SP,0,2174,90,107014
346322,2022-03-03,São José dos Campos/SP,0,2174,271,107285
351919,2022-03-04,São José dos Campos/SP,4,2178,173,107458
357516,2022-03-05,São José dos Campos/SP,4,2182,94,107552
363113,2022-03-06,São José dos Campos/SP,0,2182,16,107568
368710,2022-03-07,São José dos Campos/SP,1,2183,67,107635
374307,2022-03-08,São José dos Campos/SP,2,2185,137,107772
379904,2022-03-09,São José dos Campos/SP,0,2185,269,108041
385501,2022-03-10,São José dos Campos/SP,0,2185,156,108197
391098,2022-03-11,São José dos Campos/SP,1,2186,62,108259
396695,2022-03-12,São José dos Campos/SP,1,2187,55,108314
402292,2022-03-13,São José dos Campos/SP,0,2187,13,108327
407889,2022-03-14,São José dos Campos/SP,0,2187,34,108361
413486,2022-03-15,São José dos Campos/SP,2,2189,36,108397
419083,2022-03-16,São José dos Campos/SP,2,2191,58,108455
424680,2022-03-17,São José dos Campos/SP,0,2191,86,108541
430277,2022-03-18,São José dos Campos/SP,5,2196,132,108673
435874,2022-03-19,São José dos Campos/SP,5,2201,40,108713
441471,2022-03-20,São José dos Campos/SP,0,2201,9,108722
447068,2022-03-21,São José dos Campos/SP,0,2201,5,108727
452665,2022-03-22,São José dos Campos/SP,-2,2199,40,108767
458262,2022-03-23,São José dos Campos/SP,-5,2194,30,108797
463859,2022-03-24,São José dos Campos/SP,1,2195,22,108819
469456,2022-03-25,São José dos Campos/SP,1,2196,128,108947
475053,2022-03-26,São José dos Campos/SP,1,2197,138,109085
480650,2022-03-27,São José dos Campos/SP,0,2197,15,109100
486247,2022-03-28,São José dos Campos/SP,0,2197,29,109129
491844,2022-03-29,São José dos Campos/SP,0,2197,12,109141
497441,2022-03-30,São José dos Campos/SP,0,2197,32,109173
503038,2022-03-31,São José dos Campos/SP,0,2197,60,109233
508635,2022-04-01,São José dos Campos/SP,0,2197,75,109308
514232,2022-04-02,São José dos Campos/SP,0,2197,97,109405
519829,2022-04-03,São José dos Campos/SP,0,2197,19,109424
525426,2022-04-04,São José dos Campos/SP,0,2197,58,109482
531023,2022-04-05,São José dos Campos/SP,4,2201,191,109673
536620,2022-04-06,São José dos Campos/SP,-2,2199,174,109847
542217,2022-04-07,São José dos Campos/SP,-1,2198,86,109933
547814,2022-04-08,São José dos Campos/SP,-1,2197,58,109991
553411,2022-04-09,São José dos Campos/SP,0,2197,89,110080
559008,2022-04-10,São José dos Campos/SP,0,2197,42,110122
564605,2022-04-11,São José dos Campos/SP,0,2197,28,110150
570202,2022-04-12,São José dos Campos/SP,0,2197,78,110228
575799,2022-04-13,São José dos Campos/SP,1,2198,96,110324
581396,2022-04-14,São José dos Campos/SP,1,2199,58,110382
586993,2022-04-15,São José dos Campos/SP,0,2199,123,110505
592590,2022-04-16,São José dos Campos/SP,0,2199,10,110515
598187,2022-04-17,São José dos Campos/SP,0,2199,0,110515
603784,2022-04-18,São José dos Campos/SP,0,2199,42,110557
609381,2022-04-19,São José dos Campos/SP,0,2199,0,110557
614978,2022-04-20,São José dos Campos/SP,0,2199,190,110747
620575,2022-04-21,São José dos Campos/SP,1,2200,98,110845
626172,2022-04-22,São José dos Campos/SP,1,2201,16,110861
631769,2022-04-23,São José dos Campos/SP,1,2202,30,110891
637366,2022-04-24,São José dos Campos/SP,0,2202,30,110921
642963,2022-04-25,São José dos Campos/SP,0,2202,9,110930
648560,2022-04-26,São José dos Campos/SP,1,2203,69,110999
654157,2022-04-27,São José dos Campos/SP,-1,2202,59,111058
659754,2022-04-28,São José dos Campos/SP,-2,2200,119,111177
665351,2022-04-29,São José dos Campos/SP,0,2200,70,111247
670948,2022-04-30,São José dos Campos/SP,0,2200,71,111318
676545,2022-05-01,São José dos Campos/SP,0,2200,16,111334
682142,2022-05-02,São José dos Campos/SP,0,2200,12,111346
687739,2022-05-03,São José dos Campos/SP,0,2200,87,111433
693336,2022-05-04,São José dos Campos/SP,0,2200,60,111493
698933,2022-05-05,São José dos Campos/SP,0,2200,113,111606
704530,2022-05-06,São José dos Campos/SP,0,2200,156,111762
710127,2022-05-07,São José dos Campos/SP,0,2200,128,111890
715724,2022-05-08,São José dos Campos/SP,0,2200,27,111917
721321,2022-05-09,São José dos Campos/SP,0,2200,15,111932
726918,2022-05-10,São José dos Campos/SP,0,2200,65,111997
732515,2022-05-11,São José dos Campos/SP,0,2200,116,112113
738112,2022-05-12,São José dos Campos/SP,0,2200,68,112181
743709,2022-05-13,São José dos Campos/SP,2,2202,124,112305
749306,2022-05-14,São José dos Campos/SP,0,2202,160,112465
754903,2022-05-15,São José dos Campos/SP,0,2202,18,112483
760500,2022-05-16,São José dos Campos/SP,0,2202,75,112558
766097,2022-05-17,São José dos Campos/SP,0,2202,43,112601
771694,2022-05-18,São José dos Campos/SP,0,2202,26,112627
777291,2022-05-19,São José dos Campos/SP,0,2202,21,112648
782888,2022-05-20,São José dos Campos/SP,0,2202,0,112648
788485,2022-05-21,São José dos Campos/SP,0,2202,0,112648
794082,2022-05-22,São José dos Campos/SP,0,2202,250,112898
799679,2022-05-23,São José dos Campos/SP,0,2202,71,112969
805276,2022-05-24,São José dos Campos/SP,0,2202,193,113162
810873,2022-05-25,São José dos Campos/SP,4,2206,54,113216
816470,2022-05-26,São José dos Campos/SP,1,2207,146,113362
822067,2022-05-27,São José dos Campos/SP,1,2208,79,113441
827664,2022-05-28,São José dos Campos/SP,-3,2205,189,113630
833261,2022-05-29,São José dos Campos/SP,0,2205,62,113692
838858,2022-05-30,São José dos Campos/SP,0,2205,59,113751
844455,2022-05-31,São José dos Campos/SP,0,2205,144,113895
850052,2022-06-01,São José dos Campos/SP,0,2205,170,114065
855649,2022-06-02,São José dos Campos/SP,0,2205,157,114222
861246,2022-06-03,São José dos Campos/SP,0,2205,0,114222
866843,2022-06-04,São José dos Campos/SP,0,2205,0,114222
872440,2022-06-05,São José dos Campos/SP,0,2205,0,114222
878037,2022-06-06,São José dos Campos/SP,0,2205,0,114222
883634,2022-06-07,São José dos Campos/SP,1,2206,923,115145
889231,2022-06-08,São José dos Campos/SP,-1,2205,206,115351
894828,2022-06-09,São José dos Campos/SP,2,2207,293,115644
900425,2022-06-10,São José dos Campos/SP,0,2207,348,115992
906022,2022-06-11,São José dos Campos/SP,0,2207,207,116199
911619,2022-06-12,São José dos Campos/SP,0,2207,76,116275
917216,2022-06-13,São José dos Campos/SP,0,2207,124,116399
922813,2022-06-14,São José dos Campos/SP,0,2207,0,116399
928410,2022-06-15,São José dos Campos/SP,1,2208,505,116904
934007,2022-06-16,São José dos Campos/SP,5,2213,265,117169
939604,2022-06-17,São José dos Campos/SP,2,2215,102,117271
945201,2022-06-18,São José dos Campos/SP,0,2215,237,117508
950798,2022-06-19,São José dos Campos/SP,0,2215,160,117668
956395,2022-06-20,São José dos Campos/SP,2,2217,108,117776
961992,2022-06-21,São José dos Campos/SP,0,2217,264,118040
967589,2022-06-22,São José dos Campos/SP,0,2217,278,118318
973186,2022-06-23,São José dos Campos/SP,3,2220,171,118489
978783,2022-06-24,São José dos Campos/SP,0,2220,2,118491
984380,2022-06-25,São José dos Campos/SP,0,2220,572,119063
989977,2022-06-26,São José dos Campos/SP,0,2220,123,119186
995574,2022-06-27,São José dos Campos/SP,0,2220,101,119287
1001171,2022-06-28,São José dos Campos/SP,3,2223,325,119612
1006768,2022-06-29,São José dos Campos/SP,0,2223,335,119947
1012365,2022-06-30,São José dos Campos/SP,1,2224,225,120172
1017962,2022-07-01,São José dos Campos/SP,4,2228,354,120526
1023559,2022-07-02,São José dos Campos/SP,2,2230,253,120779
1029156,2022-07-03,São José dos Campos/SP,0,2230,180,120959
1034753,2022-07-04,São José dos Campos/SP,0,2230,156,121115
1040350,2022-07-05,São José dos Campos/SP,2,2232,384,121499
1045947,2022-07-06,São José dos Campos/SP,1,2233,275,121774
1051544,2022-07-07,São José dos Campos/SP,2,2235,171,121945
1057141,2022-07-08,São José dos Campos/SP,1,2236,277,122222
1062738,2022-07-09,São José dos Campos/SP,1,2237,260,122482
1068335,2022-07-10,São José dos Campos/SP,0,2237,49,122531
1073932,2022-07-11,São José dos Campos/SP,0,2237,112,122643
1079529,2022-07-12,São José dos Campos/SP,1,2238,240,122883
1085126,2022-07-13,São José dos Campos/SP,2,2240,179,123062
1090723,2022-07-14,São José dos Campos/SP,1,2241,201,123263
1096320,2022-07-15,São José dos Campos/SP,0,2241,153,123416
1101917,2022-07-16,São José dos Campos/SP,1,2242,108,123524
1107514,2022-07-17,São José dos Campos/SP,0,2242,75,123599
1113111,2022-07-18,São José dos Campos/SP,0,2242,44,123643
1118708,2022-07-19,São José dos Campos/SP,2,2244,178,123821
1124305,2022-07-20,São José dos Campos/SP,0,2244,86,123907
1129902,2022-07-21,São José dos Campos/SP,0,2244,90,123997
1135499,2022-07-22,São José dos Campos/SP,2,2246,106,124103
1141096,2022-07-23,São José dos Campos/SP,1,2247,71,124174
1146693,2022-07-24,São José dos Campos/SP,0,2247,65,124239
1152290,2022-07-25,São José dos Campos/SP,8,2255,66,124305
1157887,2022-07-26,São José dos Campos/SP,0,2255,113,124418
1163484,2022-07-27,São José dos Campos/SP,2,2257,71,124489
1169081,2022-07-28,São José dos Campos/SP,5,2262,47,124536
1174678,2022-07-29,São José dos Campos/SP,5,2267,129,124665
1180275,2022-07-30,São José dos Campos/SP,3,2270,73,124738
1185872,2022-07-31,São José dos Campos/SP,1,2271,41,124779
1191469,2022-08-01,São José dos Campos/SP,0,2271,9,124788
1197066,2022-08-02,São José dos Campos/SP,0,2271,24,124812
1202663,2022-08-03,São José dos Campos/SP,3,2274,55,124867
1208260,2022-08-04,São José dos Campos/SP,0,2274,33,124900
1213857,2022-08-05,São José dos Campos/SP,1,2275,117,125017
1219454,2022-08-06,São José dos Campos/SP,0,2275,55,125072
1225051,2022-08-07,São José dos Campos/SP,0,2275,16,125088
1230648,2022-08-08,São José dos Campos/SP,0,2275,8,125096
1236245,2022-08-09,São José dos Campos/SP,1,2276,57,125153
1241842,2022-08-10,São José dos Campos/SP,0,2276,26,125179
1247439,2022-08-11,São José dos Campos/SP,2,2278,54,125233
1253036,2022-08-12,São José dos Campos/SP,0,2278,45,125278
1258633,2022-08-13,São José dos Campos/SP,0,2278,53,125331
1264230,2022-08-14,São José dos Campos/SP,0,2278,11,125342
1269827,2022-08-15,São José dos Campos/SP,0,2278,9,125351
1275424,2022-08-16,São José dos Campos/SP,1,2279,69,125420
1281021,2022-08-17,São José dos Campos/SP,2,2281,58,125478
1286618,2022-08-18,São José dos Campos/SP,0,2281,64,125542
1292215,2022-08-19,São José dos Campos/SP,1,2282,39,125581
1297812,2022-08-20,São José dos Campos/SP,2,2284,47,125628
1303409,2022-08-21,São José dos Campos/SP,2,2286,13,125641
1309006,2022-08-22,São José dos Campos/SP,0,2286,5,125646
1314603,2022-08-23,São José dos Campos/SP,1,2287,16,125662
1320200,2022-08-24,São José dos Campos/SP,0,2287,20,125682
1325797,2022-08-25,São José dos Campos/SP,1,2288,7,125689
5173,2022-01-01,Taubaté/SP,0,1017,2,29150
10770,2022-01-02,Taubaté/SP,0,1017,0,29150
16367,2022-01-03,Taubaté/SP,0,1017,0,29150
21964,2022-01-04,Taubaté/SP,0,1017,25,29175
27561,2022-01-05,Taubaté/SP,0,1017,21,29196
33158,2022-01-06,Taubaté/SP,0,1017,2,29198
38755,2022-01-07,Taubaté/SP,0,1017,5,29203
44352,2022-01-08,Taubaté/SP,2,1019,5,29208
49949,2022-01-09,Taubaté/SP,0,1019,1,29209
55546,2022-01-10,Taubaté/SP,0,1019,0,29209
61143,2022-01-11,Taubaté/SP,0,1019,14,29223
66740,2022-01-12,Taubaté/SP,1,1020,13,29236
72337,2022-01-13,Taubaté/SP,0,1020,5,29241
77934,2022-01-14,Taubaté/SP,0,1020,13,29254
83531,2022-01-15,Taubaté/SP,0,1020,10,29264
89128,2022-01-16,Taubaté/SP,0,1020,15,29279
94725,2022-01-17,Taubaté/SP,0,1020,1,29280
100322,2022-01-18,Taubaté/SP,-1,1019,7,29287
105919,2022-01-19,Taubaté/SP,0,1019,26,29313
111516,2022-01-20,Taubaté/SP,0,1019,33,29346
117113,2022-01-21,Taubaté/SP,1,1020,24,29370
122710,2022-01-22,Taubaté/SP,0,1020,0,29370
128307,2022-01-23,Taubaté/SP,0,1020,18,29388
133904,2022-01-24,Taubaté/SP,2,1022,6,29394
139501,2022-01-25,Taubaté/SP,0,1022,9,29403
145098,2022-01-26,Taubaté/SP,0,1022,15,29418
150695,2022-01-27,Taubaté/SP,1,1023,2,29420
156292,2022-01-28,Taubaté/SP,0,1023,12,29432
161889,2022-01-29,Taubaté/SP,0,1023,4,29436
167486,2022-01-30,Taubaté/SP,0,1023,1,29437
173083,2022-01-31,Taubaté/SP,0,1023,0,29437
178680,2022-02-01,Taubaté/SP,1,1024,6,29443
184277,2022-02-02,Taubaté/SP,0,1024,5,29448
189874,2022-02-03,Taubaté/SP,0,1024,23,29471
195471,2022-02-04,Taubaté/SP,0,1024,0,29471
201068,2022-02-05,Taubaté/SP,1,1025,87,29558
206665,2022-02-06,Taubaté/SP,0,1025,1,29559
212262,2022-02-07,Taubaté/SP,0,1025,1,29560
217859,2022-02-08,Taubaté/SP,1,1026,23,29583
223456,2022-02-09,Taubaté/SP,2,1028,36,29619
229053,2022-02-10,Taubaté/SP,0,1028,26,29645
234650,2022-02-11,Taubaté/SP,21,1049,41,29686
240247,2022-02-12,Taubaté/SP,0,1049,59,29745
245844,2022-02-13,Taubaté/SP,0,1049,6,29751
251441,2022-02-14,Taubaté/SP,0,1049,1,29752
257038,2022-02-15,Taubaté/SP,0,1049,3,29755
262635,2022-02-16,Taubaté/SP,5,1054,14,29769
268232,2022-02-17,Taubaté/SP,0,1054,7,29776
273829,2022-02-18,Taubaté/SP,2,1056,8,29784
279426,2022-02-19,Taubaté/SP,4,1060,30,29814
285023,2022-02-20,Taubaté/SP,1,1061,1,29815
290620,2022-02-21,Taubaté/SP,0,1061,0,29815
296217,2022-02-22,Taubaté/SP,2,1063,3,29818
301814,2022-02-23,Taubaté/SP,0,1063,10,29828
307411,2022-02-24,Taubaté/SP,1,1064,9,29837
313008,2022-02-25,Taubaté/SP,0,1064,4,29841
318605,2022-02-26,Taubaté/SP,1,1065,4,29845
324202,2022-02-27,Taubaté/SP,0,1065,0,29845
329799,2022-02-28,Taubaté/SP,0,1065,36,29881
335396,2022-03-01,Taubaté/SP,0,1065,0,29881
340993,2022-03-02,Taubaté/SP,0,1065,0,29881
346590,2022-03-03,Taubaté/SP,0,1065,5,29886
352187,2022-03-04,Taubaté/SP,5,1070,6,29892
357784,2022-03-05,Taubaté/SP,4,1074,19,29911
363381,2022-03-06,Taubaté/SP,0,1074,0,29911
368978,2022-03-07,Taubaté/SP,0,1074,0,29911
374575,2022-03-08,Taubaté/SP,4,1078,17,29928
380172,2022-03-09,Taubaté/SP,3,1081,3,29931
385769,2022-03-10,Taubaté/SP,2,1083,12,29943
391366,2022-03-11,Taubaté/SP,0,1083,3,29946
396963,2022-03-12,Taubaté/SP,1,1084,2,29948
402560,2022-03-13,Taubaté/SP,0,1084,0,29948
408157,2022-03-14,Taubaté/SP,0,1084,0,29948
413754,2022-03-15,Taubaté/SP,1,1085,0,29948
419351,2022-03-16,Taubaté/SP,10,1095,14,29962
424948,2022-03-17,Taubaté/SP,2,1097,11,29973
430545,2022-03-18,Taubaté/SP,0,1097,2,29975
436142,2022-03-19,Taubaté/SP,0,1097,0,29975
441739,2022-03-20,Taubaté/SP,0,1097,0,29975
447336,2022-03-21,Taubaté/SP,0,1097,0,29975
452933,2022-03-22,Taubaté/SP,0,1097,0,29975
458530,2022-03-23,Taubaté/SP,1,1098,0,29975
464127,2022-03-24,Taubaté/SP,1,1099,14,29989
469724,2022-03-25,Taubaté/SP,0,1099,12,30001
475321,2022-03-26,Taubaté/SP,0,1099,1,30002
480918,2022-03-27,Taubaté/SP,0,1099,0,30002
486515,2022-03-28,Taubaté/SP,0,1099,0,30002
492112,2022-03-29,Taubaté/SP,0,1099,11,30013
497709,2022-03-30,Taubaté/SP,0,1099,15,30028
503306,2022-03-31,Taubaté/SP,0,1099,3,30031
508903,2022-04-01,Taubaté/SP,0,1099,5,30036
514500,2022-04-02,Taubaté/SP,0,1099,16,30052
520097,2022-04-03,Taubaté/SP,0,1099,0,30052
525694,2022-04-04,Taubaté/SP,0,1099,0,30052
531291,2022-04-05,Taubaté/SP,0,1099,40,30092
536888,2022-04-06,Taubaté/SP,0,1099,1,30093
542485,2022-04-07,Taubaté/SP,18,1117,7,30100
548082,2022-04-08,Taubaté/SP,0,1117,3,30103
553679,2022-04-09,Taubaté/SP,0,1117,31,30134
559276,2022-04-10,Taubaté/SP,0,1117,0,30134
564873,2022-04-11,Taubaté/SP,0,1117,0,30134
570470,2022-04-12,Taubaté/SP,0,1117,5,30139
576067,2022-04-13,Taubaté/SP,0,1117,26,30165
581664,2022-04-14,Taubaté/SP,0,1117,10,30175
587261,2022-04-15,Taubaté/SP,0,1117,0,30175
592858,2022-04-16,Taubaté/SP,0,1117,0,30175
598455,2022-04-17,Taubaté/SP,0,1117,0,30175
604052,2022-04-18,Taubaté/SP,0,1117,1,30176
609649,2022-04-19,Taubaté/SP,0,1117,0,30176
615246,2022-04-20,Taubaté/SP,0,1117,18,30194
620843,2022-04-21,Taubaté/SP,0,1117,1,30195
626440,2022-04-22,Taubaté/SP,0,1117,0,30195
632037,2022-04-23,Taubaté/SP,6,1123,4,30199
637634,2022-04-24,Taubaté/SP,6,1129,5,30204
643231,2022-04-25,Taubaté/SP,1,1130,0,30204
648828,2022-04-26,Taubaté/SP,0,1130,2,30206
654425,2022-04-27,Taubaté/SP,0,1130,4,30210
660022,2022-04-28,Taubaté/SP,0,1130,2,30212
665619,2022-04-29,Taubaté/SP,0,1130,3,30215
671216,2022-04-30,Taubaté/SP,0,1130,1,30216
676813,2022-05-01,Taubaté/SP,0,1130,0,30216
682410,2022-05-02,Taubaté/SP,0,1130,0,30216
688007,2022-05-03,Taubaté/SP,0,1130,20,30236
693604,2022-05-04,Taubaté/SP,0,1130,1,30237
699201,2022-05-05,Taubaté/SP,0,1130,2,30239
704798,2022-05-06,Taubaté/SP,0,1130,-1,30238
710395,2022-05-07,Taubaté/SP,0,1130,1,30239
715992,2022-05-08,Taubaté/SP,0,1130,0,30239
721589,2022-05-09,Taubaté/SP,0,1130,0,30239
727186,2022-05-10,Taubaté/SP,0,1130,13,30252
732783,2022-05-11,Taubaté/SP,0,1130,2,30254
738380,2022-05-12,Taubaté/SP,0,1130,5,30259
743977,2022-05-13,Taubaté/SP,0,1130,-1,30258
749574,2022-05-14,Taubaté/SP,0,1130,1,30259
755171,2022-05-15,Taubaté/SP,0,1130,0,30259
760768,2022-05-16,Taubaté/SP,0,1130,0,30259
766365,2022-05-17,Taubaté/SP,0,1130,1,30260
771962,2022-05-18,Taubaté/SP,0,1130,0,30260
777559,2022-05-19,Taubaté/SP,0,1130,2,30262
783156,2022-05-20,Taubaté/SP,0,1130,0,30262
788753,2022-05-21,Taubaté/SP,0,1130,0,30262
794350,2022-05-22,Taubaté/SP,0,1130,10,30272
799947,2022-05-23,Taubaté/SP,0,1130,2,30274
805544,2022-05-24,Taubaté/SP,0,1130,1,30275
811141,2022-05-25,Taubaté/SP,0,1130,1,30276
816738,2022-05-26,Taubaté/SP,1,1131,61,30337
822335,2022-05-27,Taubaté/SP,1,1132,3,30340
827932,2022-05-28,Taubaté/SP,0,1132,13,30353
833529,2022-05-29,Taubaté/SP,0,1132,0,30353
839126,2022-05-30,Taubaté/SP,0,1132,0,30353
844723,2022-05-31,Taubaté/SP,0,1132,15,30368
850320,2022-06-01,Taubaté/SP,0,1132,35,30403
855917,2022-06-02,Taubaté/SP,0,1132,2,30405
861514,2022-06-03,Taubaté/SP,0,1132,0,30405
867111,2022-06-04,Taubaté/SP,0,1132,0,30405
872708,2022-06-05,Taubaté/SP,0,1132,0,30405
878305,2022-06-06,Taubaté/SP,0,1132,0,30405
883902,2022-06-07,Taubaté/SP,1,1133,20,30425
889499,2022-06-08,Taubaté/SP,1,1134,5,30430
895096,2022-06-09,Taubaté/SP,0,1134,3,30433
900693,2022-06-10,Taubaté/SP,-1,1133,58,30491
906290,2022-06-11,Taubaté/SP,0,1133,13,30504
911887,2022-06-12,Taubaté/SP,0,1133,2,30506
917484,2022-06-13,Taubaté/SP,0,1133,0,30506
923081,2022-06-14,Taubaté/SP,0,1133,0,30506
928678,2022-06-15,Taubaté/SP,0,1133,16,30522
934275,2022-06-16,Taubaté/SP,0,1133,34,30556
939872,2022-06-17,Taubaté/SP,0,1133,1,30557
945469,2022-06-18,Taubaté/SP,0,1133,2,30559
951066,2022-06-19,Taubaté/SP,0,1133,1,30560
956663,2022-06-20,Taubaté/SP,0,1133,6,30566
962260,2022-06-21,Taubaté/SP,0,1133,29,30595
967857,2022-06-22,Taubaté/SP,0,1133,32,30627
973454,2022-06-23,Taubaté/SP,0,1133,66,30693
979051,2022-06-24,Taubaté/SP,0,1133,1,30694
984648,2022-06-25,Taubaté/SP,0,1133,192,30886
990245,2022-06-26,Taubaté/SP,0,1133,26,30912
995842,2022-06-27,Taubaté/SP,0,1133,14,30926
1001439,2022-06-28,Taubaté/SP,0,1133,80,31006
1007036,2022-06-29,Taubaté/SP,0,1133,104,31110
1012633,2022-06-30,Taubaté/SP,0,1133,180,31290
1018230,2022-07-01,Taubaté/SP,0,1133,159,31449
1023827,2022-07-02,Taubaté/SP,0,1133,67,31516
1029424,2022-07-03,Taubaté/SP,0,1133,42,31558
1035021,2022-07-04,Taubaté/SP,0,1133,23,31581
1040618,2022-07-05,Taubaté/SP,0,1133,38,31619
1046215,2022-07-06,Taubaté/SP,0,1133,70,31689
1051812,2022-07-07,Taubaté/SP,0,1133,185,31874
1057409,2022-07-08,Taubaté/SP,0,1133,177,32051
1063006,2022-07-09,Taubaté/SP,0,1133,270,32321
1068603,2022-07-10,Taubaté/SP,0,1133,86,32407
1074200,2022-07-11,Taubaté/SP,0,1133,36,32443
1079797,2022-07-12,Taubaté/SP,0,1133,235,32678
1085394,2022-07-13,Taubaté/SP,0,1133,267,32945
1090991,2022-07-14,Taubaté/SP,0,1133,141,33086
1096588,2022-07-15,Taubaté/SP,2,1135,95,33181
1102185,2022-07-16,Taubaté/SP,1,1136,104,33285
1107782,2022-07-17,Taubaté/SP,0,1136,32,33317
1113379,2022-07-18,Taubaté/SP,0,1136,35,33352
1118976,2022-07-19,Taubaté/SP,0,1136,76,33428
1124573,2022-07-20,Taubaté/SP,0,1136,76,33504
1130170,2022-07-21,Taubaté/SP,0,1136,148,33652
1135767,2022-07-22,Taubaté/SP,1,1137,21,33673
1141364,2022-07-23,Taubaté/SP,0,1137,33,33706
1146961,2022-07-24,Taubaté/SP,0,1137,21,33727
1152558,2022-07-25,Taubaté/SP,0,1137,85,33812
1158155,2022-07-26,Taubaté/SP,0,1137,40,33852
1163752,2022-07-27,Taubaté/SP,0,1137,132,33984
1169349,2022-07-28,Taubaté/SP,0,1137,100,34084
1174946,2022-07-29,Taubaté/SP,0,1137,180,34264
1180543,2022-07-30,Taubaté/SP,1,1138,93,34357
1186140,2022-07-31,Taubaté/SP,0,1138,6,34363
1191737,2022-08-01,Taubaté/SP,0,1138,8,34371
1197334,2022-08-02,Taubaté/SP,0,1138,50,34421
1202931,2022-08-03,Taubaté/SP,0,1138,33,34454
1208528,2022-08-04,Taubaté/SP,0,1138,21,34475
1214125,2022-08-05,Taubaté/SP,2,1140,45,34520
1219722,2022-08-06,Taubaté/SP,0,1140,62,34582
1225319,2022-08-07,Taubaté/SP,0,1140,2,34584
1230916,2022-08-08,Taubaté/SP,0,1140,4,34588
1236513,2022-08-09,Taubaté/SP,0,1140,36,34624
1242110,2022-08-10,Taubaté/SP,0,1140,9,34633
1247707,2022-08-11,Taubaté/SP,0,1140,25,34658
1253304,2022-08-12,Taubaté/SP,0,1140,45,34703
1258901,2022-08-13,Taubaté/SP,0,1140,12,34715
1264498,2022-08-14,Taubaté/SP,0,1140,2,34717
1270095,2022-08-15,Taubaté/SP,0,1140,1,34718
1275692,2022-08-16,Taubaté/SP,1,1141,36,34754
1281289,2022-08-17,Taubaté/SP,1,1142,9,34763
1286886,2022-08-18,Taubaté/SP,0,1142,33,34796
1292483,2022-08-19,Taubaté/SP,1,1143,19,34815
1298080,2022-08-20,Taubaté/SP,1,1144,13,34828
1303677,2022-08-21,Taubaté/SP,0,1144,0,34828
1309274,2022-08-22,Taubaté/SP,0,1144,1,34829
1314871,2022-08-23,Taubaté/SP,1,1145,19,34848
1320468,2022-08-24,Taubaté/SP,0,1145,9,34857
1326065,2022-08-25,Taubaté/SP,0,1145,18,34875
297,2022-01-01,Araraquara/SP,0,544,1,24142
5894,2022-01-02,Araraquara/SP,0,544,0,24142
11491,2022-01-03,Araraquara/SP,0,544,0,24142
17088,2022-01-04,Araraquara/SP,0,544,2,24144
22685,2022-01-05,Araraquara/SP,0,544,0,24144
28282,2022-01-06,Araraquara/SP,0,544,1,24145
33879,2022-01-07,Araraquara/SP,0,544,0,24145
39476,2022-01-08,Araraquara/SP,0,544,2,24147
45073,2022-01-09,Araraquara/SP,0,544,1,24148
50670,2022-01-10,Araraquara/SP,0,544,0,24148
56267,2022-01-11,Araraquara/SP,0,544,2,24150
61864,2022-01-12,Araraquara/SP,0,544,0,24150
67461,2022-01-13,Araraquara/SP,1,545,3,24153
73058,2022-01-14,Araraquara/SP,0,545,0,24153
78655,2022-01-15,Araraquara/SP,1,546,4,24157
84252,2022-01-16,Araraquara/SP,0,546,0,24157
89849,2022-01-17,Araraquara/SP,0,546,0,24157
95446,2022-01-18,Araraquara/SP,2,548,6,24163
101043,2022-01-19,Araraquara/SP,2,550,9,24172
106640,2022-01-20,Araraquara/SP,1,551,1,24173
112237,2022-01-21,Araraquara/SP,0,551,3,24176
117834,2022-01-22,Araraquara/SP,0,551,0,24176
123431,2022-01-23,Araraquara/SP,1,552,6,24182
129028,2022-01-24,Araraquara/SP,0,552,0,24182
134625,2022-01-25,Araraquara/SP,0,552,16,24198
140222,2022-01-26,Araraquara/SP,1,553,17,24215
145819,2022-01-27,Araraquara/SP,2,555,7,24222
151416,2022-01-28,Araraquara/SP,1,556,1,24223
157013,2022-01-29,Araraquara/SP,2,558,6,24229
162610,2022-01-30,Araraquara/SP,0,558,1,24230
168207,2022-01-31,Araraquara/SP,0,558,0,24230
173804,2022-02-01,Araraquara/SP,7,565,6,24236
179401,2022-02-02,Araraquara/SP,2,567,3,24239
184998,2022-02-03,Araraquara/SP,1,568,11,24250
190595,2022-02-04,Araraquara/SP,0,568,0,24250
196192,2022-02-05,Araraquara/SP,4,572,11,24261
201789,2022-02-06,Araraquara/SP,0,572,0,24261
207386,2022-02-07,Araraquara/SP,0,572,0,24261
212983,2022-02-08,Araraquara/SP,0,572,3,24264
218580,2022-02-09,Araraquara/SP,4,576,15,24279
224177,2022-02-10,Araraquara/SP,0,576,12,24291
229774,2022-02-11,Araraquara/SP,2,578,2,24293
235371,2022-02-12,Araraquara/SP,0,578,2,24295
240968,2022-02-13,Araraquara/SP,0,578,3,24298
246565,2022-02-14,Araraquara/SP,1,579,0,24298
252162,2022-02-15,Araraquara/SP,0,579,1,24299
257759,2022-02-16,Araraquara/SP,1,580,4,24303
263356,2022-02-17,Araraquara/SP,1,581,8,24311
268953,2022-02-18,Araraquara/SP,0,581,1,24312
274550,2022-02-19,Araraquara/SP,0,581,0,24312
280147,2022-02-20,Araraquara/SP,0,581,0,24312
285744,2022-02-21,Araraquara/SP,0,581,0,24312
291341,2022-02-22,Araraquara/SP,0,581,2,24314
296938,2022-02-23,Araraquara/SP,0,581,1,24315
302535,2022-02-24,Araraquara/SP,0,581,372,24687
308132,2022-02-25,Araraquara/SP,5,586,485,25172
313729,2022-02-26,Araraquara/SP,0,586,362,25534
319326,2022-02-27,Araraquara/SP,0,586,93,25627
324923,2022-02-28,Araraquara/SP,0,586,58,25685
330520,2022-03-01,Araraquara/SP,0,586,55,25740
336117,2022-03-02,Araraquara/SP,0,586,130,25870
341714,2022-03-03,Araraquara/SP,0,586,205,26075
347311,2022-03-04,Araraquara/SP,0,586,913,26988
352908,2022-03-05,Araraquara/SP,1,587,539,27527
358505,2022-03-06,Araraquara/SP,0,587,85,27612
364102,2022-03-07,Araraquara/SP,0,587,36,27648
369699,2022-03-08,Araraquara/SP,0,587,325,27973
375296,2022-03-09,Araraquara/SP,0,587,1335,29308
380893,2022-03-10,Araraquara/SP,3,590,1221,30529
386490,2022-03-11,Araraquara/SP,9,599,830,31359
392087,2022-03-12,Araraquara/SP,0,599,957,32316
397684,2022-03-13,Araraquara/SP,0,599,33,32349
403281,2022-03-14,Araraquara/SP,0,599,67,32416
408878,2022-03-15,Araraquara/SP,0,599,364,32780
414475,2022-03-16,Araraquara/SP,4,603,87,32867
420072,2022-03-17,Araraquara/SP,0,603,207,33074
425669,2022-03-18,Araraquara/SP,0,603,267,33341
431266,2022-03-19,Araraquara/SP,3,606,118,33459
436863,2022-03-20,Araraquara/SP,0,606,218,33677
442460,2022-03-21,Araraquara/SP,0,606,34,33711
448057,2022-03-22,Araraquara/SP,0,606,191,33902
453654,2022-03-23,Araraquara/SP,0,606,81,33983
459251,2022-03-24,Araraquara/SP,0,606,226,34209
464848,2022-03-25,Araraquara/SP,1,607,197,34406
470445,2022-03-26,Araraquara/SP,0,607,140,34546
476042,2022-03-27,Araraquara/SP,0,607,184,34730
481639,2022-03-28,Araraquara/SP,0,607,206,34936
487236,2022-03-29,Araraquara/SP,0,607,47,34983
492833,2022-03-30,Araraquara/SP,0,607,227,35210
498430,2022-03-31,Araraquara/SP,6,613,188,35398
504027,2022-04-01,Araraquara/SP,2,615,130,35528
509624,2022-04-02,Araraquara/SP,0,615,62,35590
515221,2022-04-03,Araraquara/SP,0,615,79,35669
520818,2022-04-04,Araraquara/SP,0,615,18,35687
526415,2022-04-05,Araraquara/SP,1,616,54,35741
532012,2022-04-06,Araraquara/SP,0,616,232,35973
537609,2022-04-07,Araraquara/SP,0,616,249,36222
543206,2022-04-08,Araraquara/SP,0,616,265,36487
548803,2022-04-09,Araraquara/SP,0,616,572,37059
554400,2022-04-10,Araraquara/SP,0,616,17,37076
559997,2022-04-11,Araraquara/SP,0,616,11,37087
565594,2022-04-12,Araraquara/SP,0,616,498,37585
571191,2022-04-13,Araraquara/SP,2,618,692,38277
576788,2022-04-14,Araraquara/SP,0,618,459,38736
582385,2022-04-15,Araraquara/SP,0,618,500,39236
587982,2022-04-16,Araraquara/SP,0,618,19,39255
593579,2022-04-17,Araraquara/SP,0,618,0,39255
599176,2022-04-18,Araraquara/SP,0,618,605,39860
604773,2022-04-19,Araraquara/SP,0,618,0,39860
610370,2022-04-20,Araraquara/SP,0,618,786,40646
615967,2022-04-21,Araraquara/SP,0,618,48,40694
621564,2022-04-22,Araraquara/SP,0,618,237,40931
627161,2022-04-23,Araraquara/SP,0,618,159,41090
632758,2022-04-24,Araraquara/SP,0,618,40,41130
638355,2022-04-25,Araraquara/SP,0,618,33,41163
643952,2022-04-26,Araraquara/SP,0,618,242,41405
649549,2022-04-27,Araraquara/SP,0,618,550,41955
655146,2022-04-28,Araraquara/SP,0,618,568,42523
660743,2022-04-29,Araraquara/SP,0,618,1226,43749
666340,2022-04-30,Araraquara/SP,0,618,99,43848
671937,2022-05-01,Araraquara/SP,0,618,95,43943
677534,2022-05-02,Araraquara/SP,0,618,72,44015
683131,2022-05-03,Araraquara/SP,0,618,116,44131
688728,2022-05-04,Araraquara/SP,0,618,215,44346
694325,2022-05-05,Araraquara/SP,0,618,162,44508
699922,2022-05-06,Araraquara/SP,0,618,266,44774
705519,2022-05-07,Araraquara/SP,0,618,90,44864
711116,2022-05-08,Araraquara/SP,0,618,124,44988
716713,2022-05-09,Araraquara/SP,0,618,115,45103
722310,2022-05-10,Araraquara/SP,0,618,119,45222
727907,2022-05-11,Araraquara/SP,0,618,204,45426
733504,2022-05-12,Araraquara/SP,1,619,249,45675
739101,2022-05-13,Araraquara/SP,1,620,261,45936
744698,2022-05-14,Araraquara/SP,0,620,145,46081
750295,2022-05-15,Araraquara/SP,0,620,120,46201
755892,2022-05-16,Araraquara/SP,0,620,132,46333
761489,2022-05-17,Araraquara/SP,1,621,246,46579
767086,2022-05-18,Araraquara/SP,0,621,1,46580
772683,2022-05-19,Araraquara/SP,0,621,45,46625
778280,2022-05-20,Araraquara/SP,0,621,0,46625
783877,2022-05-21,Araraquara/SP,0,621,0,46625
789474,2022-05-22,Araraquara/SP,0,621,633,47258
795071,2022-05-23,Araraquara/SP,0,621,340,47598
800668,2022-05-24,Araraquara/SP,0,621,271,47869
806265,2022-05-25,Araraquara/SP,2,623,399,48268
811862,2022-05-26,Araraquara/SP,0,623,283,48551
817459,2022-05-27,Araraquara/SP,0,623,386,48937
823056,2022-05-28,Araraquara/SP,0,623,199,49136
828653,2022-05-29,Araraquara/SP,0,623,315,49451
834250,2022-05-30,Araraquara/SP,0,623,207,49658
839847,2022-05-31,Araraquara/SP,0,623,344,50002
845444,2022-06-01,Araraquara/SP,0,623,365,50367
851041,2022-06-02,Araraquara/SP,0,623,285,50652
856638,2022-06-03,Araraquara/SP,0,623,0,50652
862235,2022-06-04,Araraquara/SP,0,623,0,50652
867832,2022-06-05,Araraquara/SP,0,623,0,50652
873429,2022-06-06,Araraquara/SP,0,623,0,50652
879026,2022-06-07,Araraquara/SP,2,625,1212,51864
884623,2022-06-08,Araraquara/SP,0,625,227,52091
890220,2022-06-09,Araraquara/SP,1,626,134,52225
895817,2022-06-10,Araraquara/SP,1,627,505,52730
901414,2022-06-11,Araraquara/SP,0,627,131,52861
907011,2022-06-12,Araraquara/SP,0,627,289,53150
912608,2022-06-13,Araraquara/SP,0,627,84,53234
918205,2022-06-14,Araraquara/SP,0,627,0,53234
923802,2022-06-15,Araraquara/SP,0,627,228,53462
929399,2022-06-16,Araraquara/SP,0,627,111,53573
934996,2022-06-17,Araraquara/SP,0,627,88,53661
940593,2022-06-18,Araraquara/SP,0,627,139,53800
946190,2022-06-19,Araraquara/SP,0,627,87,53887
951787,2022-06-20,Araraquara/SP,0,627,126,54013
957384,2022-06-21,Araraquara/SP,1,628,132,54145
962981,2022-06-22,Araraquara/SP,0,628,151,54296
968578,2022-06-23,Araraquara/SP,1,629,145,54441
974175,2022-06-24,Araraquara/SP,1,630,4,54445
979772,2022-06-25,Araraquara/SP,1,631,352,54797
985369,2022-06-26,Araraquara/SP,0,631,143,54940
990966,2022-06-27,Araraquara/SP,0,631,114,55054
996563,2022-06-28,Araraquara/SP,0,631,178,55232
1002160,2022-06-29,Araraquara/SP,0,631,123,55355
1007757,2022-06-30,Araraquara/SP,0,631,114,55469
1013354,2022-07-01,Araraquara/SP,0,631,122,55591
1018951,2022-07-02,Araraquara/SP,0,631,191,55782
1024548,2022-07-03,Araraquara/SP,0,631,156,55938
1030145,2022-07-04,Araraquara/SP,0,631,192,56130
1035742,2022-07-05,Araraquara/SP,1,632,169,56299
1041339,2022-07-06,Araraquara/SP,1,633,143,56442
1046936,2022-07-07,Araraquara/SP,1,634,145,56587
1052533,2022-07-08,Araraquara/SP,2,636,150,56737
1058130,2022-07-09,Araraquara/SP,0,636,116,56853
1063727,2022-07-10,Araraquara/SP,0,636,306,57159
1069324,2022-07-11,Araraquara/SP,0,636,76,57235
1074921,2022-07-12,Araraquara/SP,0,636,80,57315
1080518,2022-07-13,Araraquara/SP,0,636,125,57440
1086115,2022-07-14,Araraquara/SP,0,636,145,57585
1091712,2022-07-15,Araraquara/SP,1,637,123,57708
1097309,2022-07-16,Araraquara/SP,0,637,195,57903
1102906,2022-07-17,Araraquara/SP,0,637,126,58029
1108503,2022-07-18,Araraquara/SP,0,637,104,58133
1114100,2022-07-19,Araraquara/SP,1,638,83,58216
1119697,2022-07-20,Araraquara/SP,0,638,141,58357
1125294,2022-07-21,Araraquara/SP,0,638,105,58462
1130891,2022-07-22,Araraquara/SP,1,639,49,58511
1136488,2022-07-23,Araraquara/SP,0,639,159,58670
1142085,2022-07-24,Araraquara/SP,0,639,196,58866
1147682,2022-07-25,Araraquara/SP,0,639,39,58905
1153279,2022-07-26,Araraquara/SP,0,639,79,58984
1158876,2022-07-27,Araraquara/SP,1,640,77,59061
1164473,2022-07-28,Araraquara/SP,0,640,71,59132
1170070,2022-07-29,Araraquara/SP,0,640,139,59271
1175667,2022-07-30,Araraquara/SP,0,640,105,59376
1181264,2022-07-31,Araraquara/SP,0,640,82,59458
1186861,2022-08-01,Araraquara/SP,0,640,43,59501
1192458,2022-08-02,Araraquara/SP,0,640,56,59557
1198055,2022-08-03,Araraquara/SP,0,640,117,59674
1203652,2022-08-04,Araraquara/SP,0,640,79,59753
1209249,2022-08-05,Araraquara/SP,0,640,54,59807
1214846,2022-08-06,Araraquara/SP,0,640,95,59902
1220443,2022-08-07,Araraquara/SP,0,640,80,59982
1226040,2022-08-08,Araraquara/SP,0,640,81,60063
1231637,2022-08-09,Araraquara/SP,0,640,66,60129
1237234,2022-08-10,Araraquara/SP,0,640,59,60188
1242831,2022-08-11,Araraquara/SP,0,640,68,60256
1248428,2022-08-12,Araraquara/SP,0,640,50,60306
1254025,2022-08-13,Araraquara/SP,0,640,53,60359
1259622,2022-08-14,Araraquara/SP,0,640,16,60375
1265219,2022-08-15,Araraquara/SP,0,640,46,60421
1270816,2022-08-16,Araraquara/SP,0,640,45,60466
1276413,2022-08-17,Araraquara/SP,0,640,45,60511
1282010,2022-08-18,Araraquara/SP,0,640,74,60585
1287607,2022-08-19,Araraquara/SP,0,640,42,60627
1293204,2022-08-20,Araraquara/SP,0,640,47,60674
1298801,2022-08-21,Araraquara/SP,0,640,26,60700
1304398,2022-08-22,Araraquara/SP,0,640,18,60718
1309995,2022-08-23,Araraquara/SP,0,640,38,60756
1315592,2022-08-24,Araraquara/SP,1,641,43,60799
1321189,2022-08-25,Araraquara/SP,0,641,48,60847
4770,2022-01-01,São Carlos/SP,1,542,10,27448
10367,2022-01-02,São Carlos/SP,0,542,0,27448
15964,2022-01-03,São Carlos/SP,0,542,0,27448
21561,2022-01-04,São Carlos/SP,0,542,20,27468
27158,2022-01-05,São Carlos/SP,0,542,1,27469
32755,2022-01-06,São Carlos/SP,0,542,2,27471
38352,2022-01-07,São Carlos/SP,0,542,0,27471
43949,2022-01-08,São Carlos/SP,0,542,0,27471
49546,2022-01-09,São Carlos/SP,0,542,0,27471
55143,2022-01-10,São Carlos/SP,0,542,0,27471
60740,2022-01-11,São Carlos/SP,1,543,5,27476
66337,2022-01-12,São Carlos/SP,1,544,6,27482
71934,2022-01-13,São Carlos/SP,0,544,24,27506
77531,2022-01-14,São Carlos/SP,0,544,0,27506
83128,2022-01-15,São Carlos/SP,0,544,5,27511
88725,2022-01-16,São Carlos/SP,0,544,2,27513
94322,2022-01-17,São Carlos/SP,0,544,1,27514
99919,2022-01-18,São Carlos/SP,0,544,26,27540
105516,2022-01-19,São Carlos/SP,0,544,31,27571
111113,2022-01-20,São Carlos/SP,2,546,17,27588
116710,2022-01-21,São Carlos/SP,1,547,13,27601
122307,2022-01-22,São Carlos/SP,0,547,0,27601
127904,2022-01-23,São Carlos/SP,0,547,36,27637
133501,2022-01-24,São Carlos/SP,0,547,1,27638
139098,2022-01-25,São Carlos/SP,0,547,10,27648
144695,2022-01-26,São Carlos/SP,1,548,40,27688
150292,2022-01-27,São Carlos/SP,2,550,25,27713
155889,2022-01-28,São Carlos/SP,1,551,41,27754
161486,2022-01-29,São Carlos/SP,0,551,54,27808
167083,2022-01-30,São Carlos/SP,0,551,35,27843
172680,2022-01-31,São Carlos/SP,0,551,0,27843
178277,2022-02-01,São Carlos/SP,3,554,151,27994
183874,2022-02-02,São Carlos/SP,2,556,6,28000
189471,2022-02-03,São Carlos/SP,1,557,247,28247
195068,2022-02-04,São Carlos/SP,0,557,0,28247
200665,2022-02-05,São Carlos/SP,1,558,242,28489
206262,2022-02-06,São Carlos/SP,0,558,19,28508
211859,2022-02-07,São Carlos/SP,0,558,34,28542
217456,2022-02-08,São Carlos/SP,6,564,153,28695
223053,2022-02-09,São Carlos/SP,1,565,106,28801
228650,2022-02-10,São Carlos/SP,1,566,129,28930
234247,2022-02-11,São Carlos/SP,1,567,133,29063
239844,2022-02-12,São Carlos/SP,1,568,104,29167
245441,2022-02-13,São Carlos/SP,0,568,48,29215
251038,2022-02-14,São Carlos/SP,0,568,31,29246
256635,2022-02-15,São Carlos/SP,1,569,109,29355
262232,2022-02-16,São Carlos/SP,0,569,89,29444
267829,2022-02-17,São Carlos/SP,0,569,39,29483
273426,2022-02-18,São Carlos/SP,2,571,58,29541
279023,2022-02-19,São Carlos/SP,1,572,73,29614
284620,2022-02-20,São Carlos/SP,0,572,20,29634
290217,2022-02-21,São Carlos/SP,0,572,10,29644
295814,2022-02-22,São Carlos/SP,1,573,64,29708
301411,2022-02-23,São Carlos/SP,0,573,66,29774
307008,2022-02-24,São Carlos/SP,0,573,24,29798
312605,2022-02-25,São Carlos/SP,0,573,43,29841
318202,2022-02-26,São Carlos/SP,1,574,25,29866
323799,2022-02-27,São Carlos/SP,0,574,-3,29863
329396,2022-02-28,São Carlos/SP,0,574,14,29877
334993,2022-03-01,São Carlos/SP,1,575,17,29894
340590,2022-03-02,São Carlos/SP,0,575,0,29894
346187,2022-03-03,São Carlos/SP,0,575,20,29914
351784,2022-03-04,São Carlos/SP,0,575,24,29938
357381,2022-03-05,São Carlos/SP,2,577,33,29971
362978,2022-03-06,São Carlos/SP,0,577,0,29971
368575,2022-03-07,São Carlos/SP,0,577,0,29971
374172,2022-03-08,São Carlos/SP,0,577,-3,29968
379769,2022-03-09,São Carlos/SP,0,577,86,30054
385366,2022-03-10,São Carlos/SP,1,578,88,30142
390963,2022-03-11,São Carlos/SP,1,579,102,30244
396560,2022-03-12,São Carlos/SP,0,579,97,30341
402157,2022-03-13,São Carlos/SP,0,579,56,30397
407754,2022-03-14,São Carlos/SP,0,579,0,30397
413351,2022-03-15,São Carlos/SP,0,579,68,30465
418948,2022-03-16,São Carlos/SP,0,579,75,30540
424545,2022-03-17,São Carlos/SP,0,579,65,30605
430142,2022-03-18,São Carlos/SP,0,579,76,30681
435739,2022-03-19,São Carlos/SP,0,579,68,30749
441336,2022-03-20,São Carlos/SP,0,579,33,30782
446933,2022-03-21,São Carlos/SP,0,579,47,30829
452530,2022-03-22,São Carlos/SP,0,579,83,30912
458127,2022-03-23,São Carlos/SP,3,582,44,30956
463724,2022-03-24,São Carlos/SP,0,582,1,30957
469321,2022-03-25,São Carlos/SP,0,582,21,30978
474918,2022-03-26,São Carlos/SP,0,582,-18,30960
480515,2022-03-27,São Carlos/SP,0,582,-10,30950
486112,2022-03-28,São Carlos/SP,0,582,0,30950
491709,2022-03-29,São Carlos/SP,1,583,-8,30942
497306,2022-03-30,São Carlos/SP,0,583,11,30953
502903,2022-03-31,São Carlos/SP,0,583,-1,30952
508500,2022-04-01,São Carlos/SP,1,584,-3,30949
514097,2022-04-02,São Carlos/SP,0,584,5,30954
519694,2022-04-03,São Carlos/SP,0,584,-2,30952
525291,2022-04-04,São Carlos/SP,0,584,0,30952
530888,2022-04-05,São Carlos/SP,0,584,-2,30950
536485,2022-04-06,São Carlos/SP,0,584,-8,30942
542082,2022-04-07,São Carlos/SP,0,584,-7,30935
547679,2022-04-08,São Carlos/SP,0,584,-10,30925
553276,2022-04-09,São Carlos/SP,0,584,-3,30922
558873,2022-04-10,São Carlos/SP,0,584,-2,30920
564470,2022-04-11,São Carlos/SP,0,584,0,30920
570067,2022-04-12,São Carlos/SP,0,584,4,30924
575664,2022-04-13,São Carlos/SP,0,584,6,30930
581261,2022-04-14,São Carlos/SP,0,584,3,30933
586858,2022-04-15,São Carlos/SP,0,584,-2,30931
592455,2022-04-16,São Carlos/SP,0,584,0,30931
598052,2022-04-17,São Carlos/SP,0,584,0,30931
603649,2022-04-18,São Carlos/SP,0,584,0,30931
609246,2022-04-19,São Carlos/SP,0,584,0,30931
614843,2022-04-20,São Carlos/SP,0,584,3,30934
620440,2022-04-21,São Carlos/SP,0,584,0,30934
626037,2022-04-22,São Carlos/SP,0,584,0,30934
631634,2022-04-23,São Carlos/SP,0,584,23,30957
637231,2022-04-24,São Carlos/SP,0,584,7,30964
642828,2022-04-25,São Carlos/SP,0,584,0,30964
648425,2022-04-26,São Carlos/SP,0,584,26,30990
654022,2022-04-27,São Carlos/SP,0,584,19,31009
659619,2022-04-28,São Carlos/SP,1,585,20,31029
665216,2022-04-29,São Carlos/SP,0,585,12,31041
670813,2022-04-30,São Carlos/SP,0,585,17,31058
676410,2022-05-01,São Carlos/SP,0,585,16,31074
682007,2022-05-02,São Carlos/SP,0,585,0,31074
687604,2022-05-03,São Carlos/SP,1,586,52,31126
693201,2022-05-04,São Carlos/SP,0,586,16,31142
698798,2022-05-05,São Carlos/SP,0,586,0,31142
704395,2022-05-06,São Carlos/SP,0,586,22,31164
709992,2022-05-07,São Carlos/SP,0,586,-2,31162
715589,2022-05-08,São Carlos/SP,0,586,-7,31155
721186,2022-05-09,São Carlos/SP,0,586,0,31155
726783,2022-05-10,São Carlos/SP,0,586,-1,31154
732380,2022-05-11,São Carlos/SP,1,587,-7,31147
737977,2022-05-12,São Carlos/SP,1,588,1,31148
743574,2022-05-13,São Carlos/SP,0,588,-1,31147
749171,2022-05-14,São Carlos/SP,0,588,-6,31141
754768,2022-05-15,São Carlos/SP,0,588,-3,31138
760365,2022-05-16,São Carlos/SP,0,588,0,31138
765962,2022-05-17,São Carlos/SP,1,589,3,31141
771559,2022-05-18,São Carlos/SP,0,589,1,31142
777156,2022-05-19,São Carlos/SP,1,590,-1,31141
782753,2022-05-20,São Carlos/SP,0,590,0,31141
788350,2022-05-21,São Carlos/SP,0,590,0,31141
793947,2022-05-22,São Carlos/SP,0,590,5,31146
799544,2022-05-23,São Carlos/SP,0,590,0,31146
805141,2022-05-24,São Carlos/SP,2,592,3,31149
810738,2022-05-25,São Carlos/SP,0,592,-1,31148
816335,2022-05-26,São Carlos/SP,0,592,-2,31146
821932,2022-05-27,São Carlos/SP,0,592,1,31147
827529,2022-05-28,São Carlos/SP,0,592,0,31147
833126,2022-05-29,São Carlos/SP,0,592,-5,31142
838723,2022-05-30,São Carlos/SP,0,592,0,31142
844320,2022-05-31,São Carlos/SP,1,593,3,31145
849917,2022-06-01,São Carlos/SP,2,595,-3,31142
855514,2022-06-02,São Carlos/SP,0,595,6,31148
861111,2022-06-03,São Carlos/SP,0,595,0,31148
866708,2022-06-04,São Carlos/SP,0,595,0,31148
872305,2022-06-05,São Carlos/SP,0,595,0,31148
877902,2022-06-06,São Carlos/SP,0,595,0,31148
883499,2022-06-07,São Carlos/SP,1,596,93,31241
889096,2022-06-08,São Carlos/SP,1,597,54,31295
894693,2022-06-09,São Carlos/SP,0,597,32,31327
900290,2022-06-10,São Carlos/SP,1,598,77,31404
905887,2022-06-11,São Carlos/SP,0,598,80,31484
911484,2022-06-12,São Carlos/SP,0,598,34,31518
917081,2022-06-13,São Carlos/SP,0,598,61,31579
922678,2022-06-14,São Carlos/SP,0,598,0,31579
928275,2022-06-15,São Carlos/SP,3,601,183,31762
933872,2022-06-16,São Carlos/SP,0,601,119,31881
939469,2022-06-17,São Carlos/SP,0,601,-2,31879
945066,2022-06-18,São Carlos/SP,1,602,0,31879
950663,2022-06-19,São Carlos/SP,0,602,3,31882
956260,2022-06-20,São Carlos/SP,0,602,0,31882
961857,2022-06-21,São Carlos/SP,2,604,74,31956
967454,2022-06-22,São Carlos/SP,0,604,65,32021
973051,2022-06-23,São Carlos/SP,1,605,57,32078
978648,2022-06-24,São Carlos/SP,1,606,3,32081
984245,2022-06-25,São Carlos/SP,1,607,73,32154
989842,2022-06-26,São Carlos/SP,0,607,9,32163
995439,2022-06-27,São Carlos/SP,0,607,2,32165
1001036,2022-06-28,São Carlos/SP,0,607,60,32225
1006633,2022-06-29,São Carlos/SP,0,607,55,32280
1012230,2022-06-30,São Carlos/SP,0,607,53,32333
1017827,2022-07-01,São Carlos/SP,0,607,32,32365
1023424,2022-07-02,São Carlos/SP,0,607,34,32399
1029021,2022-07-03,São Carlos/SP,0,607,0,32399
1034618,2022-07-04,São Carlos/SP,0,607,21,32420
1040215,2022-07-05,São Carlos/SP,1,608,32,32452
1045812,2022-07-06,São Carlos/SP,1,609,2,32454
1051409,2022-07-07,São Carlos/SP,0,609,46,32500
1057006,2022-07-08,São Carlos/SP,1,610,38,32538
1062603,2022-07-09,São Carlos/SP,0,610,27,32565
1068200,2022-07-10,São Carlos/SP,0,610,0,32565
1073797,2022-07-11,São Carlos/SP,0,610,16,32581
1079394,2022-07-12,São Carlos/SP,0,610,45,32626
1084991,2022-07-13,São Carlos/SP,0,610,60,32686
1090588,2022-07-14,São Carlos/SP,1,611,50,32736
1096185,2022-07-15,São Carlos/SP,0,611,63,32799
1101782,2022-07-16,São Carlos/SP,1,612,46,32845
1107379,2022-07-17,São Carlos/SP,0,612,0,32845
1112976,2022-07-18,São Carlos/SP,0,612,9,32854
1118573,2022-07-19,São Carlos/SP,0,612,20,32874
1124170,2022-07-20,São Carlos/SP,0,612,51,32925
1129767,2022-07-21,São Carlos/SP,0,612,55,32980
1135364,2022-07-22,São Carlos/SP,0,612,39,33019
1140961,2022-07-23,São Carlos/SP,2,614,20,33039
1146558,2022-07-24,São Carlos/SP,0,614,11,33050
1152155,2022-07-25,São Carlos/SP,0,614,1,33051
1157752,2022-07-26,São Carlos/SP,0,614,21,33072
1163349,2022-07-27,São Carlos/SP,0,614,33,33105
1168946,2022-07-28,São Carlos/SP,0,614,4,33109
1174543,2022-07-29,São Carlos/SP,1,615,10,33119
1180140,2022-07-30,São Carlos/SP,2,617,3,33122
1185737,2022-07-31,São Carlos/SP,0,617,0,33122
1191334,2022-08-01,São Carlos/SP,1,618,0,33122
1196931,2022-08-02,São Carlos/SP,0,618,10,33132
1202528,2022-08-03,São Carlos/SP,0,618,32,33164
1208125,2022-08-04,São Carlos/SP,0,618,40,33204
1213722,2022-08-05,São Carlos/SP,0,618,15,33219
1219319,2022-08-06,São Carlos/SP,1,619,32,33251
1224916,2022-08-07,São Carlos/SP,0,619,1,33252
1230513,2022-08-08,São Carlos/SP,0,619,0,33252
1236110,2022-08-09,São Carlos/SP,0,619,31,33283
1241707,2022-08-10,São Carlos/SP,1,620,29,33312
1247304,2022-08-11,São Carlos/SP,1,621,35,33347
1252901,2022-08-12,São Carlos/SP,0,621,37,33384
1258498,2022-08-13,São Carlos/SP,0,621,30,33414
1264095,2022-08-14,São Carlos/SP,0,621,0,33414
1269692,2022-08-15,São Carlos/SP,1,622,1,33415
1275289,2022-08-16,São Carlos/SP,0,622,0,33415
1280886,2022-08-17,São Carlos/SP,1,623,18,33433
1286483,2022-08-18,São Carlos/SP,0,623,3,33436
1292080,2022-08-19,São Carlos/SP,0,623,17,33453
1297677,2022-08-20,São Carlos/SP,0,623,31,33484
1303274,2022-08-21,São Carlos/SP,0,623,0,33484
1308871,2022-08-22,São Carlos/SP,0,623,0,33484
1314468,2022-08-23,São Carlos/SP,0,623,32,33516
1320065,2022-08-24,São Carlos/SP,0,623,39,33555
1325662,2022-08-25,São Carlos/SP,0,623,32,33587
3811,2022-01-01,Piracicaba/SP,0,1404,4,64602
9408,2022-01-02,Piracicaba/SP,0,1404,2,64604
15005,2022-01-03,Piracicaba/SP,0,1404,10,64614
20602,2022-01-04,Piracicaba/SP,0,1404,10,64624
26199,2022-01-05,Piracicaba/SP,0,1404,10,64634
31796,2022-01-06,Piracicaba/SP,0,1404,317,64951
37393,2022-01-07,Piracicaba/SP,0,1404,156,65107
42990,2022-01-08,Piracicaba/SP,1,1405,3,65110
48587,2022-01-09,Piracicaba/SP,0,1405,787,65897
54184,2022-01-10,Piracicaba/SP,0,1405,258,66155
59781,2022-01-11,Piracicaba/SP,1,1406,14,66169
65378,2022-01-12,Piracicaba/SP,0,1406,14,66183
70975,2022-01-13,Piracicaba/SP,0,1406,4,66187
76572,2022-01-14,Piracicaba/SP,0,1406,72,66259
82169,2022-01-15,Piracicaba/SP,3,1409,3,66262
87766,2022-01-16,Piracicaba/SP,1,1410,853,67115
93363,2022-01-17,Piracicaba/SP,3,1413,177,67292
98960,2022-01-18,Piracicaba/SP,4,1417,16,67308
104557,2022-01-19,Piracicaba/SP,1,1418,11,67319
110154,2022-01-20,Piracicaba/SP,4,1422,51,67370
115751,2022-01-21,Piracicaba/SP,1,1423,121,67491
121348,2022-01-22,Piracicaba/SP,0,1423,0,67491
126945,2022-01-23,Piracicaba/SP,3,1426,734,68225
132542,2022-01-24,Piracicaba/SP,0,1426,765,68990
138139,2022-01-25,Piracicaba/SP,8,1434,126,69116
143736,2022-01-26,Piracicaba/SP,3,1437,153,69269
149333,2022-01-27,Piracicaba/SP,6,1443,207,69476
154930,2022-01-28,Piracicaba/SP,4,1447,168,69644
160527,2022-01-29,Piracicaba/SP,4,1451,28,69672
166124,2022-01-30,Piracicaba/SP,0,1451,418,70090
171721,2022-01-31,Piracicaba/SP,0,1451,0,70090
177318,2022-02-01,Piracicaba/SP,8,1459,745,70835
182915,2022-02-02,Piracicaba/SP,6,1465,21,70856
188512,2022-02-03,Piracicaba/SP,2,1467,127,70983
194109,2022-02-04,Piracicaba/SP,0,1467,0,70983
199706,2022-02-05,Piracicaba/SP,8,1475,492,71475
205303,2022-02-06,Piracicaba/SP,0,1475,372,71847
210900,2022-02-07,Piracicaba/SP,0,1475,414,72261
216497,2022-02-08,Piracicaba/SP,6,1481,289,72550
222094,2022-02-09,Piracicaba/SP,4,1485,13,72563
227691,2022-02-10,Piracicaba/SP,2,1487,209,72772
233288,2022-02-11,Piracicaba/SP,5,1492,175,72947
238885,2022-02-12,Piracicaba/SP,2,1494,109,73056
244482,2022-02-13,Piracicaba/SP,1,1495,493,73549
250079,2022-02-14,Piracicaba/SP,2,1497,732,74281
255676,2022-02-15,Piracicaba/SP,4,1501,146,74427
261273,2022-02-16,Piracicaba/SP,3,1504,422,74849
266870,2022-02-17,Piracicaba/SP,2,1506,284,75133
272467,2022-02-18,Piracicaba/SP,2,1508,61,75194
278064,2022-02-19,Piracicaba/SP,3,1511,324,75518
283661,2022-02-20,Piracicaba/SP,-1,1510,800,76318
289258,2022-02-21,Piracicaba/SP,1,1511,466,76784
294855,2022-02-22,Piracicaba/SP,3,1514,150,76934
300452,2022-02-23,Piracicaba/SP,6,1520,129,77063
306049,2022-02-24,Piracicaba/SP,1,1521,127,77190
311646,2022-02-25,Piracicaba/SP,1,1522,10,77200
317243,2022-02-26,Piracicaba/SP,5,1527,58,77258
322840,2022-02-27,Piracicaba/SP,0,1527,239,77497
328437,2022-02-28,Piracicaba/SP,1,1528,15,77512
334034,2022-03-01,Piracicaba/SP,1,1529,26,77538
339631,2022-03-02,Piracicaba/SP,1,1530,1,77539
345228,2022-03-03,Piracicaba/SP,1,1531,45,77584
350825,2022-03-04,Piracicaba/SP,1,1532,85,77669
356422,2022-03-05,Piracicaba/SP,2,1534,115,77784
362019,2022-03-06,Piracicaba/SP,0,1534,16,77800
367616,2022-03-07,Piracicaba/SP,0,1534,16,77816
373213,2022-03-08,Piracicaba/SP,0,1534,96,77912
378810,2022-03-09,Piracicaba/SP,0,1534,32,77944
384407,2022-03-10,Piracicaba/SP,1,1535,65,78009
390004,2022-03-11,Piracicaba/SP,0,1535,18,78027
395601,2022-03-12,Piracicaba/SP,1,1536,2,78029
401198,2022-03-13,Piracicaba/SP,0,1536,91,78120
406795,2022-03-14,Piracicaba/SP,1,1537,174,78294
412392,2022-03-15,Piracicaba/SP,0,1537,-3,78291
417989,2022-03-16,Piracicaba/SP,1,1538,2,78293
423586,2022-03-17,Piracicaba/SP,0,1538,10,78303
429183,2022-03-18,Piracicaba/SP,1,1539,5,78308
434780,2022-03-19,Piracicaba/SP,2,1541,6,78314
440377,2022-03-20,Piracicaba/SP,0,1541,224,78538
445974,2022-03-21,Piracicaba/SP,0,1541,100,78638
451571,2022-03-22,Piracicaba/SP,0,1541,8,78646
457168,2022-03-23,Piracicaba/SP,0,1541,7,78653
462765,2022-03-24,Piracicaba/SP,0,1541,8,78661
468362,2022-03-25,Piracicaba/SP,0,1541,2,78663
473959,2022-03-26,Piracicaba/SP,1,1542,12,78675
479556,2022-03-27,Piracicaba/SP,0,1542,366,79041
485153,2022-03-28,Piracicaba/SP,1,1543,86,79127
490750,2022-03-29,Piracicaba/SP,0,1543,30,79157
496347,2022-03-30,Piracicaba/SP,0,1543,16,79173
501944,2022-03-31,Piracicaba/SP,1,1544,3,79176
507541,2022-04-01,Piracicaba/SP,0,1544,3,79179
513138,2022-04-02,Piracicaba/SP,1,1545,3,79182
518735,2022-04-03,Piracicaba/SP,0,1545,-2,79180
524332,2022-04-04,Piracicaba/SP,0,1545,0,79180
529929,2022-04-05,Piracicaba/SP,0,1545,1,79181
535526,2022-04-06,Piracicaba/SP,0,1545,0,79181
541123,2022-04-07,Piracicaba/SP,0,1545,0,79181
546720,2022-04-08,Piracicaba/SP,0,1545,0,79181
552317,2022-04-09,Piracicaba/SP,0,1545,1,79182
557914,2022-04-10,Piracicaba/SP,0,1545,40,79222
563511,2022-04-11,Piracicaba/SP,0,1545,454,79676
569108,2022-04-12,Piracicaba/SP,0,1545,105,79781
574705,2022-04-13,Piracicaba/SP,0,1545,16,79797
580302,2022-04-14,Piracicaba/SP,0,1545,1,79798
585899,2022-04-15,Piracicaba/SP,0,1545,0,79798
591496,2022-04-16,Piracicaba/SP,0,1545,28,79826
597093,2022-04-17,Piracicaba/SP,0,1545,0,79826
602690,2022-04-18,Piracicaba/SP,0,1545,6,79832
608287,2022-04-19,Piracicaba/SP,0,1545,0,79832
613884,2022-04-20,Piracicaba/SP,2,1547,1,79833
619481,2022-04-21,Piracicaba/SP,0,1547,17,79850
625078,2022-04-22,Piracicaba/SP,0,1547,69,79919
630675,2022-04-23,Piracicaba/SP,0,1547,0,79919
636272,2022-04-24,Piracicaba/SP,0,1547,136,80055
641869,2022-04-25,Piracicaba/SP,0,1547,354,80409
647466,2022-04-26,Piracicaba/SP,1,1548,146,80555
653063,2022-04-27,Piracicaba/SP,1,1549,76,80631
658660,2022-04-28,Piracicaba/SP,0,1549,33,80664
664257,2022-04-29,Piracicaba/SP,1,1550,0,80664
669854,2022-04-30,Piracicaba/SP,2,1552,0,80664
675451,2022-05-01,Piracicaba/SP,0,1552,201,80865
681048,2022-05-02,Piracicaba/SP,0,1552,15,80880
686645,2022-05-03,Piracicaba/SP,1,1553,0,80880
692242,2022-05-04,Piracicaba/SP,0,1553,1,80881
697839,2022-05-05,Piracicaba/SP,0,1553,0,80881
703436,2022-05-06,Piracicaba/SP,0,1553,0,80881
709033,2022-05-07,Piracicaba/SP,0,1553,0,80881
714630,2022-05-08,Piracicaba/SP,0,1553,206,81087
720227,2022-05-09,Piracicaba/SP,0,1553,0,81087
725824,2022-05-10,Piracicaba/SP,0,1553,83,81170
731421,2022-05-11,Piracicaba/SP,0,1553,40,81210
737018,2022-05-12,Piracicaba/SP,1,1554,29,81239
742615,2022-05-13,Piracicaba/SP,1,1555,2,81241
748212,2022-05-14,Piracicaba/SP,0,1555,2,81243
753809,2022-05-15,Piracicaba/SP,3,1558,326,81569
759406,2022-05-16,Piracicaba/SP,0,1558,290,81859
765003,2022-05-17,Piracicaba/SP,0,1558,91,81950
770600,2022-05-18,Piracicaba/SP,1,1559,1,81951
776197,2022-05-19,Piracicaba/SP,0,1559,2,81953
781794,2022-05-20,Piracicaba/SP,0,1559,0,81953
787391,2022-05-21,Piracicaba/SP,0,1559,0,81953
792988,2022-05-22,Piracicaba/SP,0,1559,87,82040
798585,2022-05-23,Piracicaba/SP,0,1559,0,82040
804182,2022-05-24,Piracicaba/SP,1,1560,6,82046
809779,2022-05-25,Piracicaba/SP,2,1562,62,82108
815376,2022-05-26,Piracicaba/SP,0,1562,29,82137
820973,2022-05-27,Piracicaba/SP,0,1562,3,82140
826570,2022-05-28,Piracicaba/SP,0,1562,2,82142
832167,2022-05-29,Piracicaba/SP,0,1562,174,82316
837764,2022-05-30,Piracicaba/SP,0,1562,57,82373
843361,2022-05-31,Piracicaba/SP,0,1562,107,82480
848958,2022-06-01,Piracicaba/SP,1,1563,75,82555
854555,2022-06-02,Piracicaba/SP,1,1564,77,82632
860152,2022-06-03,Piracicaba/SP,0,1564,0,82632
865749,2022-06-04,Piracicaba/SP,0,1564,0,82632
871346,2022-06-05,Piracicaba/SP,0,1564,0,82632
876943,2022-06-06,Piracicaba/SP,0,1564,0,82632
882540,2022-06-07,Piracicaba/SP,2,1566,781,83413
888137,2022-06-08,Piracicaba/SP,1,1567,131,83544
893734,2022-06-09,Piracicaba/SP,2,1569,42,83586
899331,2022-06-10,Piracicaba/SP,1,1570,170,83756
904928,2022-06-11,Piracicaba/SP,-1,1569,193,83949
910525,2022-06-12,Piracicaba/SP,0,1569,378,84327
916122,2022-06-13,Piracicaba/SP,0,1569,290,84617
921719,2022-06-14,Piracicaba/SP,0,1569,0,84617
927316,2022-06-15,Piracicaba/SP,1,1570,238,84855
932913,2022-06-16,Piracicaba/SP,0,1570,39,84894
938510,2022-06-17,Piracicaba/SP,0,1570,267,85161
944107,2022-06-18,Piracicaba/SP,1,1571,142,85303
949704,2022-06-19,Piracicaba/SP,0,1571,0,85303
955301,2022-06-20,Piracicaba/SP,0,1571,499,85802
960898,2022-06-21,Piracicaba/SP,0,1571,51,85853
966495,2022-06-22,Piracicaba/SP,0,1571,69,85922
972092,2022-06-23,Piracicaba/SP,0,1571,20,85942
977689,2022-06-24,Piracicaba/SP,2,1573,6,85948
983286,2022-06-25,Piracicaba/SP,1,1574,85,86033
988883,2022-06-26,Piracicaba/SP,0,1574,563,86596
994480,2022-06-27,Piracicaba/SP,0,1574,475,87071
1000077,2022-06-28,Piracicaba/SP,6,1580,86,87157
1005674,2022-06-29,Piracicaba/SP,2,1582,49,87206
1011271,2022-06-30,Piracicaba/SP,0,1582,126,87332
1016868,2022-07-01,Piracicaba/SP,0,1582,136,87468
1022465,2022-07-02,Piracicaba/SP,0,1582,54,87522
1028062,2022-07-03,Piracicaba/SP,0,1582,868,88390
1033659,2022-07-04,Piracicaba/SP,0,1582,402,88792
1039256,2022-07-05,Piracicaba/SP,5,1587,16,88808
1044853,2022-07-06,Piracicaba/SP,1,1588,46,88854
1050450,2022-07-07,Piracicaba/SP,1,1589,67,88921
1056047,2022-07-08,Piracicaba/SP,1,1590,84,89005
1061644,2022-07-09,Piracicaba/SP,2,1592,157,89162
1067241,2022-07-10,Piracicaba/SP,1,1593,339,89501
1072838,2022-07-11,Piracicaba/SP,1,1594,114,89615
1078435,2022-07-12,Piracicaba/SP,0,1594,173,89788
1084032,2022-07-13,Piracicaba/SP,1,1595,72,89860
1089629,2022-07-14,Piracicaba/SP,3,1598,90,89950
1095226,2022-07-15,Piracicaba/SP,0,1598,128,90078
1100823,2022-07-16,Piracicaba/SP,1,1599,4,90082
1106420,2022-07-17,Piracicaba/SP,1,1600,1,90083
1112017,2022-07-18,Piracicaba/SP,0,1600,20,90103
1117614,2022-07-19,Piracicaba/SP,2,1602,18,90121
1123211,2022-07-20,Piracicaba/SP,3,1605,7,90128
1128808,2022-07-21,Piracicaba/SP,0,1605,57,90185
1134405,2022-07-22,Piracicaba/SP,0,1605,64,90249
1140002,2022-07-23,Piracicaba/SP,1,1606,2,90251
1145599,2022-07-24,Piracicaba/SP,0,1606,279,90530
1151196,2022-07-25,Piracicaba/SP,0,1606,144,90674
1156793,2022-07-26,Piracicaba/SP,0,1606,169,90843
1162390,2022-07-27,Piracicaba/SP,1,1607,83,90926
1167987,2022-07-28,Piracicaba/SP,2,1609,20,90946
1173584,2022-07-29,Piracicaba/SP,0,1609,42,90988
1179181,2022-07-30,Piracicaba/SP,0,1609,14,91002
1184778,2022-07-31,Piracicaba/SP,0,1609,307,91309
1190375,2022-08-01,Piracicaba/SP,0,1609,244,91553
1195972,2022-08-02,Piracicaba/SP,3,1612,104,91657
1201569,2022-08-03,Piracicaba/SP,1,1613,74,91731
1207166,2022-08-04,Piracicaba/SP,0,1613,201,91932
1212763,2022-08-05,Piracicaba/SP,0,1613,219,92151
1218360,2022-08-06,Piracicaba/SP,1,1614,9,92160
1223957,2022-08-07,Piracicaba/SP,0,1614,317,92477
1229554,2022-08-08,Piracicaba/SP,0,1614,272,92749
1235151,2022-08-09,Piracicaba/SP,1,1615,72,92821
1240748,2022-08-10,Piracicaba/SP,0,1615,192,93013
1246345,2022-08-11,Piracicaba/SP,0,1615,166,93179
1251942,2022-08-12,Piracicaba/SP,1,1616,10,93189
1257539,2022-08-13,Piracicaba/SP,1,1617,53,93242
1263136,2022-08-14,Piracicaba/SP,0,1617,346,93588
1268733,2022-08-15,Piracicaba/SP,0,1617,0,93588
1274330,2022-08-16,Piracicaba/SP,0,1617,13,93601
1279927,2022-08-17,Piracicaba/SP,2,1619,16,93617
1285524,2022-08-18,Piracicaba/SP,0,1619,26,93643
1291121,2022-08-19,Piracicaba/SP,0,1619,17,93660
1296718,2022-08-20,Piracicaba/SP,0,1619,203,93863
1302315,2022-08-21,Piracicaba/SP,0,1619,285,94148
1307912,2022-08-22,Piracicaba/SP,0,1619,322,94470
1313509,2022-08-23,Piracicaba/SP,1,1620,397,94867
1319106,2022-08-24,Piracicaba/SP,0,1620,183,95050
1324703,2022-08-25,Piracicaba/SP,0,1620,274,95324
2764,2022-01-01,Limeira/SP,0,1174,1,27985
8361,2022-01-02,Limeira/SP,0,1174,0,27985
13958,2022-01-03,Limeira/SP,0,1174,0,27985
19555,2022-01-04,Limeira/SP,0,1174,60,28045
25152,2022-01-05,Limeira/SP,0,1174,40,28085
30749,2022-01-06,Limeira/SP,0,1174,57,28142
36346,2022-01-07,Limeira/SP,1,1175,36,28178
41943,2022-01-08,Limeira/SP,0,1175,19,28197
47540,2022-01-09,Limeira/SP,1,1176,4,28201
53137,2022-01-10,Limeira/SP,0,1176,0,28201
58734,2022-01-11,Limeira/SP,0,1176,30,28231
64331,2022-01-12,Limeira/SP,0,1176,105,28336
69928,2022-01-13,Limeira/SP,0,1176,82,28418
75525,2022-01-14,Limeira/SP,0,1176,85,28503
81122,2022-01-15,Limeira/SP,0,1176,11,28514
86719,2022-01-16,Limeira/SP,1,1177,12,28526
92316,2022-01-17,Limeira/SP,0,1177,0,28526
97913,2022-01-18,Limeira/SP,0,1177,85,28611
103510,2022-01-19,Limeira/SP,0,1177,58,28669
109107,2022-01-20,Limeira/SP,0,1177,68,28737
114704,2022-01-21,Limeira/SP,0,1177,36,28773
120301,2022-01-22,Limeira/SP,0,1177,0,28773
125898,2022-01-23,Limeira/SP,0,1177,224,28997
131495,2022-01-24,Limeira/SP,0,1177,0,28997
137092,2022-01-25,Limeira/SP,0,1177,43,29040
142689,2022-01-26,Limeira/SP,0,1177,9,29049
148286,2022-01-27,Limeira/SP,0,1177,3,29052
153883,2022-01-28,Limeira/SP,6,1183,22,29074
159480,2022-01-29,Limeira/SP,5,1188,9,29083
165077,2022-01-30,Limeira/SP,0,1188,86,29169
170674,2022-01-31,Limeira/SP,0,1188,0,29169
176271,2022-02-01,Limeira/SP,2,1190,2,29171
181868,2022-02-02,Limeira/SP,0,1190,2,29173
187465,2022-02-03,Limeira/SP,0,1190,92,29265
193062,2022-02-04,Limeira/SP,0,1190,0,29265
198659,2022-02-05,Limeira/SP,13,1203,125,29390
204256,2022-02-06,Limeira/SP,0,1203,118,29508
209853,2022-02-07,Limeira/SP,0,1203,1,29509
215450,2022-02-08,Limeira/SP,5,1208,22,29531
221047,2022-02-09,Limeira/SP,3,1211,94,29625
226644,2022-02-10,Limeira/SP,0,1211,73,29698
232241,2022-02-11,Limeira/SP,3,1214,84,29782
237838,2022-02-12,Limeira/SP,1,1215,30,29812
243435,2022-02-13,Limeira/SP,0,1215,168,29980
249032,2022-02-14,Limeira/SP,0,1215,0,29980
254629,2022-02-15,Limeira/SP,1,1216,23,30003
260226,2022-02-16,Limeira/SP,0,1216,37,30040
265823,2022-02-17,Limeira/SP,1,1217,22,30062
271420,2022-02-18,Limeira/SP,5,1222,69,30131
277017,2022-02-19,Limeira/SP,4,1226,50,30181
282614,2022-02-20,Limeira/SP,0,1226,229,30410
288211,2022-02-21,Limeira/SP,0,1226,0,30410
293808,2022-02-22,Limeira/SP,0,1226,75,30485
299405,2022-02-23,Limeira/SP,3,1229,130,30615
305002,2022-02-24,Limeira/SP,2,1231,219,30834
310599,2022-02-25,Limeira/SP,3,1234,180,31014
316196,2022-02-26,Limeira/SP,5,1239,96,31110
321793,2022-02-27,Limeira/SP,0,1239,614,31724
327390,2022-02-28,Limeira/SP,0,1239,0,31724
332987,2022-03-01,Limeira/SP,0,1239,6,31730
338584,2022-03-02,Limeira/SP,0,1239,0,31730
344181,2022-03-03,Limeira/SP,2,1241,462,32192
349778,2022-03-04,Limeira/SP,2,1243,70,32262
355375,2022-03-05,Limeira/SP,0,1243,89,32351
360972,2022-03-06,Limeira/SP,0,1243,8,32359
366569,2022-03-07,Limeira/SP,0,1243,3,32362
372166,2022-03-08,Limeira/SP,0,1243,131,32493
377763,2022-03-09,Limeira/SP,0,1243,285,32778
383360,2022-03-10,Limeira/SP,0,1243,316,33094
388957,2022-03-11,Limeira/SP,1,1244,190,33284
394554,2022-03-12,Limeira/SP,0,1244,104,33388
400151,2022-03-13,Limeira/SP,0,1244,545,33933
405748,2022-03-14,Limeira/SP,0,1244,0,33933
411345,2022-03-15,Limeira/SP,0,1244,111,34044
416942,2022-03-16,Limeira/SP,1,1245,344,34388
422539,2022-03-17,Limeira/SP,0,1245,230,34618
428136,2022-03-18,Limeira/SP,0,1245,227,34845
433733,2022-03-19,Limeira/SP,1,1246,65,34910
439330,2022-03-20,Limeira/SP,0,1246,522,35432
444927,2022-03-21,Limeira/SP,0,1246,0,35432
450524,2022-03-22,Limeira/SP,0,1246,120,35552
456121,2022-03-23,Limeira/SP,0,1246,226,35778
461718,2022-03-24,Limeira/SP,0,1246,136,35914
467315,2022-03-25,Limeira/SP,0,1246,70,35984
472912,2022-03-26,Limeira/SP,0,1246,55,36039
478509,2022-03-27,Limeira/SP,0,1246,359,36398
484106,2022-03-28,Limeira/SP,0,1246,0,36398
489703,2022-03-29,Limeira/SP,0,1246,154,36552
495300,2022-03-30,Limeira/SP,0,1246,120,36672
500897,2022-03-31,Limeira/SP,1,1247,446,37118
506494,2022-04-01,Limeira/SP,0,1247,104,37222
512091,2022-04-02,Limeira/SP,0,1247,112,37334
517688,2022-04-03,Limeira/SP,0,1247,39,37373
523285,2022-04-04,Limeira/SP,0,1247,7,37380
528882,2022-04-05,Limeira/SP,0,1247,194,37574
534479,2022-04-06,Limeira/SP,2,1249,137,37711
540076,2022-04-07,Limeira/SP,0,1249,203,37914
545673,2022-04-08,Limeira/SP,0,1249,22,37936
551270,2022-04-09,Limeira/SP,0,1249,78,38014
556867,2022-04-10,Limeira/SP,0,1249,489,38503
562464,2022-04-11,Limeira/SP,0,1249,0,38503
568061,2022-04-12,Limeira/SP,0,1249,206,38709
573658,2022-04-13,Limeira/SP,0,1249,250,38959
579255,2022-04-14,Limeira/SP,0,1249,242,39201
584852,2022-04-15,Limeira/SP,1,1250,62,39263
590449,2022-04-16,Limeira/SP,0,1250,0,39263
596046,2022-04-17,Limeira/SP,0,1250,0,39263
601643,2022-04-18,Limeira/SP,0,1250,0,39263
607240,2022-04-19,Limeira/SP,0,1250,0,39263
612837,2022-04-20,Limeira/SP,0,1250,107,39370
618434,2022-04-21,Limeira/SP,1,1251,42,39412
624031,2022-04-22,Limeira/SP,0,1251,8,39420
629628,2022-04-23,Limeira/SP,0,1251,4,39424
635225,2022-04-24,Limeira/SP,0,1251,35,39459
640822,2022-04-25,Limeira/SP,0,1251,0,39459
646419,2022-04-26,Limeira/SP,0,1251,228,39687
652016,2022-04-27,Limeira/SP,0,1251,190,39877
657613,2022-04-28,Limeira/SP,0,1251,64,39941
663210,2022-04-29,Limeira/SP,0,1251,9,39950
668807,2022-04-30,Limeira/SP,0,1251,16,39966
674404,2022-05-01,Limeira/SP,0,1251,0,39966
680001,2022-05-02,Limeira/SP,0,1251,0,39966
685598,2022-05-03,Limeira/SP,0,1251,168,40134
691195,2022-05-04,Limeira/SP,0,1251,176,40310
696792,2022-05-05,Limeira/SP,0,1251,149,40459
702389,2022-05-06,Limeira/SP,0,1251,104,40563
707986,2022-05-07,Limeira/SP,0,1251,62,40625
713583,2022-05-08,Limeira/SP,0,1251,437,41062
719180,2022-05-09,Limeira/SP,0,1251,0,41062
724777,2022-05-10,Limeira/SP,0,1251,220,41282
730374,2022-05-11,Limeira/SP,0,1251,202,41484
735971,2022-05-12,Limeira/SP,0,1251,150,41634
741568,2022-05-13,Limeira/SP,0,1251,79,41713
747165,2022-05-14,Limeira/SP,0,1251,17,41730
752762,2022-05-15,Limeira/SP,0,1251,479,42209
758359,2022-05-16,Limeira/SP,0,1251,0,42209
763956,2022-05-17,Limeira/SP,0,1251,161,42370
769553,2022-05-18,Limeira/SP,0,1251,97,42467
775150,2022-05-19,Limeira/SP,0,1251,154,42621
780747,2022-05-20,Limeira/SP,0,1251,0,42621
786344,2022-05-21,Limeira/SP,0,1251,0,42621
791941,2022-05-22,Limeira/SP,0,1251,232,42853
797538,2022-05-23,Limeira/SP,0,1251,0,42853
803135,2022-05-24,Limeira/SP,0,1251,33,42886
808732,2022-05-25,Limeira/SP,0,1251,19,42905
814329,2022-05-26,Limeira/SP,0,1251,35,42940
819926,2022-05-27,Limeira/SP,0,1251,28,42968
825523,2022-05-28,Limeira/SP,0,1251,2,42970
831120,2022-05-29,Limeira/SP,0,1251,1,42971
836717,2022-05-30,Limeira/SP,0,1251,0,42971
842314,2022-05-31,Limeira/SP,0,1251,2,42973
847911,2022-06-01,Limeira/SP,0,1251,23,42996
853508,2022-06-02,Limeira/SP,0,1251,3,42999
859105,2022-06-03,Limeira/SP,0,1251,0,42999
864702,2022-06-04,Limeira/SP,0,1251,0,42999
870299,2022-06-05,Limeira/SP,0,1251,0,42999
875896,2022-06-06,Limeira/SP,0,1251,0,42999
881493,2022-06-07,Limeira/SP,0,1251,54,43053
887090,2022-06-08,Limeira/SP,0,1251,18,43071
892687,2022-06-09,Limeira/SP,0,1251,13,43084
898284,2022-06-10,Limeira/SP,0,1251,12,43096
903881,2022-06-11,Limeira/SP,0,1251,0,43096
909478,2022-06-12,Limeira/SP,0,1251,3,43099
915075,2022-06-13,Limeira/SP,0,1251,1,43100
920672,2022-06-14,Limeira/SP,0,1251,0,43100
926269,2022-06-15,Limeira/SP,0,1251,3,43103
931866,2022-06-16,Limeira/SP,0,1251,0,43103
937463,2022-06-17,Limeira/SP,0,1251,0,43103
943060,2022-06-18,Limeira/SP,0,1251,1,43104
948657,2022-06-19,Limeira/SP,0,1251,0,43104
954254,2022-06-20,Limeira/SP,0,1251,0,43104
959851,2022-06-21,Limeira/SP,0,1251,11,43115
965448,2022-06-22,Limeira/SP,0,1251,65,43180
971045,2022-06-23,Limeira/SP,0,1251,4,43184
976642,2022-06-24,Limeira/SP,1,1252,2,43186
982239,2022-06-25,Limeira/SP,0,1252,0,43186
987836,2022-06-26,Limeira/SP,0,1252,0,43186
993433,2022-06-27,Limeira/SP,0,1252,0,43186
999030,2022-06-28,Limeira/SP,5,1257,13,43199
1004627,2022-06-29,Limeira/SP,1,1258,8,43207
1010224,2022-06-30,Limeira/SP,0,1258,4,43211
1015821,2022-07-01,Limeira/SP,0,1258,0,43211
1021418,2022-07-02,Limeira/SP,0,1258,1,43212
1027015,2022-07-03,Limeira/SP,0,1258,2,43214
1032612,2022-07-04,Limeira/SP,0,1258,0,43214
1038209,2022-07-05,Limeira/SP,2,1260,1,43215
1043806,2022-07-06,Limeira/SP,0,1260,1,43216
1049403,2022-07-07,Limeira/SP,0,1260,2,43218
1055000,2022-07-08,Limeira/SP,0,1260,1,43219
1060597,2022-07-09,Limeira/SP,0,1260,0,43219
1066194,2022-07-10,Limeira/SP,0,1260,0,43219
1071791,2022-07-11,Limeira/SP,0,1260,1,43220
1077388,2022-07-12,Limeira/SP,0,1260,1,43221
1082985,2022-07-13,Limeira/SP,0,1260,6,43227
1088582,2022-07-14,Limeira/SP,0,1260,3,43230
1094179,2022-07-15,Limeira/SP,0,1260,1,43231
1099776,2022-07-16,Limeira/SP,0,1260,0,43231
1105373,2022-07-17,Limeira/SP,0,1260,0,43231
1110970,2022-07-18,Limeira/SP,0,1260,0,43231
1116567,2022-07-19,Limeira/SP,0,1260,1,43232
1122164,2022-07-20,Limeira/SP,3,1263,0,43232
1127761,2022-07-21,Limeira/SP,0,1263,0,43232
1133358,2022-07-22,Limeira/SP,0,1263,0,43232
1138955,2022-07-23,Limeira/SP,0,1263,0,43232
1144552,2022-07-24,Limeira/SP,0,1263,-1,43231
1150149,2022-07-25,Limeira/SP,0,1263,0,43231
1155746,2022-07-26,Limeira/SP,2,1265,1,43232
1161343,2022-07-27,Limeira/SP,0,1265,5,43237
1166940,2022-07-28,Limeira/SP,0,1265,2,43239
1172537,2022-07-29,Limeira/SP,0,1265,11,43250
1178134,2022-07-30,Limeira/SP,0,1265,0,43250
1183731,2022-07-31,Limeira/SP,0,1265,0,43250
1189328,2022-08-01,Limeira/SP,0,1265,0,43250
1194925,2022-08-02,Limeira/SP,3,1268,2,43252
1200522,2022-08-03,Limeira/SP,0,1268,1,43253
1206119,2022-08-04,Limeira/SP,0,1268,1,43254
1211716,2022-08-05,Limeira/SP,0,1268,0,43254
1217313,2022-08-06,Limeira/SP,1,1269,1,43255
1222910,2022-08-07,Limeira/SP,4,1273,4,43259
1228507,2022-08-08,Limeira/SP,0,1273,0,43259
1234104,2022-08-09,Limeira/SP,0,1273,1,43260
1239701,2022-08-10,Limeira/SP,0,1273,0,43260
1245298,2022-08-11,Limeira/SP,1,1274,1,43261
1250895,2022-08-12,Limeira/SP,0,1274,1,43262
1256492,2022-08-13,Limeira/SP,1,1275,0,43262
1262089,2022-08-14,Limeira/SP,0,1275,1,43263
1267686,2022-08-15,Limeira/SP,0,1275,0,43263
1273283,2022-08-16,Limeira/SP,1,1276,15,43278
1278880,2022-08-17,Limeira/SP,5,1281,6,43284
1284477,2022-08-18,Limeira/SP,0,1281,0,43284
1290074,2022-08-19,Limeira/SP,0,1281,23,43307
1295671,2022-08-20,Limeira/SP,0,1281,1,43308
1301268,2022-08-21,Limeira/SP,0,1281,0,43308
1306865,2022-08-22,Limeira/SP,0,1281,0,43308
1312462,2022-08-23,Limeira/SP,2,1283,37,43345
1318059,2022-08-24,Limeira/SP,0,1283,9,43354
1323656,2022-08-25,Limeira/SP,0,1283,1,43355
36,2020-03-08,MG,0,0,1,1
44,2020-03-09,MG,0,0,0,1
52,2020-03-10,MG,0,0,0,1
61,2020-03-11,MG,0,0,0,1
71,2020-03-12,MG,0,0,1,2
86,2020-03-13,MG,0,0,0,2
101,2020-03-14,MG,0,0,2,4
118,2020-03-15,MG,0,0,0,4
136,2020-03-16,MG,0,0,2,6
155,2020-03-17,MG,0,0,8,14
174,2020-03-18,MG,0,0,5,19
196,2020-03-19,MG,0,0,10,29
221,2020-03-20,MG,0,0,9,38
248,2020-03-21,MG,0,0,17,55
276,2020-03-22,MG,0,0,28,83
304,2020-03-23,MG,0,0,45,128
332,2020-03-24,MG,0,0,2,130
360,2020-03-25,MG,0,0,3,133
388,2020-03-26,MG,0,0,20,153
416,2020-03-27,MG,0,0,36,189
444,2020-03-28,MG,0,0,16,205
472,2020-03-29,MG,0,0,26,231
500,2020-03-30,MG,1,1,30,261
528,2020-03-31,MG,1,2,14,275
556,2020-04-01,MG,1,3,39,314
584,2020-04-02,MG,1,4,56,370
612,2020-04-03,MG,2,6,27,397
640,2020-04-04,MG,0,6,33,430
668,2020-04-05,MG,0,6,68,498
696,2020-04-06,MG,3,9,27,525
724,2020-04-07,MG,2,11,34,559
752,2020-04-08,MG,3,14,55,614
780,2020-04-09,MG,1,15,41,655
808,2020-04-10,MG,2,17,43,698
836,2020-04-11,MG,0,17,52,750
864,2020-04-12,MG,3,20,56,806
892,2020-04-13,MG,3,23,9,815
920,2020-04-14,MG,4,27,69,884
948,2020-04-15,MG,3,30,19,903
976,2020-04-16,MG,3,33,55,958
1004,2020-04-17,MG,2,35,63,1021
1032,2020-04-18,MG,4,39,56,1077
1060,2020-04-19,MG,0,39,77,1154
1088,2020-04-20,MG,2,41,35,1189
1116,2020-04-21,MG,3,44,41,1230
1144,2020-04-22,MG,3,47,53,1283
1172,2020-04-23,MG,4,51,25,1308
1200,2020-04-24,MG,3,54,111,1419
1228,2020-04-25,MG,4,58,62,1481
1256,2020-04-26,MG,3,61,67,1548
1284,2020-04-27,MG,1,62,38,1586
1312,2020-04-28,MG,9,71,63,1649
1340,2020-04-29,MG,9,80,109,1758
1368,2020-04-30,MG,2,82,69,1827
1396,2020-05-01,MG,6,88,108,1935
1424,2020-05-02,MG,0,88,88,2023
1452,2020-05-03,MG,1,89,95,2118
1480,2020-05-04,MG,1,90,229,2347
1508,2020-05-05,MG,4,94,105,2452
1536,2020-05-06,MG,3,97,153,2605
1564,2020-05-07,MG,9,106,165,2770
1592,2020-05-08,MG,5,111,173,2943
1620,2020-05-09,MG,7,118,180,3123
1648,2020-05-10,MG,1,119,114,3237
1676,2020-05-11,MG,2,121,83,3320
1704,2020-05-12,MG,6,127,115,3435
1732,2020-05-13,MG,8,135,298,3733
1760,2020-05-14,MG,4,139,217,3950
1788,2020-05-15,MG,7,146,246,4196
1816,2020-05-16,MG,4,150,278,4474
1844,2020-05-17,MG,6,156,137,4611
1872,2020-05-18,MG,5,161,84,4695
1900,2020-05-19,MG,6,167,282,4977
1928,2020-05-20,MG,10,177,309,5286
1956,2020-05-21,MG,14,191,310,5596
1984,2020-05-22,MG,10,201,399,5995
2012,2020-05-23,MG,16,217,343,6338
2040,2020-05-24,MG,9,226,330,6668
2068,2020-05-25,MG,4,230,294,6962
2096,2020-05-26,MG,4,234,554,7516
2124,2020-05-27,MG,6,240,495,8011
2152,2020-05-28,MG,15,255,675,8686
2180,2020-05-29,MG,2,257,546,9232
2208,2020-05-30,MG,6,263,398,9630
2236,2020-05-31,MG,8,271,834,10464
2264,2020-06-01,MG,7,278,206,10670
2292,2020-06-02,MG,11,289,269,10939
2320,2020-06-03,MG,17,306,1071,12010
2348,2020-06-04,MG,17,323,1024,13034
2376,2020-06-05,MG,21,344,961,13995
2404,2020-06-06,MG,24,368,944,14939
2432,2020-06-07,MG,8,376,764,15703
2460,2020-06-08,MG,4,380,180,15883
2488,2020-06-09,MG,19,399,219,16102
2516,2020-06-10,MG,10,409,1399,17501
2544,2020-06-11,MG,22,431,947,18448
2572,2020-06-12,MG,15,446,1658,20106
2600,2020-06-13,MG,8,454,508,20614
2628,2020-06-14,MG,21,475,767,21381
2656,2020-06-15,MG,6,481,347,21728
2684,2020-06-16,MG,21,502,296,22024
2712,2020-06-17,MG,35,537,1323,23347
2740,2020-06-18,MG,33,570,1559,24906
2768,2020-06-19,MG,30,600,1146,26052
2796,2020-06-20,MG,36,636,1253,27305
2824,2020-06-21,MG,25,661,336,27641
2852,2020-06-22,MG,27,688,1277,28918
2880,2020-06-23,MG,32,720,979,29897
2908,2020-06-24,MG,51,771,1446,31343
2936,2020-06-25,MG,35,806,1426,32769
2964,2020-06-26,MG,27,833,6122,38891
2992,2020-06-27,MG,49,882,2075,40966
3020,2020-06-28,MG,17,899,1775,42741
3048,2020-06-29,MG,41,940,1123,43864
3076,2020-06-30,MG,25,965,1137,45001
3104,2020-07-01,MG,42,1007,2583,47584
3132,2020-07-02,MG,52,1059,3123,50707
3160,2020-07-03,MG,51,1110,2644,53351
3188,2020-07-04,MG,73,1183,2607,55958
3216,2020-07-05,MG,18,1201,2325,58283
3244,2020-07-06,MG,29,1230,1343,59626
3272,2020-07-07,MG,52,1282,1271,60897
3300,2020-07-08,MG,73,1355,3138,64035
3328,2020-07-09,MG,90,1445,2829,66864
3356,2020-07-10,MG,59,1504,3222,70086
3384,2020-07-11,MG,46,1550,3727,73813
3412,2020-07-12,MG,26,1576,2038,75851
3440,2020-07-13,MG,39,1615,971,76822
3468,2020-07-14,MG,73,1688,1821,78643
3496,2020-07-15,MG,64,1752,3367,82010
3524,2020-07-16,MG,82,1834,2460,84470
3552,2020-07-17,MG,70,1904,2801,87271
3580,2020-07-18,MG,60,1964,3604,90875
3608,2020-07-19,MG,18,1982,2097,92972
3636,2020-07-20,MG,22,2004,1160,94132
3664,2020-07-21,MG,67,2071,1434,95566
3692,2020-07-22,MG,95,2166,3175,98741
3720,2020-07-23,MG,72,2238,3827,102568
3748,2020-07-24,MG,77,2315,4244,106812
3776,2020-07-25,MG,89,2404,3281,110093
3804,2020-07-26,MG,25,2429,2478,112571
3832,2020-07-27,MG,32,2461,1147,113718
3860,2020-07-28,MG,90,2551,2927,116645
3888,2020-07-29,MG,57,2608,2749,119394
3916,2020-07-30,MG,84,2692,4021,123415
3944,2020-07-31,MG,77,2769,3691,127106
3972,2020-08-01,MG,92,2861,2879,129985
4000,2020-08-02,MG,30,2891,2816,132801
4028,2020-08-03,MG,3,2894,942,133743
4056,2020-08-04,MG,149,3043,1985,135728
4084,2020-08-05,MG,152,3195,3933,139661
4112,2020-08-06,MG,109,3304,3167,142828
4140,2020-08-07,MG,77,3381,4495,147323
4168,2020-08-08,MG,68,3449,3400,150723
4196,2020-08-09,MG,88,3537,3204,153927
4224,2020-08-10,MG,60,3597,1148,155075
4252,2020-08-11,MG,16,3613,1476,156551
4280,2020-08-12,MG,170,3783,3934,160485
4308,2020-08-13,MG,63,3846,4430,164915
4336,2020-08-14,MG,97,3943,3513,168428
4364,2020-08-15,MG,101,4044,3086,171514
4392,2020-08-16,MG,88,4132,2888,174402
4420,2020-08-17,MG,91,4223,1313,175715
4448,2020-08-18,MG,83,4306,2072,177787
4476,2020-08-19,MG,130,4436,3371,181158
4504,2020-08-20,MG,107,4543,3904,185062
4532,2020-08-21,MG,120,4663,3561,188623
4560,2020-08-22,MG,74,4737,2884,191507
4588,2020-08-23,MG,53,4790,3107,194614
4616,2020-08-24,MG,15,4805,1306,195920
4644,2020-08-25,MG,42,4847,2816,198736
4672,2020-08-26,MG,101,4948,3237,201973
4700,2020-08-27,MG,101,5049,3969,205942
4728,2020-08-28,MG,118,5167,3523,209465
4756,2020-08-29,MG,103,5270,3100,212565
4784,2020-08-30,MG,56,5326,2485,215050
4812,2020-08-31,MG,9,5335,1507,216557
4840,2020-09-01,MG,29,5364,2224,218781
4868,2020-09-02,MG,141,5505,3267,222048
4896,2020-09-03,MG,86,5591,2939,224987
4924,2020-09-04,MG,117,5708,3026,228013
4952,2020-09-05,MG,0,5708,3865,231878
4980,2020-09-06,MG,129,5837,2926,234804
5008,2020-09-07,MG,14,5851,1208,236012
5036,2020-09-08,MG,26,5877,651,236663
5064,2020-09-09,MG,58,5935,1852,238515
5092,2020-09-10,MG,74,6009,4018,242533
5120,2020-09-11,MG,105,6114,3616,246149
5148,2020-09-12,MG,86,6200,4041,250190
5176,2020-09-13,MG,76,6276,2073,252263
5204,2020-09-14,MG,10,6286,1734,253997
5232,2020-09-15,MG,42,6328,1609,255606
5260,2020-09-16,MG,91,6419,2989,258595
5288,2020-09-17,MG,81,6500,3406,262001
5316,2020-09-18,MG,74,6574,3184,265185
5344,2020-09-19,MG,82,6656,2824,268009
5372,2020-09-20,MG,58,6714,2044,270053
5400,2020-09-21,MG,13,6727,1141,271194
5428,2020-09-22,MG,37,6764,2039,273233
5456,2020-09-23,MG,133,6897,3081,276314
5484,2020-09-24,MG,86,6983,2587,278901
5512,2020-09-25,MG,73,7056,4578,283479
5540,2020-09-26,MG,125,7181,2871,286350
5568,2020-09-27,MG,47,7228,2269,288619
5596,2020-09-28,MG,12,7240,1518,290137
5624,2020-09-29,MG,19,7259,2154,292291
5652,2020-09-30,MG,101,7360,2878,295169
5680,2020-10-01,MG,76,7436,3438,298607
5708,2020-10-02,MG,66,7502,3475,302082
5736,2020-10-03,MG,67,7569,3445,305527
5764,2020-10-04,MG,74,7643,1672,307199
5792,2020-10-05,MG,13,7656,1267,308466
5820,2020-10-06,MG,48,7704,1658,310124
5848,2020-10-07,MG,107,7811,2908,313032
5876,2020-10-08,MG,86,7897,2009,315041
5904,2020-10-09,MG,95,7992,3049,318090
5932,2020-10-10,MG,69,8061,3050,321140
5960,2020-10-11,MG,66,8127,1796,322936
5988,2020-10-12,MG,3,8130,1031,323967
6016,2020-10-13,MG,15,8145,659,324626
6044,2020-10-14,MG,26,8171,1346,325972
6072,2020-10-15,MG,96,8267,2430,328402
6100,2020-10-16,MG,78,8345,3031,331433
6128,2020-10-17,MG,60,8405,2565,333998
6156,2020-10-18,MG,41,8446,1685,335683
6184,2020-10-19,MG,7,8453,965,336648
6212,2020-10-20,MG,30,8483,1459,338107
6240,2020-10-21,MG,71,8554,2395,340502
6268,2020-10-22,MG,67,8621,2657,343159
6296,2020-10-23,MG,65,8686,2029,345188
6324,2020-10-24,MG,46,8732,1818,347006
6352,2020-10-25,MG,38,8770,1798,348804
6380,2020-10-26,MG,9,8779,708,349512
6408,2020-10-27,MG,10,8789,1521,351033
6436,2020-10-28,MG,83,8872,2278,353311
6464,2020-10-29,MG,44,8916,1915,355226
6492,2020-10-30,MG,99,9015,3745,358971
6520,2020-10-31,MG,0,9015,0,358971
6548,2020-11-01,MG,23,9038,1020,359991
6576,2020-11-02,MG,9,9047,839,360830
6604,2020-11-03,MG,3,9050,326,361156
6632,2020-11-04,MG,19,9069,1184,362340
6660,2020-11-05,MG,59,9128,2201,364541
6688,2020-11-06,MG,71,9199,1762,366303
6716,2020-11-07,MG,5,9204,2306,368609
6744,2020-11-08,MG,0,9204,1347,369956
6772,2020-11-09,MG,0,9204,1035,370991
6800,2020-11-10,MG,0,9204,1491,372482
6828,2020-11-11,MG,0,9204,2169,374651
6856,2020-11-12,MG,55,9259,1886,376537
6884,2020-11-13,MG,146,9405,2737,379274
6912,2020-11-14,MG,99,9504,2036,381310
6940,2020-11-15,MG,3,9507,1572,382882
6968,2020-11-16,MG,10,9517,591,383473
6996,2020-11-17,MG,14,9531,1954,385427
7024,2020-11-18,MG,74,9605,2324,387751
7052,2020-11-19,MG,43,9648,2586,390337
7080,2020-11-20,MG,40,9688,2773,393110
7108,2020-11-21,MG,44,9732,2424,395534
7136,2020-11-22,MG,45,9777,1399,396933
7164,2020-11-23,MG,17,9794,1081,398014
7192,2020-11-24,MG,10,9804,1522,399536
7220,2020-11-25,MG,54,9858,4006,403542
7248,2020-11-26,MG,46,9904,3338,406880
7276,2020-11-27,MG,44,9948,2851,409731
7304,2020-11-28,MG,42,9990,3265,412996
7332,2020-11-29,MG,41,10031,2251,415247
7360,2020-11-30,MG,10,10041,1088,416335
7388,2020-12-01,MG,10,10051,3320,419655
7416,2020-12-02,MG,70,10121,4500,424155
7444,2020-12-03,MG,66,10187,4635,428790
7472,2020-12-04,MG,40,10227,4291,433081
7500,2020-12-05,MG,56,10283,5223,438304
7528,2020-12-06,MG,53,10336,3011,441315
7556,2020-12-07,MG,5,10341,871,442186
7584,2020-12-08,MG,4,10345,2614,444800
7612,2020-12-09,MG,84,10429,4080,448880
7640,2020-12-10,MG,70,10499,4484,453364
7668,2020-12-11,MG,66,10565,6173,459537
7696,2020-12-12,MG,80,10645,5008,464545
7724,2020-12-13,MG,56,10701,3478,468023
7752,2020-12-14,MG,10,10711,980,469003
7780,2020-12-15,MG,8,10719,4222,473225
7808,2020-12-16,MG,136,10855,4472,477697
7836,2020-12-17,MG,78,10933,5672,483369
7864,2020-12-18,MG,76,11009,5565,488934
7892,2020-12-19,MG,84,11093,5253,494187
7920,2020-12-20,MG,132,11225,3485,497672
7948,2020-12-21,MG,10,11235,1827,499499
7976,2020-12-22,MG,23,11258,4201,503700
8004,2020-12-23,MG,97,11355,6519,510219
8032,2020-12-24,MG,120,11475,5969,516188
8060,2020-12-25,MG,87,11562,4030,520218
8088,2020-12-26,MG,23,11585,2113,522331
8116,2020-12-27,MG,7,11592,1217,523548
8144,2020-12-28,MG,13,11605,1110,524658
8172,2020-12-29,MG,10,11615,4995,529653
8200,2020-12-30,MG,169,11784,6391,536044
8228,2020-12-31,MG,118,11902,6865,542909
8256,2021-01-01,MG,99,12001,3975,546884
8284,2021-01-02,MG,22,12023,2418,549302
8312,2021-01-03,MG,14,12037,1370,550672
8340,2021-01-04,MG,26,12063,1432,552104
8368,2021-01-05,MG,20,12083,4588,556692
8396,2021-01-06,MG,128,12211,9515,566207
8424,2021-01-07,MG,155,12366,5450,571657
8452,2021-01-08,MG,103,12469,7812,579469
8480,2021-01-09,MG,125,12594,8399,587868
8508,2021-01-10,MG,115,12709,4443,592311
8536,2021-01-11,MG,27,12736,2696,595007
8564,2021-01-12,MG,14,12750,7826,602833
8592,2021-01-13,MG,144,12894,8319,611152
8620,2021-01-14,MG,134,13028,8694,619846
8648,2021-01-15,MG,154,13182,9120,628966
8676,2021-01-16,MG,173,13355,7831,636797
8704,2021-01-17,MG,110,13465,6812,643609
8732,2021-01-18,MG,18,13483,2482,646091
8760,2021-01-19,MG,24,13507,5865,651956
8788,2021-01-20,MG,214,13721,7429,659385
8816,2021-01-21,MG,170,13891,8831,668216
8844,2021-01-22,MG,119,14010,9593,677809
8872,2021-01-23,MG,138,14148,8873,686682
8900,2021-01-24,MG,131,14279,4171,690853
8928,2021-01-25,MG,26,14305,2697,693550
8956,2021-01-26,MG,23,14328,5707,699257
8984,2021-01-27,MG,216,14544,8392,707649
9012,2021-01-28,MG,155,14699,8318,715967
9040,2021-01-29,MG,120,14819,6000,721967
9068,2021-01-30,MG,120,14939,8001,729968
9096,2021-01-31,MG,121,15060,4518,734486
9124,2021-02-01,MG,34,15094,1779,736265
9152,2021-02-02,MG,32,15126,4707,740972
9180,2021-02-03,MG,189,15315,5947,746919
9208,2021-02-04,MG,184,15499,10052,756971
9236,2021-02-05,MG,168,15667,5441,762412
9264,2021-02-06,MG,140,15807,4649,767061
9292,2021-02-07,MG,123,15930,7050,774111
9320,2021-02-08,MG,37,15967,2104,776215
9348,2021-02-09,MG,23,15990,3972,780187
9376,2021-02-10,MG,243,16233,6466,786653
9404,2021-02-11,MG,172,16405,6504,793157
9432,2021-02-12,MG,190,16595,5554,798711
9460,2021-02-13,MG,165,16760,5352,804063
9488,2021-02-14,MG,119,16879,3184,807247
9516,2021-02-15,MG,8,16887,1446,808693
9544,2021-02-16,MG,16,16903,3049,811742
9572,2021-02-17,MG,206,17109,5159,816901
9600,2021-02-18,MG,140,17249,5547,822448
9628,2021-02-19,MG,193,17442,4989,827437
9656,2021-02-20,MG,152,17594,9604,837041
9684,2021-02-21,MG,120,17714,3274,840315
9712,2021-02-22,MG,19,17733,2062,842377
9740,2021-02-23,MG,41,17774,5386,847763
9768,2021-02-24,MG,200,17974,5696,853459
9796,2021-02-25,MG,161,18135,9043,862502
9824,2021-02-26,MG,141,18276,6728,869230
9852,2021-02-27,MG,155,18431,5654,874884
9880,2021-02-28,MG,134,18565,3821,878705
9908,2021-03-01,MG,33,18598,4400,883105
9936,2021-03-02,MG,47,18645,3975,887080
9964,2021-03-03,MG,227,18872,6565,893645
9992,2021-03-04,MG,160,19032,7890,901535
10020,2021-03-05,MG,172,19204,7334,908869
10048,2021-03-06,MG,155,19359,7336,916205
10076,2021-03-07,MG,164,19523,6368,922573
10104,2021-03-08,MG,25,19548,1999,924572
10132,2021-03-09,MG,57,19605,3830,928402
10160,2021-03-10,MG,219,19824,10409,938811
10188,2021-03-11,MG,263,20087,7745,946556
10216,2021-03-12,MG,213,20300,9912,956468
10244,2021-03-13,MG,206,20506,7421,963889
10272,2021-03-14,MG,144,20650,7490,971379
10300,2021-03-15,MG,37,20687,3215,974594
10328,2021-03-16,MG,28,20715,6093,980687
10356,2021-03-17,MG,314,21029,11045,991732
10384,2021-03-18,MG,274,21303,11372,1003104
10412,2021-03-19,MG,237,21540,10975,1014079
10440,2021-03-20,MG,224,21764,9890,1023969
10468,2021-03-21,MG,243,22007,9593,1033562
10496,2021-03-22,MG,48,22055,2739,1036301
10524,2021-03-23,MG,68,22123,3897,1040198
10552,2021-03-24,MG,374,22497,13796,1053994
10580,2021-03-25,MG,74,22571,13925,1067919
10608,2021-03-26,MG,316,22887,14062,1081981
10636,2021-03-27,MG,479,23366,11558,1093539
10664,2021-03-28,MG,321,23687,7036,1100575
10692,2021-03-29,MG,101,23788,3112,1103687
10720,2021-03-30,MG,127,23915,8206,1111893
10748,2021-03-31,MG,417,24332,12020,1123913
10776,2021-04-01,MG,396,24728,11943,1135856
10804,2021-04-02,MG,486,25214,11722,1147578
10832,2021-04-03,MG,320,25534,5948,1153526
10860,2021-04-04,MG,120,25654,2909,1156435
10888,2021-04-05,MG,59,25713,2604,1159039
10916,2021-04-06,MG,82,25795,10450,1169489
10944,2021-04-07,MG,508,26303,13358,1182847
10972,2021-04-08,MG,492,26795,9203,1192050
11000,2021-04-09,MG,455,27250,16479,1208529
11028,2021-04-10,MG,368,27618,12109,1220638
11056,2021-04-11,MG,386,28004,5180,1225818
11084,2021-04-12,MG,86,28090,2841,1228659
11112,2021-04-13,MG,62,28152,7313,1235972
11140,2021-04-14,MG,484,28636,11286,1247258
11168,2021-04-15,MG,469,29105,9806,1257064
11196,2021-04-16,MG,433,29538,9207,1266271
11224,2021-04-17,MG,402,29940,8963,1275234
11252,2021-04-18,MG,369,30309,4315,1279549
11280,2021-04-19,MG,88,30397,1872,1281421
11308,2021-04-20,MG,129,30526,4850,1286271
11336,2021-04-21,MG,468,30994,11905,1298176
11364,2021-04-22,MG,392,31386,4452,1302628
11392,2021-04-23,MG,108,31494,5309,1307937
11420,2021-04-24,MG,493,31987,11360,1319297
11448,2021-04-25,MG,331,32318,3856,1323153
11476,2021-04-26,MG,96,32414,1869,1325022
11504,2021-04-27,MG,83,32497,4996,1330018
11532,2021-04-28,MG,488,32985,12874,1342892
11560,2021-04-29,MG,416,33401,8847,1351739
11588,2021-04-30,MG,298,33699,7398,1359137
11616,2021-05-01,MG,337,34036,7465,1366602
11644,2021-05-02,MG,253,34289,3600,1370202
11672,2021-05-03,MG,24,34313,1616,1371818
11700,2021-05-04,MG,83,34396,6727,1378545
11728,2021-05-05,MG,441,34837,9264,1387809
11756,2021-05-06,MG,328,35165,8725,1396534
11784,2021-05-07,MG,259,35424,7685,1404219
11812,2021-05-08,MG,326,35750,6895,1411114
11840,2021-05-09,MG,261,36011,4500,1415614
11868,2021-05-10,MG,51,36062,1231,1416845
11896,2021-05-11,MG,60,36122,6872,1423717
11924,2021-05-12,MG,373,36495,9764,1433481
11952,2021-05-13,MG,258,36753,8951,1442432
11980,2021-05-14,MG,252,37005,9404,1451836
12008,2021-05-15,MG,278,37283,7566,1459402
12036,2021-05-16,MG,225,37508,4141,1463543
12064,2021-05-17,MG,49,37557,2125,1465668
12092,2021-05-18,MG,60,37617,7133,1472801
12120,2021-05-19,MG,310,37927,10399,1483200
12148,2021-05-20,MG,295,38222,9330,1492530
12176,2021-05-21,MG,327,38549,9140,1501670
12204,2021-05-22,MG,329,38878,10086,1511756
12232,2021-05-23,MG,208,39086,4526,1516282
12260,2021-05-24,MG,42,39128,2443,1518725
12288,2021-05-25,MG,48,39176,6347,1525072
12316,2021-05-26,MG,364,39540,11040,1536112
12344,2021-05-27,MG,244,39784,9590,1545702
12372,2021-05-28,MG,242,40026,9582,1555284
12400,2021-05-29,MG,236,40262,8916,1564200
12428,2021-05-30,MG,190,40452,5574,1569774
12456,2021-05-31,MG,45,40497,2230,1572004
12484,2021-06-01,MG,59,40556,7283,1579287
12512,2021-06-02,MG,324,40880,15133,1594420
12540,2021-06-03,MG,290,41170,10605,1605025
12568,2021-06-04,MG,248,41418,5958,1610983
12596,2021-06-05,MG,61,41479,5893,1616876
12624,2021-06-06,MG,131,41610,5019,1621895
12652,2021-06-07,MG,63,41673,2049,1623944
12680,2021-06-08,MG,47,41720,9444,1633388
12708,2021-06-09,MG,280,42000,12716,1646104
12736,2021-06-10,MG,319,42319,11043,1657147
12764,2021-06-11,MG,270,42589,10758,1667905
12792,2021-06-12,MG,283,42872,10653,1678558
12820,2021-06-13,MG,252,43124,4542,1683100
12848,2021-06-14,MG,30,43154,1862,1684962
12876,2021-06-15,MG,52,43206,9719,1694681
12904,2021-06-16,MG,353,43559,10452,1705133
12932,2021-06-17,MG,255,43814,8924,1714057
12960,2021-06-18,MG,254,44068,10449,1724506
12988,2021-06-19,MG,279,44347,8675,1733181
13016,2021-06-20,MG,189,44536,5161,1738342
13044,2021-06-21,MG,47,44583,1587,1739929
13072,2021-06-22,MG,40,44623,7379,1747308
13100,2021-06-23,MG,413,45036,10341,1757649
13128,2021-06-24,MG,209,45245,8435,1766084
13156,2021-06-25,MG,253,45498,8043,1774127
13184,2021-06-26,MG,220,45718,8523,1782650
13212,2021-06-27,MG,170,45888,4004,1786654
13240,2021-06-28,MG,36,45924,2071,1788725
13268,2021-06-29,MG,37,45961,6337,1795062
13296,2021-06-30,MG,281,46242,8686,1803748
13324,2021-07-01,MG,217,46459,7106,1810854
13352,2021-07-02,MG,195,46654,7579,1818433
13380,2021-07-03,MG,229,46883,5386,1823819
13408,2021-07-04,MG,196,47079,3289,1827108
13436,2021-07-05,MG,41,47120,1796,1828904
13464,2021-07-06,MG,28,47148,7294,1836198
13492,2021-07-07,MG,230,47378,7367,1843565
13520,2021-07-08,MG,218,47596,6428,1849993
13548,2021-07-09,MG,160,47756,5631,1855624
13576,2021-07-10,MG,186,47942,6801,1862425
13604,2021-07-11,MG,160,48102,3019,1865444
13632,2021-07-12,MG,22,48124,1097,1866541
13660,2021-07-13,MG,27,48151,6208,1872749
13688,2021-07-14,MG,199,48350,7770,1880519
13716,2021-07-15,MG,163,48513,7883,1888402
13744,2021-07-16,MG,168,48681,5866,1894268
13772,2021-07-17,MG,191,48872,6152,1900420
13800,2021-07-18,MG,103,48975,2707,1903127
13828,2021-07-19,MG,13,48988,1068,1904195
13856,2021-07-20,MG,37,49025,5148,1909343
13884,2021-07-21,MG,208,49233,5751,1915094
13912,2021-07-22,MG,144,49377,6136,1921230
13940,2021-07-23,MG,123,49500,7161,1928391
13968,2021-07-24,MG,175,49675,4911,1933302
13996,2021-07-25,MG,157,49832,2989,1936291
14024,2021-07-26,MG,37,49869,1199,1937490
14052,2021-07-27,MG,32,49901,5192,1942682
14080,2021-07-28,MG,158,50059,6071,1948753
14108,2021-07-29,MG,166,50225,5668,1954421
14136,2021-07-30,MG,121,50346,5794,1960215
14164,2021-07-31,MG,115,50461,6309,1966524
14192,2021-08-01,MG,150,50611,6762,1973286
14220,2021-08-02,MG,17,50628,2261,1975547
14248,2021-08-03,MG,11,50639,168,1975715
14276,2021-08-04,MG,162,50801,5292,1981007
14304,2021-08-05,MG,137,50938,4921,1985928
14332,2021-08-06,MG,150,51088,5270,1991198
14360,2021-08-07,MG,128,51216,4488,1995686
14388,2021-08-08,MG,101,51317,2189,1997875
14416,2021-08-09,MG,26,51343,1003,1998878
14444,2021-08-10,MG,19,51362,4133,2003011
14472,2021-08-11,MG,140,51502,4654,2007665
14500,2021-08-12,MG,112,51614,4525,2012190
14528,2021-08-13,MG,130,51744,3517,2015707
14556,2021-08-14,MG,105,51849,3728,2019435
14584,2021-08-15,MG,110,51959,2128,2021563
14612,2021-08-16,MG,11,51970,1113,2022676
14640,2021-08-17,MG,32,52002,3315,2025991
14668,2021-08-18,MG,130,52132,4250,2030241
14696,2021-08-19,MG,116,52248,4237,2034478
14724,2021-08-20,MG,78,52326,3829,2038307
14752,2021-08-21,MG,85,52411,3288,2041595
14780,2021-08-22,MG,80,52491,1917,2043512
14808,2021-08-23,MG,17,52508,845,2044357
14836,2021-08-24,MG,13,52521,2895,2047252
14864,2021-08-25,MG,105,52626,3925,2051177
14892,2021-08-26,MG,87,52713,4672,2055849
14920,2021-08-27,MG,71,52784,2143,2057992
14948,2021-08-28,MG,101,52885,3248,2061240
14976,2021-08-29,MG,73,52958,1992,2063232
15004,2021-08-30,MG,9,52967,597,2063829
15032,2021-08-31,MG,19,52986,2509,2066338
15060,2021-09-01,MG,96,53082,2892,2069230
15088,2021-09-02,MG,85,53167,3991,2073221
15116,2021-09-03,MG,77,53244,1467,2074688
15144,2021-09-04,MG,79,53323,2582,2077270
15172,2021-09-05,MG,0,53323,3326,2080596
15200,2021-09-06,MG,0,53323,590,2081186
15228,2021-09-07,MG,63,53386,0,2081186
15256,2021-09-08,MG,21,53407,4963,2086149
15284,2021-09-09,MG,17,53424,2519,2088668
15312,2021-09-10,MG,101,53525,3111,2091779
15340,2021-09-11,MG,86,53611,3121,2094900
15368,2021-09-12,MG,70,53681,1395,2096295
15396,2021-09-13,MG,17,53698,800,2097095
15424,2021-09-14,MG,34,53732,1629,2098724
15452,2021-09-15,MG,113,53845,5074,2103798
15480,2021-09-16,MG,54,53899,2559,2106357
15508,2021-09-17,MG,72,53971,2005,2108362
15536,2021-09-18,MG,52,54023,2406,2110768
15564,2021-09-19,MG,57,54080,1275,2112043
15592,2021-09-20,MG,5,54085,715,2112758
15620,2021-09-21,MG,10,54095,1534,2114292
15648,2021-09-22,MG,67,54162,2411,2116703
15676,2021-09-23,MG,50,54212,9574,2126277
15704,2021-09-24,MG,53,54265,2304,2128581
15732,2021-09-25,MG,72,54337,2736,2131317
15760,2021-09-26,MG,35,54372,1431,2132748
15788,2021-09-27,MG,1,54373,443,2133191
15816,2021-09-28,MG,52,54425,1548,2134739
15844,2021-09-29,MG,41,54466,3225,2137964
15872,2021-09-30,MG,81,54547,2414,2140378
15900,2021-10-01,MG,66,54613,2856,2143234
15928,2021-10-02,MG,51,54664,2539,2145773
15956,2021-10-03,MG,55,54719,1315,2147088
15984,2021-10-04,MG,3,54722,1668,2148756
16012,2021-10-05,MG,75,54797,1256,2150012
16040,2021-10-06,MG,43,54840,2841,2152853
16068,2021-10-07,MG,33,54873,1101,2153954
16096,2021-10-08,MG,71,54944,1823,2155777
16124,2021-10-09,MG,40,54984,2128,2157905
16152,2021-10-10,MG,12,54996,866,2158771
16180,2021-10-11,MG,10,55006,941,2159712
16208,2021-10-12,MG,6,55012,707,2160419
16236,2021-10-13,MG,24,55036,332,2160751
16264,2021-10-14,MG,28,55064,1860,2162611
16292,2021-10-15,MG,42,55106,2170,2164781
16320,2021-10-16,MG,74,55180,1327,2166108
16348,2021-10-17,MG,29,55209,1379,2167487
16376,2021-10-18,MG,9,55218,166,2167653
16404,2021-10-19,MG,11,55229,2713,2170366
16432,2021-10-20,MG,52,55281,1833,2172199
16460,2021-10-21,MG,66,55347,1915,2174114
16488,2021-10-22,MG,20,55367,1728,2175842
16516,2021-10-23,MG,16,55383,1298,2177140
16544,2021-10-24,MG,18,55401,796,2177936
16572,2021-10-25,MG,0,55401,222,2178158
16600,2021-10-26,MG,1,55402,1451,2179609
16628,2021-10-27,MG,99,55501,1527,2181136
16656,2021-10-28,MG,24,55525,1506,2182642
16684,2021-10-29,MG,17,55542,885,2183527
16712,2021-10-30,MG,10,55552,1341,2184868
16740,2021-10-31,MG,30,55582,399,2185267
16768,2021-11-01,MG,6,55588,269,2185536
16796,2021-11-02,MG,4,55592,417,2185953
16824,2021-11-03,MG,21,55613,368,2186321
16852,2021-11-04,MG,57,55670,1542,2187863
16880,2021-11-05,MG,58,55728,1842,2189705
16908,2021-11-06,MG,18,55746,1306,2191011
16936,2021-11-07,MG,13,55759,583,2191594
16964,2021-11-08,MG,0,55759,264,2191858
16992,2021-11-09,MG,21,55780,1052,2192910
17020,2021-11-10,MG,40,55820,966,2193876
17048,2021-11-11,MG,29,55849,930,2194806
17076,2021-11-12,MG,36,55885,1248,2196054
17104,2021-11-13,MG,32,55917,1274,2197328
17132,2021-11-14,MG,23,55940,545,2197873
17160,2021-11-15,MG,1,55941,116,2197989
17188,2021-11-16,MG,1,55942,196,2198185
17216,2021-11-17,MG,10,55952,733,2198918
17244,2021-11-18,MG,45,55997,766,2199684
17272,2021-11-19,MG,15,56012,1557,2201241
17300,2021-11-20,MG,11,56023,807,2202048
17328,2021-11-21,MG,19,56042,298,2202346
17356,2021-11-22,MG,1,56043,105,2202451
17384,2021-11-23,MG,5,56048,749,2203200
17412,2021-11-24,MG,36,56084,516,2203716
17440,2021-11-25,MG,20,56104,1038,2204754
17468,2021-11-26,MG,25,56129,857,2205611
17496,2021-11-27,MG,14,56143,1253,2206864
17524,2021-11-28,MG,20,56163,328,2207192
17552,2021-11-29,MG,1,56164,97,2207289
17580,2021-11-30,MG,34,56198,786,2208075
17608,2021-12-01,MG,36,56234,812,2208887
17636,2021-12-02,MG,32,56266,1041,2209928
17664,2021-12-03,MG,35,56301,659,2210587
17692,2021-12-04,MG,8,56309,851,2211438
17720,2021-12-05,MG,12,56321,164,2211602
17748,2021-12-06,MG,1,56322,114,2211716
17776,2021-12-07,MG,25,56347,678,2212394
17804,2021-12-08,MG,24,56371,641,2213035
17832,2021-12-09,MG,15,56386,485,2213520
17860,2021-12-10,MG,57,56443,836,2214356
17888,2021-12-11,MG,3,56446,571,2214927
17916,2021-12-12,MG,33,56479,149,2215076
17944,2021-12-13,MG,0,56479,116,2215192
17972,2021-12-14,MG,7,56486,171,2215363
18000,2021-12-15,MG,6,56492,459,2215822
18028,2021-12-16,MG,24,56516,401,2216223
18056,2021-12-17,MG,19,56535,393,2216616
18084,2021-12-18,MG,17,56552,176,2216792
18112,2021-12-19,MG,15,56567,94,2216886
18140,2021-12-20,MG,1,56568,99,2216985
18168,2021-12-21,MG,0,56568,423,2217408
18196,2021-12-22,MG,24,56592,400,2217808
18224,2021-12-23,MG,12,56604,456,2218264
18252,2021-12-24,MG,9,56613,431,2218695
18280,2021-12-25,MG,0,56613,0,2218695
18308,2021-12-26,MG,0,56613,0,2218695
18336,2021-12-27,MG,2,56615,398,2219093
18364,2021-12-28,MG,8,56623,1169,2220262
18392,2021-12-29,MG,6,56629,1041,2221303
18420,2021-12-30,MG,26,56655,1179,2222482
18448,2021-12-31,MG,4,56659,1503,2223985
18476,2022-01-01,MG,0,56659,568,2224553
18504,2022-01-02,MG,0,56659,0,2224553
18532,2022-01-03,MG,9,56668,1611,2226164
18560,2022-01-04,MG,15,56683,2410,2228574
18588,2022-01-05,MG,12,56695,4585,2233159
18616,2022-01-06,MG,17,56712,3400,2236559
18644,2022-01-07,MG,5,56717,10982,2247541
18672,2022-01-08,MG,11,56728,10182,2257723
18700,2022-01-09,MG,15,56743,6551,2264274
18728,2022-01-10,MG,0,56743,2182,2266456
18756,2022-01-11,MG,1,56744,10924,2277380
18784,2022-01-12,MG,11,56755,18153,2295533
18812,2022-01-13,MG,13,56768,15785,2311318
18840,2022-01-14,MG,23,56791,18910,2330228
18868,2022-01-15,MG,19,56810,19153,2349381
18896,2022-01-16,MG,19,56829,8527,2357908
18924,2022-01-17,MG,3,56832,4323,2362231
18952,2022-01-18,MG,1,56833,20810,2383041
18980,2022-01-19,MG,33,56866,27683,2410724
19008,2022-01-20,MG,29,56895,25939,2436663
19036,2022-01-21,MG,23,56918,26977,2463640
19064,2022-01-22,MG,23,56941,26136,2489776
19092,2022-01-23,MG,21,56962,15227,2505003
19120,2022-01-24,MG,3,56965,9046,2514049
19148,2022-01-25,MG,11,56976,24404,2538453
19176,2022-01-26,MG,62,57038,36383,2574836
19204,2022-01-27,MG,55,57093,34420,2609256
19232,2022-01-28,MG,44,57137,40753,2650009
19260,2022-01-29,MG,77,57214,30125,2680134
19288,2022-01-30,MG,92,57306,25600,2705734
19316,2022-01-31,MG,8,57314,7847,2713581
19344,2022-02-01,MG,17,57331,24334,2737915
19372,2022-02-02,MG,109,57440,39271,2777186
19400,2022-02-03,MG,135,57575,28585,2805771
19428,2022-02-04,MG,80,57655,27421,2833192
19456,2022-02-05,MG,99,57754,28981,2862173
19484,2022-02-06,MG,114,57868,14345,2876518
19512,2022-02-07,MG,26,57894,4073,2880591
19540,2022-02-08,MG,56,57950,26405,2906996
19568,2022-02-09,MG,125,58075,26705,2933701
19596,2022-02-10,MG,128,58203,26306,2960007
19624,2022-02-11,MG,143,58346,22464,2982471
19652,2022-02-12,MG,65,58411,22467,3004938
19680,2022-02-13,MG,48,58459,10282,3015220
19708,2022-02-14,MG,46,58505,-507,3014713
19736,2022-02-15,MG,14,58519,11887,3026600
19764,2022-02-16,MG,81,58600,24823,3051423
19792,2022-02-17,MG,144,58744,15008,3066431
19820,2022-02-18,MG,129,58873,14445,3080876
19848,2022-02-19,MG,122,58995,20135,3101011
19876,2022-02-20,MG,112,59107,5702,3106713
19904,2022-02-21,MG,9,59116,2257,3108970
19932,2022-02-22,MG,23,59139,11888,3120858
19960,2022-02-23,MG,168,59307,36596,3157454
19988,2022-02-24,MG,109,59416,12883,3170337
20016,2022-02-25,MG,123,59539,11610,3181947
20044,2022-02-26,MG,50,59589,12028,3193975
20072,2022-02-27,MG,54,59643,3829,3197804
20100,2022-02-28,MG,2,59645,1690,3199494
20128,2022-03-01,MG,2,59647,4112,3203606
20156,2022-03-02,MG,51,59698,166,3203772
20184,2022-03-03,MG,24,59722,10262,3214034
20212,2022-03-04,MG,67,59789,7735,3221769
20240,2022-03-05,MG,86,59875,8131,3229900
20268,2022-03-06,MG,109,59984,3747,3233647
20296,2022-03-07,MG,7,59991,1146,3234793
20324,2022-03-08,MG,8,59999,16196,3250989
20352,2022-03-09,MG,80,60079,-1252,3249737
20380,2022-03-10,MG,74,60153,5286,3255023
20408,2022-03-11,MG,107,60260,5019,3260042
20436,2022-03-12,MG,59,60319,4678,3264720
20464,2022-03-13,MG,29,60348,1044,3265764
20492,2022-03-14,MG,6,60354,507,3266271
20520,2022-03-15,MG,16,60370,4331,3270602
20548,2022-03-16,MG,21,60391,5632,3276234
20576,2022-03-17,MG,58,60449,5223,3281457
20604,2022-03-18,MG,51,60500,8886,3290343
20632,2022-03-19,MG,38,60538,5376,3295719
20660,2022-03-20,MG,22,60560,1158,3296877
20688,2022-03-21,MG,4,60564,310,3297187
20716,2022-03-22,MG,37,60601,4456,3301643
20744,2022-03-23,MG,37,60638,5110,3306753
20772,2022-03-24,MG,49,60687,3922,3310675
20800,2022-03-25,MG,30,60717,3169,3313844
20828,2022-03-26,MG,24,60741,3215,3317059
20856,2022-03-27,MG,26,60767,342,3317401
20884,2022-03-28,MG,2,60769,116,3317517
20912,2022-03-29,MG,1,60770,3043,3320560
20940,2022-03-30,MG,33,60803,2896,3323456
20968,2022-03-31,MG,47,60850,2904,3326360
20996,2022-04-01,MG,29,60879,3091,3329451
21024,2022-04-02,MG,0,60879,0,3329451
21052,2022-04-03,MG,0,60879,0,3329451
21080,2022-04-04,MG,56,60935,4372,3333823
21108,2022-04-05,MG,13,60948,2975,3336798
21136,2022-04-06,MG,39,60987,2748,3339546
21164,2022-04-07,MG,8,60995,510,3340056
21192,2022-04-08,MG,21,61016,2993,3343049
21220,2022-04-09,MG,18,61034,1891,3344940
21248,2022-04-10,MG,12,61046,191,3345131
21276,2022-04-11,MG,0,61046,33,3345164
21304,2022-04-12,MG,0,61046,562,3345726
21332,2022-04-13,MG,31,61077,1066,3346792
21360,2022-04-14,MG,16,61093,2262,3349054
21388,2022-04-15,MG,15,61108,360,3349414
21416,2022-04-16,MG,5,61113,126,3349540
21444,2022-04-17,MG,0,61113,107,3349647
21472,2022-04-18,MG,1,61114,35,3349682
21500,2022-04-19,MG,11,61125,388,3350070
21528,2022-04-20,MG,79,61204,1217,3351287
21556,2022-04-21,MG,3,61207,1105,3352392
21584,2022-04-22,MG,9,61216,152,3352544
21612,2022-04-23,MG,0,61216,138,3352682
21640,2022-04-24,MG,10,61226,36,3352718
21668,2022-04-25,MG,1,61227,18,3352736
21696,2022-04-26,MG,4,61231,1175,3353911
21724,2022-04-27,MG,12,61243,758,3354669
21752,2022-04-28,MG,26,61269,998,3355667
21780,2022-04-29,MG,16,61285,776,3356443
21808,2022-04-30,MG,11,61296,882,3357325
21836,2022-05-01,MG,0,61296,309,3357634
21864,2022-05-02,MG,22,61318,210,3357844
21892,2022-05-03,MG,0,61318,825,3358669
21920,2022-05-04,MG,0,61318,761,3359430
21948,2022-05-05,MG,35,61353,570,3360000
21976,2022-05-06,MG,24,61377,1406,3361406
22004,2022-05-07,MG,0,61377,0,3361406
22032,2022-05-08,MG,0,61377,0,3361406
22060,2022-05-09,MG,7,61384,2217,3363623
22088,2022-05-10,MG,7,61391,953,3364576
22116,2022-05-11,MG,11,61402,2113,3366689
22144,2022-05-12,MG,3,61405,1515,3368204
22172,2022-05-13,MG,5,61410,2714,3370918
22200,2022-05-14,MG,0,61410,0,3370918
22228,2022-05-15,MG,0,61410,0,3370918
22256,2022-05-16,MG,27,61437,3992,3374910
22284,2022-05-17,MG,7,61444,2214,3377124
22312,2022-05-18,MG,11,61455,2038,3379162
22340,2022-05-19,MG,3,61458,2389,3381551
22368,2022-05-20,MG,0,61458,2323,3383874
22396,2022-05-21,MG,0,61458,0,3383874
22424,2022-05-22,MG,0,61458,0,3383874
22452,2022-05-23,MG,11,61469,3830,3387704
22480,2022-05-24,MG,9,61478,2411,3390115
22508,2022-05-25,MG,42,61520,4072,3394187
22536,2022-05-26,MG,13,61533,4383,3398570
22564,2022-05-27,MG,11,61544,4580,3403150
22592,2022-05-28,MG,0,61544,0,3403150
22620,2022-05-29,MG,0,61544,0,3403150
22648,2022-05-30,MG,5,61549,7460,3410610
22676,2022-05-31,MG,17,61566,5081,3415691
22704,2022-06-01,MG,13,61579,6809,3422500
22732,2022-06-02,MG,0,61579,6115,3428615
22760,2022-06-03,MG,0,61579,6886,3435501
22788,2022-06-04,MG,0,61579,0,3435501
22816,2022-06-05,MG,0,61579,0,3435501
22844,2022-06-06,MG,0,61579,10977,3446478
22872,2022-06-07,MG,0,61579,6577,3453055
22900,2022-06-08,MG,113,61692,9063,3462118
22928,2022-06-09,MG,7,61699,8440,3470558
22956,2022-06-10,MG,20,61719,8017,3478575
22984,2022-06-11,MG,0,61719,0,3478575
23012,2022-06-12,MG,0,61719,0,3478575
23040,2022-06-13,MG,18,61737,13099,3491674
23068,2022-06-14,MG,23,61760,6214,3497888
23096,2022-06-15,MG,83,61843,9800,3507688
23124,2022-06-16,MG,0,61843,0,3507688
23152,2022-06-17,MG,0,61843,0,3507688
23180,2022-06-18,MG,0,61843,0,3507688
23208,2022-06-19,MG,0,61843,0,3507688
23236,2022-06-20,MG,31,61874,17013,3524701
23264,2022-06-21,MG,42,61916,7990,3532691
23292,2022-06-22,MG,0,61916,15497,3548188
23320,2022-06-23,MG,0,61916,10102,3558290
23348,2022-06-24,MG,99,62015,14029,3572319
23376,2022-06-25,MG,0,62015,0,3572319
23404,2022-06-26,MG,0,62015,0,3572319
23432,2022-06-27,MG,49,62064,17112,3589431
23460,2022-06-28,MG,0,62064,9209,3598640
23488,2022-06-29,MG,46,62110,11611,3610251
23516,2022-06-30,MG,39,62149,10991,3621242
23544,2022-07-01,MG,21,62170,12222,3633464
23572,2022-07-02,MG,0,62170,0,3633464
23600,2022-07-03,MG,0,62170,0,3633464
23628,2022-07-04,MG,27,62197,17160,3650624
23656,2022-07-05,MG,38,62235,9851,3660475
23684,2022-07-06,MG,52,62287,10632,3671107
23712,2022-07-07,MG,37,62324,13663,3684770
23740,2022-07-08,MG,23,62347,6644,3691414
23768,2022-07-09,MG,0,62347,0,3691414
23796,2022-07-10,MG,0,62347,0,3691414
23824,2022-07-11,MG,33,62380,16620,3708034
23852,2022-07-12,MG,35,62415,7872,3715906
23880,2022-07-13,MG,49,62464,9155,3725061
23908,2022-07-14,MG,41,62505,8790,3733851
23936,2022-07-15,MG,36,62541,9342,3743193
23964,2022-07-16,MG,0,62541,0,3743193
23992,2022-07-17,MG,0,62541,0,3743193
24020,2022-07-18,MG,26,62567,13821,3757014
24048,2022-07-19,MG,39,62606,7242,3764256
24076,2022-07-20,MG,46,62652,8052,3772308
24104,2022-07-21,MG,35,62687,8133,3780441
24132,2022-07-22,MG,34,62721,5508,3785949
24160,2022-07-23,MG,0,62721,0,3785949
24188,2022-07-24,MG,0,62721,0,3785949
24216,2022-07-25,MG,34,62755,13049,3798998
24244,2022-07-26,MG,38,62793,2837,3801835
24272,2022-07-27,MG,45,62838,3869,3805704
24300,2022-07-28,MG,28,62866,3692,3809396
24328,2022-07-29,MG,36,62902,4731,3814127
24356,2022-07-30,MG,0,62902,0,3814127
24384,2022-07-31,MG,0,62902,0,3814127
24412,2022-08-01,MG,56,62958,6708,3820835
24440,2022-08-02,MG,37,62995,2362,3823197
24468,2022-08-03,MG,42,63037,3602,3826799
24496,2022-08-04,MG,50,63087,3742,3830541
24524,2022-08-05,MG,17,63104,3347,3833888
24552,2022-08-06,MG,0,63104,0,3833888
24580,2022-08-07,MG,0,63104,0,3833888
24608,2022-08-08,MG,33,63137,6078,3839966
24636,2022-08-09,MG,30,63167,2095,3842061
24664,2022-08-10,MG,26,63193,4281,3846342
24692,2022-08-11,MG,46,63239,6317,3852659
24720,2022-08-12,MG,18,63257,1990,3854649
24748,2022-08-13,MG,0,63257,0,3854649
24776,2022-08-14,MG,0,63257,0,3854649
24804,2022-08-15,MG,0,63257,0,3854649
24832,2022-08-16,MG,24,63281,3859,3858508
24860,2022-08-17,MG,49,63330,469,3858977
24888,2022-08-18,MG,35,63365,2311,3861288
24916,2022-08-19,MG,24,63389,592,3861880
24944,2022-08-20,MG,0,63389,0,3861880
24972,2022-08-21,MG,0,63389,0,3861880
25000,2022-08-22,MG,0,63389,0,3861880
25028,2022-08-23,MG,46,63435,3964,3865844
25056,2022-08-24,MG,14,63449,351,3866195
25084,2022-08-25,MG,16,63465,1279,3867474
0,2020-02-25,SP,0,0,1,1
2,2020-02-26,SP,0,0,0,1
4,2020-02-27,SP,0,0,0,1
6,2020-02-28,SP,0,0,1,2
8,2020-02-29,SP,0,0,0,2
10,2020-03-01,SP,0,0,0,2
12,2020-03-02,SP,0,0,0,2
14,2020-03-03,SP,0,0,0,2
16,2020-03-04,SP,0,0,1,3
19,2020-03-05,SP,0,0,3,6
24,2020-03-06,SP,0,0,4,10
30,2020-03-07,SP,0,0,3,13
38,2020-03-08,SP,0,0,3,16
46,2020-03-09,SP,0,0,0,16
55,2020-03-10,SP,0,0,3,19
64,2020-03-11,SP,0,0,11,30
78,2020-03-12,SP,0,0,16,46
93,2020-03-13,SP,0,0,10,56
110,2020-03-14,SP,0,0,9,65
127,2020-03-15,SP,0,0,71,136
145,2020-03-16,SP,0,0,16,152
164,2020-03-17,SP,1,1,12,164
185,2020-03-18,SP,3,4,77,241
208,2020-03-19,SP,1,5,45,286
235,2020-03-20,SP,4,9,110,396
263,2020-03-21,SP,6,15,63,459
291,2020-03-22,SP,7,22,172,631
319,2020-03-23,SP,8,30,114,745
347,2020-03-24,SP,10,40,65,810
375,2020-03-25,SP,8,48,52,862
403,2020-03-26,SP,10,58,191,1053
431,2020-03-27,SP,10,68,170,1223
459,2020-03-28,SP,16,84,183,1406
487,2020-03-29,SP,14,98,45,1451
515,2020-03-30,SP,15,113,66,1517
543,2020-03-31,SP,23,136,822,2339
571,2020-04-01,SP,28,164,642,2981
599,2020-04-02,SP,24,188,525,3506
627,2020-04-03,SP,31,219,542,4048
655,2020-04-04,SP,41,260,418,4466
683,2020-04-05,SP,15,275,154,4620
711,2020-04-06,SP,29,304,246,4866
739,2020-04-07,SP,67,371,816,5682
767,2020-04-08,SP,57,428,1026,6708
795,2020-04-09,SP,68,496,772,7480
823,2020-04-10,SP,44,540,736,8216
851,2020-04-11,SP,20,560,203,8419
879,2020-04-12,SP,28,588,336,8755
907,2020-04-13,SP,20,608,140,8895
935,2020-04-14,SP,87,695,476,9371
963,2020-04-15,SP,83,778,1672,11043
991,2020-04-16,SP,75,853,525,11568
1019,2020-04-17,SP,75,928,1273,12841
1047,2020-04-18,SP,63,991,1053,13894
1075,2020-04-19,SP,24,1015,373,14267
1103,2020-04-20,SP,22,1037,313,14580
1131,2020-04-21,SP,56,1093,805,15385
1159,2020-04-22,SP,41,1134,529,15914
1187,2020-04-23,SP,211,1345,826,16740
1215,2020-04-24,SP,167,1512,1086,17826
1243,2020-04-25,SP,155,1667,2178,20004
1271,2020-04-26,SP,33,1700,711,20715
1299,2020-04-27,SP,125,1825,981,21696
1327,2020-04-28,SP,224,2049,2345,24041
1355,2020-04-29,SP,198,2247,2117,26158
1383,2020-04-30,SP,128,2375,2540,28698
1411,2020-05-01,SP,136,2511,1676,30374
1439,2020-05-02,SP,75,2586,800,31174
1467,2020-05-03,SP,41,2627,598,31772
1495,2020-05-04,SP,27,2654,415,32187
1523,2020-05-05,SP,197,2851,1866,34053
1551,2020-05-06,SP,194,3045,3800,37853
1579,2020-05-07,SP,161,3206,2075,39928
1607,2020-05-08,SP,210,3416,1902,41830
1635,2020-05-09,SP,192,3608,2581,44411
1663,2020-05-10,SP,101,3709,1033,45444
1691,2020-05-11,SP,34,3743,687,46131
1719,2020-05-12,SP,206,3949,1588,47719
1747,2020-05-13,SP,169,4118,3378,51097
1775,2020-05-14,SP,197,4315,3189,54286
1803,2020-05-15,SP,186,4501,4092,58378
1831,2020-05-16,SP,187,4688,2805,61183
1859,2020-05-17,SP,94,4782,1162,62345
1887,2020-05-18,SP,41,4823,721,63066
1915,2020-05-19,SP,324,5147,2929,65995
1943,2020-05-20,SP,216,5363,3864,69859
1971,2020-05-21,SP,195,5558,3880,73739
1999,2020-05-22,SP,215,5773,3132,76871
2027,2020-05-23,SP,272,6045,3687,80558
2055,2020-05-24,SP,118,6163,1603,82161
2083,2020-05-25,SP,57,6220,1464,83625
2111,2020-05-26,SP,203,6423,2392,86017
2139,2020-05-27,SP,289,6712,3466,89483
2167,2020-05-28,SP,268,6980,6382,95865
2195,2020-05-29,SP,295,7275,5691,101556
2223,2020-05-30,SP,257,7532,5586,107142
2251,2020-05-31,SP,83,7615,2556,109698
2279,2020-06-01,SP,52,7667,1598,111296
2307,2020-06-02,SP,327,7994,6999,118295
2335,2020-06-03,SP,282,8276,5188,123483
2363,2020-06-04,SP,285,8561,5717,129200
2391,2020-06-05,SP,281,8842,5365,134565
2419,2020-06-06,SP,216,9058,5984,140549
2447,2020-06-07,SP,87,9145,2524,143073
2475,2020-06-08,SP,43,9188,1520,144593
2503,2020-06-09,SP,334,9522,5545,150138
2531,2020-06-10,SP,340,9862,6178,156316
2559,2020-06-11,SP,283,10145,6204,162520
2587,2020-06-12,SP,223,10368,5380,167900
2615,2020-06-13,SP,213,10581,4975,172875
2643,2020-06-14,SP,113,10694,5327,178202
2671,2020-06-15,SP,73,10767,3258,181460
2699,2020-06-16,SP,365,11132,8825,190285
2727,2020-06-17,SP,389,11521,1232,191517
2755,2020-06-18,SP,325,11846,1111,192628
2783,2020-06-19,SP,386,12232,19030,211658
2811,2020-06-20,SP,262,12494,4135,215793
2839,2020-06-21,SP,94,12588,3392,219185
2867,2020-06-22,SP,46,12634,2788,221973
2895,2020-06-23,SP,434,13068,7502,229475
2923,2020-06-24,SP,284,13352,9347,238822
2951,2020-06-25,SP,407,13759,9765,248587
2979,2020-06-26,SP,207,13966,9921,258508
3007,2020-06-27,SP,297,14263,7073,265581
3035,2020-06-28,SP,75,14338,6156,271737
3063,2020-06-29,SP,60,14398,3408,275145
3091,2020-06-30,SP,365,14763,6235,281380
3119,2020-07-01,SP,267,15030,8555,289935
3147,2020-07-02,SP,321,15351,12244,302179
3175,2020-07-03,SP,343,15694,8523,310702
3203,2020-07-04,SP,302,15996,1828,312530
3231,2020-07-05,SP,82,16078,7649,320179
3259,2020-07-06,SP,56,16134,2891,323070
3287,2020-07-07,SP,341,16475,9638,332708
3315,2020-07-08,SP,313,16788,8657,341365
3343,2020-07-09,SP,330,17118,8350,349715
3371,2020-07-10,SP,324,17442,9395,359110
3399,2020-07-11,SP,260,17702,7780,366890
3427,2020-07-12,SP,146,17848,5107,371997
3455,2020-07-13,SP,59,17907,2610,374607
3483,2020-07-14,SP,417,18324,12000,386607
3511,2020-07-15,SP,316,18640,6569,393176
3539,2020-07-16,SP,398,19038,8872,402048
3567,2020-07-17,SP,339,19377,5367,407415
3595,2020-07-18,SP,270,19647,4612,412027
3623,2020-07-19,SP,85,19732,3022,415049
3651,2020-07-20,SP,56,19788,1385,416434
3679,2020-07-21,SP,383,20171,6235,422669
3707,2020-07-22,SP,361,20532,16777,439446
3735,2020-07-23,SP,362,20894,12561,452007
3763,2020-07-24,SP,312,21206,11211,463218
3791,2020-07-25,SP,311,21517,16263,479481
3819,2020-07-26,SP,89,21606,4501,483982
3847,2020-07-27,SP,70,21676,3672,487654
3875,2020-07-28,SP,383,22059,12647,500301
3903,2020-07-29,SP,330,22389,13896,514197
3931,2020-07-30,SP,321,22710,14809,529006
3959,2020-07-31,SP,287,22997,13298,542304
3987,2020-08-01,SP,239,23236,10014,552318
4015,2020-08-02,SP,81,23317,6367,558685
4043,2020-08-03,SP,48,23365,1533,560218
4071,2020-08-04,SP,337,23702,15371,575589
4099,2020-08-05,SP,407,24109,9676,585265
4127,2020-08-06,SP,339,24448,13405,598670
4155,2020-08-07,SP,287,24735,9709,608379
4183,2020-08-08,SP,281,25016,13352,621731
4211,2020-08-09,SP,98,25114,5395,627126
4239,2020-08-10,SP,37,25151,1289,628415
4267,2020-08-11,SP,420,25571,11147,639562
4295,2020-08-12,SP,298,25869,15619,655181
4323,2020-08-13,SP,455,26324,19274,674455
4351,2020-08-14,SP,289,26613,11667,686122
4379,2020-08-15,SP,167,26780,11408,697530
4407,2020-08-16,SP,72,26852,1963,699493
4435,2020-08-17,SP,47,26899,3172,702665
4463,2020-08-18,SP,416,27315,8865,711530
4491,2020-08-19,SP,276,27591,9847,721377
4519,2020-08-20,SP,314,27905,9451,730828
4547,2020-08-21,SP,250,28155,5132,735960
4575,2020-08-22,SP,237,28392,13284,749244
4603,2020-08-23,SP,75,28467,4885,754129
4631,2020-08-24,SP,38,28505,2351,756480
4659,2020-08-25,SP,407,28912,9190,765670
4687,2020-08-26,SP,282,29194,10465,776135
4715,2020-08-27,SP,221,29415,8318,784453
4743,2020-08-28,SP,279,29694,11756,796209
4771,2020-08-29,SP,250,29944,5213,801422
4799,2020-08-30,SP,34,29978,1982,803404
4827,2020-08-31,SP,36,30014,938,804342
4855,2020-09-01,SP,361,30375,10033,814375
4883,2020-09-02,SP,298,30673,11956,826331
4911,2020-09-03,SP,232,30905,11647,837978
4939,2020-09-04,SP,186,31091,7038,845016
4967,2020-09-05,SP,222,31313,8069,853085
4995,2020-09-06,SP,40,31353,2637,855722
5023,2020-09-07,SP,24,31377,1608,857330
5051,2020-09-08,SP,53,31430,1453,858783
5079,2020-09-09,SP,391,31821,7793,866576
5107,2020-09-10,SP,283,32104,8178,874754
5135,2020-09-11,SP,234,32338,8055,882809
5163,2020-09-12,SP,229,32567,7881,890690
5191,2020-09-13,SP,39,32606,1567,892257
5219,2020-09-14,SP,36,32642,1092,893349
5247,2020-09-15,SP,321,32963,7922,901271
5275,2020-09-16,SP,290,33253,8157,909428
5303,2020-09-17,SP,219,33472,7393,916821
5331,2020-09-18,SP,206,33678,7711,924532
5359,2020-09-19,SP,249,33927,7141,931673
5387,2020-09-20,SP,25,33952,3627,935300
5415,2020-09-21,SP,32,33984,2032,937332
5443,2020-09-22,SP,282,34266,8090,945422
5471,2020-09-23,SP,226,34492,6551,951973
5499,2020-09-24,SP,185,34677,6267,958240
5527,2020-09-25,SP,200,34877,6681,964921
5555,2020-09-26,SP,186,35063,5967,970888
5583,2020-09-27,SP,45,35108,1349,972237
5611,2020-09-28,SP,17,35125,905,973142
5639,2020-09-29,SP,266,35391,6377,979519
5667,2020-09-30,SP,231,35622,6109,985628
5695,2020-10-01,SP,182,35804,6097,991725
5723,2020-10-02,SP,152,35956,5608,997333
5751,2020-10-03,SP,180,36136,6096,1003429
5779,2020-10-04,SP,42,36178,473,1003902
5807,2020-10-05,SP,42,36220,677,1004579
5835,2020-10-06,SP,270,36490,6260,1010839
5863,2020-10-07,SP,179,36669,5916,1016755
5891,2020-10-08,SP,215,36884,5649,1022404
5919,2020-10-09,SP,184,37068,5786,1028190
5947,2020-10-10,SP,155,37223,6626,1034816
5975,2020-10-11,SP,33,37256,2844,1037660
6003,2020-10-12,SP,23,37279,684,1038344
6031,2020-10-13,SP,35,37314,685,1039029
6059,2020-10-14,SP,227,37541,6031,1045060
6087,2020-10-15,SP,149,37690,6553,1051613
6115,2020-10-16,SP,180,37870,5627,1057240
6143,2020-10-17,SP,122,37992,5394,1062634
6171,2020-10-18,SP,28,38020,968,1063602
6199,2020-10-19,SP,15,38035,437,1064039
6227,2020-10-20,SP,211,38246,4923,1068962
6255,2020-10-21,SP,125,38371,4299,1073261
6283,2020-10-22,SP,111,38482,3678,1076939
6311,2020-10-23,SP,126,38608,6702,1083641
6339,2020-10-24,SP,118,38726,5614,1089255
6367,2020-10-25,SP,21,38747,2725,1091980
6395,2020-10-26,SP,6,38753,863,1092843
6423,2020-10-27,SP,132,38885,5364,1098207
6451,2020-10-28,SP,122,39007,5375,1103582
6479,2020-10-29,SP,112,39119,5278,1108860
6507,2020-10-30,SP,136,39255,4928,1113788
6535,2020-10-31,SP,56,39311,2339,1116127
6563,2020-11-01,SP,20,39331,1020,1117147
6591,2020-11-02,SP,15,39346,648,1117795
6619,2020-11-03,SP,18,39364,749,1118544
6647,2020-11-04,SP,185,39549,4755,1123299
6675,2020-11-05,SP,168,39717,2637,1125936
6703,2020-11-06,SP,0,39717,0,1125936
6731,2020-11-07,SP,0,39717,0,1125936
6759,2020-11-08,SP,0,39717,0,1125936
6787,2020-11-09,SP,0,39717,0,1125936
6815,2020-11-10,SP,0,39717,21515,1147451
6843,2020-11-11,SP,190,39907,3421,1150872
6871,2020-11-12,SP,295,40202,5780,1156652
6899,2020-11-13,SP,0,40202,6130,1162782
6927,2020-11-14,SP,347,40549,4640,1167422
6955,2020-11-15,SP,15,40564,1218,1168640
6983,2020-11-16,SP,12,40576,737,1169377
7011,2020-11-17,SP,173,40749,8698,1178075
7039,2020-11-18,SP,178,40927,6421,1184496
7067,2020-11-19,SP,147,41074,6794,1191290
7095,2020-11-20,SP,105,41179,9058,1200348
7123,2020-11-21,SP,77,41256,5087,1205435
7151,2020-11-22,SP,11,41267,4153,1209588
7179,2020-11-23,SP,9,41276,1037,1210625
7207,2020-11-24,SP,179,41455,5219,1215844
7235,2020-11-25,SP,146,41601,8900,1224744
7263,2020-11-26,SP,172,41773,4523,1229267
7291,2020-11-27,SP,129,41902,4320,1233587
7319,2020-11-28,SP,146,42048,4507,1238094
7347,2020-11-29,SP,28,42076,2379,1240473
7375,2020-11-30,SP,19,42095,1180,1241653
7403,2020-12-01,SP,195,42290,8937,1250590
7431,2020-12-02,SP,166,42456,9114,1259704
7459,2020-12-03,SP,181,42637,8208,1267912
7487,2020-12-04,SP,151,42788,8237,1276149
7515,2020-12-05,SP,181,42969,8938,1285087
7543,2020-12-06,SP,46,43015,2675,1287762
7571,2020-12-07,SP,25,43040,1116,1288878
7599,2020-12-08,SP,242,43282,7923,1296801
7627,2020-12-09,SP,179,43461,9784,1306585
7655,2020-12-10,SP,200,43661,9786,1316371
7683,2020-12-11,SP,141,43802,8791,1325162
7711,2020-12-12,SP,169,43971,8601,1333763
7739,2020-12-13,SP,47,44018,940,1334703
7767,2020-12-14,SP,32,44050,2313,1337016
7795,2020-12-15,SP,232,44282,4412,1341428
7823,2020-12-16,SP,0,44282,0,1341428
7851,2020-12-17,SP,399,44681,20303,1361731
7879,2020-12-18,SP,197,44878,9922,1371653
7907,2020-12-19,SP,151,45029,12447,1384100
7935,2020-12-20,SP,0,45029,0,1384100
7963,2020-12-21,SP,107,45136,3943,1388043
7991,2020-12-22,SP,259,45395,10714,1398757
8019,2020-12-23,SP,181,45576,10383,1409140
8047,2020-12-24,SP,182,45758,9351,1418491
8075,2020-12-25,SP,37,45795,3596,1422087
8103,2020-12-26,SP,13,45808,1253,1423340
8131,2020-12-27,SP,55,45863,2836,1426176
8159,2020-12-28,SP,39,45902,1576,1427752
8187,2020-12-29,SP,293,46195,12477,1440229
8215,2020-12-30,SP,282,46477,11849,1452078
8243,2020-12-31,SP,240,46717,10219,1462297
8271,2021-01-01,SP,58,46775,3894,1466191
8299,2021-01-02,SP,33,46808,1762,1467953
8327,2021-01-03,SP,37,46845,3469,1471422
8355,2021-01-04,SP,43,46888,2248,1473670
8383,2021-01-05,SP,334,47222,12881,1486551
8411,2021-01-06,SP,289,47511,14534,1501085
8439,2021-01-07,SP,257,47768,14073,1515158
8467,2021-01-08,SP,261,48029,13794,1528952
8495,2021-01-09,SP,269,48298,11561,1540513
8523,2021-01-10,SP,53,48351,5619,1546132
8551,2021-01-11,SP,28,48379,3010,1549142
8579,2021-01-12,SP,283,48662,12702,1561844
8607,2021-01-13,SP,323,48985,15275,1577119
8635,2021-01-14,SP,304,49289,13710,1590829
8663,2021-01-15,SP,311,49600,15016,1605845
8691,2021-01-16,SP,285,49885,13774,1619619
8719,2021-01-17,SP,60,49945,5720,1625339
8747,2021-01-18,SP,42,49987,2933,1628272
8775,2021-01-19,SP,331,50318,15953,1644225
8803,2021-01-20,SP,334,50652,14411,1658636
8831,2021-01-21,SP,286,50938,12118,1670754
8859,2021-01-22,SP,254,51192,9005,1679759
8887,2021-01-23,SP,231,51423,14596,1694355
8915,2021-01-24,SP,79,51502,5072,1699427
8943,2021-01-25,SP,54,51556,2867,1702294
8971,2021-01-26,SP,282,51838,12959,1715253
8999,2021-01-27,SP,332,52170,16041,1731294
9027,2021-01-28,SP,311,52481,14776,1746070
9055,2021-01-29,SP,241,52722,13887,1759957
9083,2021-01-30,SP,232,52954,13067,1773024
9111,2021-01-31,SP,80,53034,4344,1777368
9139,2021-02-01,SP,56,53090,2354,1779722
9167,2021-02-02,SP,365,53455,14297,1794019
9195,2021-02-03,SP,249,53704,12990,1807009
9223,2021-02-04,SP,293,53997,13932,1820941
9251,2021-02-05,SP,327,54324,12222,1833163
9279,2021-02-06,SP,221,54545,11923,1845086
9307,2021-02-07,SP,69,54614,4248,1849334
9335,2021-02-08,SP,49,54663,2442,1851776
9363,2021-02-09,SP,424,55087,13201,1864977
9391,2021-02-10,SP,332,55419,13825,1878802
9419,2021-02-11,SP,323,55742,11167,1889969
9447,2021-02-12,SP,229,55971,11605,1901574
9475,2021-02-13,SP,220,56191,9837,1911411
9503,2021-02-14,SP,75,56266,2187,1913598
9531,2021-02-15,SP,38,56304,2316,1915914
9559,2021-02-16,SP,398,56702,11496,1927410
9587,2021-02-17,SP,258,56960,11302,1938712
9615,2021-02-18,SP,280,57240,10747,1949459
9643,2021-02-19,SP,259,57499,11105,1960564
9671,2021-02-20,SP,244,57743,10859,1971423
9699,2021-02-21,SP,56,57799,4504,1975927
9727,2021-02-22,SP,43,57842,2550,1978477
9755,2021-02-23,SP,357,58199,12077,1990554
9783,2021-02-24,SP,329,58528,12086,2002640
9811,2021-02-25,SP,345,58873,11889,2014529
9839,2021-02-26,SP,256,59129,11596,2026125
9867,2021-02-27,SP,299,59428,11142,2037267
9895,2021-02-28,SP,65,59493,4361,2041628
9923,2021-03-01,SP,53,59546,3071,2044699
9951,2021-03-02,SP,468,60014,10168,2054867
9979,2021-03-03,SP,367,60381,13749,2068616
10007,2021-03-04,SP,313,60694,12236,2080852
10035,2021-03-05,SP,370,61064,13072,2093924
10063,2021-03-06,SP,353,61417,13763,2107687
10091,2021-03-07,SP,46,61463,6051,2113738
10119,2021-03-08,SP,121,61584,4224,2117962
10147,2021-03-09,SP,517,62101,16058,2134020
10175,2021-03-10,SP,469,62570,15541,2149561
10203,2021-03-11,SP,440,63010,14505,2164066
10231,2021-03-12,SP,521,63531,15720,2179786
10259,2021-03-13,SP,434,63965,15344,2195130
10287,2021-03-14,SP,158,64123,7853,2202983
10315,2021-03-15,SP,100,64223,5259,2208242
10343,2021-03-16,SP,679,64902,17684,2225926
10371,2021-03-17,SP,617,65519,17942,2243868
10399,2021-03-18,SP,659,66178,17492,2261360
10427,2021-03-19,SP,620,66798,18673,2280033
10455,2021-03-20,SP,616,67414,18028,2298061
10483,2021-03-21,SP,144,67558,8265,2306326
10511,2021-03-22,SP,44,67602,4775,2311101
10539,2021-03-23,SP,1021,68623,20942,2332043
10567,2021-03-24,SP,281,68904,20395,2352438
10595,2021-03-25,SP,599,69503,18447,2370885
10623,2021-03-26,SP,1193,70696,21489,2392374
10651,2021-03-27,SP,1051,71747,18124,2410498
10679,2021-03-28,SP,244,71991,9602,2420100
10707,2021-03-29,SP,292,72283,5220,2425320
10735,2021-03-30,SP,1209,73492,21360,2446680
10763,2021-03-31,SP,1160,74652,23169,2469849
10791,2021-04-01,SP,1082,75734,26567,2496416
10819,2021-04-02,SP,818,76552,16762,2513178
10847,2021-04-03,SP,198,76750,7026,2520204
10875,2021-04-04,SP,270,77020,7196,2527400
10903,2021-04-05,SP,145,77165,4647,2532047
10931,2021-04-06,SP,1389,78554,22794,2554841
10959,2021-04-07,SP,889,79443,21521,2576362
10987,2021-04-08,SP,1299,80742,21004,2597366
11015,2021-04-09,SP,1008,81750,20701,2618067
11043,2021-04-10,SP,657,82407,17311,2635378
11071,2021-04-11,SP,510,82917,8156,2643534
11099,2021-04-12,SP,181,83098,5310,2648844
11127,2021-04-13,SP,1282,84380,18397,2667241
11155,2021-04-14,SP,1095,85475,18790,2686031
11183,2021-04-15,SP,1060,86535,18067,2704098
11211,2021-04-16,SP,791,87326,17979,2722077
11239,2021-04-17,SP,771,88097,17746,2739823
11267,2021-04-18,SP,253,88350,6394,2746217
11295,2021-04-19,SP,178,88528,4083,2750300
11323,2021-04-20,SP,1122,89650,19060,2769360
11351,2021-04-21,SP,977,90627,17123,2786483
11379,2021-04-22,SP,183,90810,7267,2793750
11407,2021-04-23,SP,863,91673,17812,2811562
11435,2021-04-24,SP,875,92548,16271,2827833
11463,2021-04-25,SP,145,92693,6488,2834321
11491,2021-04-26,SP,105,92798,3912,2838233
11519,2021-04-27,SP,1044,93842,17992,2856225
11547,2021-04-28,SP,814,94656,17013,2873238
11575,2021-04-29,SP,876,95532,14920,2888158
11603,2021-04-30,SP,659,96191,15551,2903709
11631,2021-05-01,SP,750,96941,14335,2918044
11659,2021-05-02,SP,117,97058,5323,2923367
11687,2021-05-03,SP,114,97172,3149,2926516
11715,2021-05-04,SP,849,98021,15464,2941980
11743,2021-05-05,SP,689,98710,14230,2956210
11771,2021-05-06,SP,696,99406,13470,2969680
11799,2021-05-07,SP,583,99989,14502,2984182
11827,2021-05-08,SP,660,100649,13100,2997282
11855,2021-05-09,SP,150,100799,5785,3003067
11883,2021-05-10,SP,55,100854,3183,3006250
11911,2021-05-11,SP,806,101660,16318,3022568
11939,2021-05-12,SP,696,102356,15672,3038240
11967,2021-05-13,SP,578,102934,15649,3053889
11995,2021-05-14,SP,559,103493,15915,3069804
12023,2021-05-15,SP,502,103995,15486,3085290
12051,2021-05-16,SP,224,104219,7554,3092844
12079,2021-05-17,SP,76,104295,4001,3096845
12107,2021-05-18,SP,810,105105,15779,3112624
12135,2021-05-19,SP,747,105852,16788,3129412
12163,2021-05-20,SP,585,106437,17936,3147348
12191,2021-05-21,SP,580,107017,16511,3163859
12219,2021-05-22,SP,480,107497,16736,3180595
12247,2021-05-23,SP,117,107614,7510,3188105
12275,2021-05-24,SP,63,107677,4622,3192727
12303,2021-05-25,SP,898,108575,17477,3210204
12331,2021-05-26,SP,666,109241,16671,3226875
12359,2021-05-27,SP,609,109850,12782,3239657
12387,2021-05-28,SP,703,110553,1583,3241240
12415,2021-05-29,SP,570,111123,13653,3254893
12443,2021-05-30,SP,181,111304,11037,3265930
12471,2021-05-31,SP,70,111374,6113,3272043
12499,2021-06-01,SP,836,112210,19466,3291509
12527,2021-06-02,SP,717,112927,23122,3314631
12555,2021-06-03,SP,514,113441,19733,3334364
12583,2021-06-04,SP,33,113474,3898,3338262
12611,2021-06-05,SP,718,114192,16939,3355201
12639,2021-06-06,SP,212,114404,9959,3365160
12667,2021-06-07,SP,138,114542,5074,3370234
12695,2021-06-08,SP,767,115309,8022,3378256
12723,2021-06-09,SP,651,115960,4192,3382448
12751,2021-06-10,SP,733,116693,23033,3405481
12779,2021-06-11,SP,651,117344,22875,3428356
12807,2021-06-12,SP,543,117887,21221,3449577
12835,2021-06-13,SP,234,118121,9272,3458849
12863,2021-06-14,SP,92,118213,5309,3464158
12891,2021-06-15,SP,897,119110,23227,3487385
12919,2021-06-16,SP,795,119905,22582,3509967
12947,2021-06-17,SP,619,120524,15054,3525021
12975,2021-06-18,SP,714,121238,27706,3552727
13003,2021-06-19,SP,722,121960,20483,3573210
13031,2021-06-20,SP,200,122160,9582,3582792
13059,2021-06-21,SP,98,122258,4854,3587646
13087,2021-06-22,SP,843,123101,23097,3610743
13115,2021-06-23,SP,724,123825,19508,3630251
13143,2021-06-24,SP,781,124606,17951,3648202
13171,2021-06-25,SP,772,125378,20994,3669196
13199,2021-06-26,SP,538,125916,18932,3688128
13227,2021-06-27,SP,134,126050,7965,3696093
13255,2021-06-28,SP,62,126112,4285,3700378
13283,2021-06-29,SP,825,126937,19208,3719586
13311,2021-06-30,SP,744,127681,7762,3727348
13339,2021-07-01,SP,641,128322,15943,3743291
13367,2021-07-02,SP,599,128921,19467,3762758
13395,2021-07-03,SP,532,129453,16650,3779408
13423,2021-07-04,SP,156,129609,6451,3785859
13451,2021-07-05,SP,66,129675,4231,3790090
13479,2021-07-06,SP,714,130389,19132,3809222
13507,2021-07-07,SP,546,130935,14889,3824111
13535,2021-07-08,SP,543,131478,14453,3838564
13563,2021-07-09,SP,482,131960,14712,3853276
13591,2021-07-10,SP,105,132065,7684,3860960
13619,2021-07-11,SP,75,132140,5218,3866178
13647,2021-07-12,SP,65,132205,3122,3869300
13675,2021-07-13,SP,640,132845,10546,3879846
13703,2021-07-14,SP,519,133364,16237,3896083
13731,2021-07-15,SP,537,133901,12196,3908279
13759,2021-07-16,SP,419,134320,11475,3919754
13787,2021-07-17,SP,448,134768,17095,3936849
13815,2021-07-18,SP,35,134803,2783,3939632
13843,2021-07-19,SP,97,134900,3144,3942776
13871,2021-07-20,SP,590,135490,4798,3947574
13899,2021-07-21,SP,483,135973,18435,3966009
13927,2021-07-22,SP,493,136466,13093,3979102
13955,2021-07-23,SP,418,136884,12086,3991188
13983,2021-07-24,SP,327,137211,5896,3997084
14011,2021-07-25,SP,25,137236,3994,4001078
14039,2021-07-26,SP,37,137273,2471,4003549
14067,2021-07-27,SP,467,137740,11877,4015426
14095,2021-07-28,SP,361,138101,11636,4027062
14123,2021-07-29,SP,335,138436,11313,4038375
14151,2021-07-30,SP,266,138702,10103,4048478
14179,2021-07-31,SP,294,138996,9390,4057868
14207,2021-08-01,SP,43,139039,3873,4061741
14235,2021-08-02,SP,20,139059,1939,4063680
14263,2021-08-03,SP,405,139464,9942,4073622
14291,2021-08-04,SP,406,139870,10490,4084112
14319,2021-08-05,SP,265,140135,10099,4094211
14347,2021-08-06,SP,293,140428,10557,4104768
14375,2021-08-07,SP,249,140677,8973,4113741
14403,2021-08-08,SP,78,140755,3726,4117467
14431,2021-08-09,SP,54,140809,1798,4119265
14459,2021-08-10,SP,468,141277,10455,4129720
14487,2021-08-11,SP,387,141664,8701,4138421
14515,2021-08-12,SP,294,141958,9244,4147665
14543,2021-08-13,SP,241,142199,8898,4156563
14571,2021-08-14,SP,329,142528,8024,4164587
14599,2021-08-15,SP,60,142588,3906,4168493
14627,2021-08-16,SP,21,142609,2048,4170541
14655,2021-08-17,SP,526,143135,8607,4179148
14683,2021-08-18,SP,336,143471,8317,4187465
14711,2021-08-19,SP,281,143752,8001,4195466
14739,2021-08-20,SP,261,144013,7111,4202577
14767,2021-08-21,SP,172,144185,6844,4209421
14795,2021-08-22,SP,31,144216,3190,4212611
14823,2021-08-23,SP,27,144243,1942,4214553
14851,2021-08-24,SP,267,144510,8349,4222902
14879,2021-08-25,SP,257,144767,6698,4229600
14907,2021-08-26,SP,245,145012,6836,4236436
14935,2021-08-27,SP,304,145316,7635,4244071
14963,2021-08-28,SP,183,145499,6403,4250474
14991,2021-08-29,SP,23,145522,3042,4253516
15019,2021-08-30,SP,36,145558,1808,4255324
15047,2021-08-31,SP,278,145836,7360,4262684
15075,2021-09-01,SP,179,146015,6454,4269138
15103,2021-09-02,SP,164,146179,6120,4275258
15131,2021-09-03,SP,169,146348,6714,4281972
15159,2021-09-04,SP,178,146526,6471,4288443
15187,2021-09-05,SP,23,146549,2016,4290459
15215,2021-09-06,SP,18,146567,1534,4291993
15243,2021-09-07,SP,28,146595,3156,4295149
15271,2021-09-08,SP,15,146610,2080,4297229
15299,2021-09-09,SP,218,146828,951,4298180
15327,2021-09-10,SP,192,147020,671,4298851
15355,2021-09-11,SP,178,147198,778,4299629
15383,2021-09-12,SP,38,147236,678,4300307
15411,2021-09-13,SP,22,147258,337,4300644
15439,2021-09-14,SP,186,147444,881,4301525
15467,2021-09-15,SP,197,147641,986,4302511
15495,2021-09-16,SP,170,147811,22678,4325189
15523,2021-09-17,SP,133,147944,23586,4348775
15551,2021-09-18,SP,135,148079,1448,4350223
15579,2021-09-19,SP,20,148099,307,4350530
15607,2021-09-20,SP,5,148104,471,4351001
15635,2021-09-21,SP,191,148295,1831,4352832
15663,2021-09-22,SP,200,148495,1826,4354658
15691,2021-09-23,SP,193,148688,1932,4356590
15719,2021-09-24,SP,215,148903,2198,4358788
15747,2021-09-25,SP,175,149078,1760,4360548
15775,2021-09-26,SP,31,149109,383,4360931
15803,2021-09-27,SP,18,149127,400,4361331
15831,2021-09-28,SP,253,149380,1791,4363122
15859,2021-09-29,SP,241,149621,1460,4364582
15887,2021-09-30,SP,189,149810,1550,4366132
15915,2021-10-01,SP,143,149953,1616,4367748
15943,2021-10-02,SP,97,150050,1313,4369061
15971,2021-10-03,SP,14,150064,477,4369538
15999,2021-10-04,SP,22,150086,205,4369743
16027,2021-10-05,SP,143,150229,3765,4373508
16055,2021-10-06,SP,172,150401,1679,4375187
16083,2021-10-07,SP,139,150540,1513,4376700
16111,2021-10-08,SP,90,150630,1439,4378139
16139,2021-10-09,SP,98,150728,4724,4382863
16167,2021-10-10,SP,28,150756,518,4383381
16195,2021-10-11,SP,33,150789,399,4383780
16223,2021-10-12,SP,37,150826,410,4384190
16251,2021-10-13,SP,9,150835,226,4384416
16279,2021-10-14,SP,103,150938,1930,4386346
16307,2021-10-15,SP,79,151017,1685,4388031
16335,2021-10-16,SP,90,151107,1448,4389479
16363,2021-10-17,SP,19,151126,369,4389848
16391,2021-10-18,SP,3,151129,158,4390006
16419,2021-10-19,SP,81,151210,1296,4391302
16447,2021-10-20,SP,87,151297,1748,4393050
16475,2021-10-21,SP,89,151386,1625,4394675
16503,2021-10-22,SP,85,151471,2229,4396904
16531,2021-10-23,SP,69,151540,1833,4398737
16559,2021-10-24,SP,4,151544,270,4399007
16587,2021-10-25,SP,1,151545,209,4399216
16615,2021-10-26,SP,78,151623,1716,4400932
16643,2021-10-27,SP,59,151682,1634,4402566
16671,2021-10-28,SP,116,151798,1290,4403856
16699,2021-10-29,SP,116,151914,987,4404843
16727,2021-10-30,SP,61,151975,684,4405527
16755,2021-10-31,SP,27,152002,550,4406077
16783,2021-11-01,SP,17,152019,175,4406252
16811,2021-11-02,SP,62,152081,738,4406990
16839,2021-11-03,SP,17,152098,766,4407756
16867,2021-11-04,SP,124,152222,1648,4409404
16895,2021-11-05,SP,115,152337,1471,4410875
16923,2021-11-06,SP,179,152516,1307,4412182
16951,2021-11-07,SP,11,152527,700,4412882
16979,2021-11-08,SP,0,152527,359,4413241
17007,2021-11-09,SP,2,152529,946,4414187
17035,2021-11-10,SP,9,152538,1558,4415745
17063,2021-11-11,SP,1,152539,1847,4417592
17091,2021-11-12,SP,414,152953,2671,4420263
17119,2021-11-13,SP,105,153058,1692,4421955
17147,2021-11-14,SP,1,153059,469,4422424
17175,2021-11-15,SP,7,153066,166,4422590
17203,2021-11-16,SP,1,153067,333,4422923
17231,2021-11-17,SP,147,153214,1970,4424893
17259,2021-11-18,SP,85,153299,1935,4426828
17287,2021-11-19,SP,62,153361,2208,4429036
17315,2021-11-20,SP,99,153460,1154,4430190
17343,2021-11-21,SP,12,153472,787,4430977
17371,2021-11-22,SP,5,153477,219,4431196
17399,2021-11-23,SP,94,153571,1524,4432720
17427,2021-11-24,SP,68,153639,1195,4433915
17455,2021-11-25,SP,116,153755,1210,4435125
17483,2021-11-26,SP,124,153879,1326,4436451
17511,2021-11-27,SP,114,153993,935,4437386
17539,2021-11-28,SP,9,154002,457,4437843
17567,2021-11-29,SP,4,154006,169,4438012
17595,2021-11-30,SP,71,154077,1093,4439105
17623,2021-12-01,SP,82,154159,1086,4440191
17651,2021-12-02,SP,54,154213,1387,4441578
17679,2021-12-03,SP,66,154279,1034,4442612
17707,2021-12-04,SP,69,154348,977,4443589
17735,2021-12-05,SP,14,154362,824,4444413
17763,2021-12-06,SP,7,154369,213,4444626
17791,2021-12-07,SP,111,154480,1316,4445942
17819,2021-12-08,SP,91,154571,1287,4447229
17847,2021-12-09,SP,67,154638,1237,4448466
17875,2021-12-10,SP,53,154691,1086,4449552
17903,2021-12-11,SP,0,154691,0,4449552
17931,2021-12-12,SP,0,154691,0,4449552
17959,2021-12-13,SP,0,154691,0,4449552
17987,2021-12-14,SP,0,154691,0,4449552
18015,2021-12-15,SP,157,154848,254,4449806
18043,2021-12-16,SP,0,154848,0,4449806
18071,2021-12-17,SP,102,154950,236,4450042
18099,2021-12-18,SP,51,155001,102,4450144
18127,2021-12-19,SP,6,155007,0,4450144
18155,2021-12-20,SP,1,155008,0,4450144
18183,2021-12-21,SP,0,155008,0,4450144
18211,2021-12-22,SP,40,155048,52,4450196
18239,2021-12-23,SP,20,155068,69,4450265
18267,2021-12-24,SP,27,155095,37,4450302
18295,2021-12-25,SP,1,155096,13,4450315
18323,2021-12-26,SP,0,155096,0,4450315
18351,2021-12-27,SP,0,155096,0,4450315
18379,2021-12-28,SP,31,155127,123,4450438
18407,2021-12-29,SP,0,155127,0,4450438
18435,2021-12-30,SP,59,155186,4573,4455011
18463,2021-12-31,SP,19,155205,1097,4456108
18491,2022-01-01,SP,8,155213,361,4456469
18519,2022-01-02,SP,3,155216,112,4456581
18547,2022-01-03,SP,0,155216,164,4456745
18575,2022-01-04,SP,26,155242,1944,4458689
18603,2022-01-05,SP,35,155277,2962,4461651
18631,2022-01-06,SP,34,155311,2831,4464482
18659,2022-01-07,SP,30,155341,2917,4467399
18687,2022-01-08,SP,29,155370,3714,4471113
18715,2022-01-09,SP,2,155372,2077,4473190
18743,2022-01-10,SP,12,155384,919,4474109
18771,2022-01-11,SP,36,155420,4359,4478468
18799,2022-01-12,SP,44,155464,4585,4483053
18827,2022-01-13,SP,53,155517,5876,4488929
18855,2022-01-14,SP,100,155617,8472,4497401
18883,2022-01-15,SP,90,155707,744,4498145
18911,2022-01-16,SP,22,155729,2371,4500516
18939,2022-01-17,SP,12,155741,1330,4501846
18967,2022-01-18,SP,117,155858,11409,4513255
18995,2022-01-19,SP,139,155997,10266,4523521
19023,2022-01-20,SP,168,156165,10545,4534066
19051,2022-01-21,SP,145,156310,11159,4545225
19079,2022-01-22,SP,124,156434,12617,4557842
19107,2022-01-23,SP,59,156493,5148,4562990
19135,2022-01-24,SP,58,156551,2709,4565699
19163,2022-01-25,SP,227,156778,13217,4578916
19191,2022-01-26,SP,172,156950,13184,4592100
19219,2022-01-27,SP,259,157209,17021,4609121
19247,2022-01-28,SP,285,157494,14896,4624017
19275,2022-01-29,SP,323,157817,14343,4638360
19303,2022-01-30,SP,37,157854,7746,4646106
19331,2022-01-31,SP,100,157954,2609,4648715
19359,2022-02-01,SP,206,158160,17130,4665845
19387,2022-02-02,SP,363,158523,1096,4666941
19415,2022-02-03,SP,349,158872,37611,4704552
19443,2022-02-04,SP,370,159242,18535,4723087
19471,2022-02-05,SP,294,159536,17066,4740153
19499,2022-02-06,SP,53,159589,5351,4745504
19527,2022-02-07,SP,26,159615,3585,4749089
19555,2022-02-08,SP,445,160060,15696,4764785
19583,2022-02-09,SP,482,160542,17464,4782249
19611,2022-02-10,SP,297,160839,19046,4801295
19639,2022-02-11,SP,317,161156,20598,4821893
19667,2022-02-12,SP,285,161441,15964,4837857
19695,2022-02-13,SP,48,161489,6813,4844670
19723,2022-02-14,SP,28,161517,4146,4848816
19751,2022-02-15,SP,251,161768,15677,4864493
19779,2022-02-16,SP,397,162165,17801,4882294
19807,2022-02-17,SP,352,162517,15995,4898289
19835,2022-02-18,SP,280,162797,14809,4913098
19863,2022-02-19,SP,337,163134,16249,4929347
19891,2022-02-20,SP,26,163160,6424,4935771
19919,2022-02-21,SP,23,163183,2470,4938241
19947,2022-02-22,SP,310,163493,15999,4954240
19975,2022-02-23,SP,298,163791,15427,4969667
20003,2022-02-24,SP,303,164094,15228,4984895
20031,2022-02-25,SP,211,164305,14764,4999659
20059,2022-02-26,SP,211,164516,11290,5010949
20087,2022-02-27,SP,7,164523,4865,5015814
20115,2022-02-28,SP,9,164532,1639,5017453
20143,2022-03-01,SP,81,164613,2959,5020412
20171,2022-03-02,SP,29,164642,2978,5023390
20199,2022-03-03,SP,193,164835,10193,5033583
20227,2022-03-04,SP,198,165033,11868,5045451
20255,2022-03-05,SP,242,165275,12143,5057594
20283,2022-03-06,SP,13,165288,3483,5061077
20311,2022-03-07,SP,7,165295,1184,5062261
20339,2022-03-08,SP,189,165484,12404,5074665
20367,2022-03-09,SP,183,165667,13105,5087770
20395,2022-03-10,SP,211,165878,12775,5100545
20423,2022-03-11,SP,103,165981,12183,5112728
20451,2022-03-12,SP,105,166086,10967,5123695
20479,2022-03-13,SP,7,166093,5043,5128738
20507,2022-03-14,SP,26,166119,1306,5130044
20535,2022-03-15,SP,63,166182,11965,5142009
20563,2022-03-16,SP,139,166321,8815,5150824
20591,2022-03-17,SP,125,166446,9026,5159850
20619,2022-03-18,SP,104,166550,9565,5169415
20647,2022-03-19,SP,101,166651,7651,5177066
20675,2022-03-20,SP,7,166658,5299,5182365
20703,2022-03-21,SP,10,166668,1472,5183837
20731,2022-03-22,SP,78,166746,9782,5193619
20759,2022-03-23,SP,97,166843,9364,5202983
20787,2022-03-24,SP,112,166955,8953,5211936
20815,2022-03-25,SP,91,167046,9300,5221236
20843,2022-03-26,SP,61,167107,7177,5228413
20871,2022-03-27,SP,3,167110,3961,5232374
20899,2022-03-28,SP,14,167124,1648,5234022
20927,2022-03-29,SP,87,167211,7432,5241454
20955,2022-03-30,SP,91,167302,7813,5249267
20983,2022-03-31,SP,72,167374,8426,5257693
21011,2022-04-01,SP,63,167437,6828,5264521
21039,2022-04-02,SP,46,167483,6650,5271171
21067,2022-04-03,SP,2,167485,2124,5273295
21095,2022-04-04,SP,6,167491,656,5273951
21123,2022-04-05,SP,57,167548,6331,5280282
21151,2022-04-06,SP,46,167594,6840,5287122
21179,2022-04-07,SP,57,167651,7486,5294608
21207,2022-04-08,SP,33,167684,6393,5301001
21235,2022-04-09,SP,22,167706,5968,5306969
21263,2022-04-10,SP,0,167706,2373,5309342
21291,2022-04-11,SP,0,167706,1122,5310464
21319,2022-04-12,SP,24,167730,8230,5318694
21347,2022-04-13,SP,40,167770,7437,5326131
21375,2022-04-14,SP,35,167805,6323,5332454
21403,2022-04-15,SP,41,167846,4503,5336957
21431,2022-04-16,SP,1,167847,502,5337459
21459,2022-04-17,SP,0,167847,0,5337459
21487,2022-04-18,SP,7,167854,2688,5340147
21515,2022-04-19,SP,0,167854,0,5340147
21543,2022-04-20,SP,109,167963,14445,5354592
21571,2022-04-21,SP,23,167986,6231,5360823
21599,2022-04-22,SP,3,167989,1554,5362377
21627,2022-04-23,SP,11,168000,479,5362856
21655,2022-04-24,SP,7,168007,608,5363464
21683,2022-04-25,SP,2,168009,633,5364097
21711,2022-04-26,SP,51,168060,5725,5369822
21739,2022-04-27,SP,46,168106,5693,5375515
21767,2022-04-28,SP,34,168140,4792,5380307
21795,2022-04-29,SP,53,168193,4013,5384320
21823,2022-04-30,SP,30,168223,5025,5389345
21851,2022-05-01,SP,3,168226,2724,5392069
21879,2022-05-02,SP,1,168227,587,5392656
21907,2022-05-03,SP,45,168272,6717,5399373
21935,2022-05-04,SP,21,168293,6199,5405572
21963,2022-05-05,SP,18,168311,5973,5411545
21991,2022-05-06,SP,23,168334,6104,5417649
22019,2022-05-07,SP,5,168339,4683,5422332
22047,2022-05-08,SP,0,168339,2141,5424473
22075,2022-05-09,SP,0,168339,487,5424960
22103,2022-05-10,SP,77,168416,4736,5429696
22131,2022-05-11,SP,50,168466,4742,5434438
22159,2022-05-12,SP,67,168533,4520,5438958
22187,2022-05-13,SP,84,168617,4935,5443893
22215,2022-05-14,SP,52,168669,3712,5447605
22243,2022-05-15,SP,41,168710,2336,5449941
22271,2022-05-16,SP,2,168712,1203,5451144
22299,2022-05-17,SP,63,168775,4671,5455815
22327,2022-05-18,SP,39,168814,2657,5458472
22355,2022-05-19,SP,50,168864,1157,5459629
22383,2022-05-20,SP,0,168864,0,5459629
22411,2022-05-21,SP,0,168864,0,5459629
22439,2022-05-22,SP,86,168950,7579,5467208
22467,2022-05-23,SP,5,168955,979,5468187
22495,2022-05-24,SP,57,169012,5959,5474146
22523,2022-05-25,SP,41,169053,6586,5480732
22551,2022-05-26,SP,65,169118,6402,5487134
22579,2022-05-27,SP,69,169187,5927,5493061
22607,2022-05-28,SP,26,169213,6707,5499768
22635,2022-05-29,SP,21,169234,2822,5502590
22663,2022-05-30,SP,7,169241,928,5503518
22691,2022-05-31,SP,43,169284,8421,5511939
22719,2022-06-01,SP,47,169331,8351,5520290
22747,2022-06-02,SP,84,169415,7436,5527726
22775,2022-06-03,SP,0,169415,0,5527726
22803,2022-06-04,SP,0,169415,0,5527726
22831,2022-06-05,SP,0,169415,0,5527726
22859,2022-06-06,SP,0,169415,0,5527726
22887,2022-06-07,SP,168,169583,29856,5557582
22915,2022-06-08,SP,58,169641,8967,5566549
22943,2022-06-09,SP,68,169709,6148,5572697
22971,2022-06-10,SP,68,169777,10557,5583254
22999,2022-06-11,SP,59,169836,8022,5591276
23027,2022-06-12,SP,9,169845,3959,5595235
23055,2022-06-13,SP,6,169851,1479,5596714
23083,2022-06-14,SP,0,169851,0,5596714
23111,2022-06-15,SP,156,170007,19824,5616538
23139,2022-06-16,SP,85,170092,8831,5625369
23167,2022-06-17,SP,19,170111,2709,5628078
23195,2022-06-18,SP,41,170152,3386,5631464
23223,2022-06-19,SP,19,170171,2079,5633543
23251,2022-06-20,SP,7,170178,1597,5635140
23279,2022-06-21,SP,72,170250,10807,5645947
23307,2022-06-22,SP,0,170250,9893,5655840
23335,2022-06-23,SP,177,170427,9087,5664927
23363,2022-06-24,SP,101,170528,397,5665324
23391,2022-06-25,SP,72,170600,16911,5682235
23419,2022-06-26,SP,7,170607,3179,5685414
23447,2022-06-27,SP,7,170614,2071,5687485
23475,2022-06-28,SP,122,170736,9885,5697370
23503,2022-06-29,SP,81,170817,10451,5707821
23531,2022-06-30,SP,90,170907,10671,5718492
23559,2022-07-01,SP,87,170994,10915,5729407
23587,2022-07-02,SP,61,171055,8838,5738245
23615,2022-07-03,SP,10,171065,3678,5741923
23643,2022-07-04,SP,7,171072,1660,5743583
23671,2022-07-05,SP,136,171208,10495,5754078
23699,2022-07-06,SP,98,171306,10925,5765003
23727,2022-07-07,SP,89,171395,10220,5775223
23755,2022-07-08,SP,83,171478,9554,5784777
23783,2022-07-09,SP,84,171562,9224,5794001
23811,2022-07-10,SP,7,171569,3624,5797625
23839,2022-07-11,SP,2,171571,1075,5798700
23867,2022-07-12,SP,124,171695,9759,5808459
23895,2022-07-13,SP,82,171777,8764,5817223
23923,2022-07-14,SP,74,171851,8610,5825833
23951,2022-07-15,SP,108,171959,7787,5833620
23979,2022-07-16,SP,88,172047,7383,5841003
24007,2022-07-17,SP,10,172057,1567,5842570
24035,2022-07-18,SP,17,172074,888,5843458
24063,2022-07-19,SP,111,172185,9502,5852960
24091,2022-07-20,SP,92,172277,8303,5861263
24119,2022-07-21,SP,87,172364,6608,5867871
24147,2022-07-22,SP,95,172459,6745,5874616
24175,2022-07-23,SP,77,172536,6117,5880733
24203,2022-07-24,SP,8,172544,2226,5882959
24231,2022-07-25,SP,11,172555,652,5883611
24259,2022-07-26,SP,99,172654,7152,5890763
24287,2022-07-27,SP,73,172727,7096,5897859
24315,2022-07-28,SP,89,172816,6986,5904845
24343,2022-07-29,SP,71,172887,6707,5911552
24371,2022-07-30,SP,48,172935,5716,5917268
24399,2022-07-31,SP,9,172944,2178,5919446
24427,2022-08-01,SP,3,172947,813,5920259
24455,2022-08-02,SP,89,173036,6860,5927119
24483,2022-08-03,SP,66,173102,5970,5933089
24511,2022-08-04,SP,58,173160,5647,5938736
24539,2022-08-05,SP,77,173237,5405,5944141
24567,2022-08-06,SP,79,173316,4179,5948320
24595,2022-08-07,SP,22,173338,1153,5949473
24623,2022-08-08,SP,8,173346,840,5950313
24651,2022-08-09,SP,72,173418,5097,5955410
24679,2022-08-10,SP,66,173484,5372,5960782
24707,2022-08-11,SP,39,173523,4504,5965286
24735,2022-08-12,SP,44,173567,3631,5968917
24763,2022-08-13,SP,0,173567,0,5968917
24791,2022-08-14,SP,0,173567,0,5968917
24819,2022-08-15,SP,101,173668,5274,5974191
24847,2022-08-16,SP,53,173721,5269,5979460
24875,2022-08-17,SP,70,173791,4950,5984410
24903,2022-08-18,SP,48,173839,4995,5989405
24931,2022-08-19,SP,33,173872,3971,5993376
24959,2022-08-20,SP,0,173872,0,5993376
24987,2022-08-21,SP,0,173872,0,5993376
25015,2022-08-22,SP,0,173872,0,5993376
25043,2022-08-23,SP,107,173979,10907,6004283
25071,2022-08-24,SP,16,173995,4468,6008751
25099,2022-08-25,SP,24,174019,4354,6013105
